INJECTOR_CODE,FOLIO_NUMBER,ORDERED_QUANTITY,COMMITTED_NET_QUANTITY,UNACCOUNTED,FRAC_UNACCOUNTED,PRODUCT_THRUPUT,serka
INJ_201,20210928,10200,10200,0,-1,33973,-23773
INJ_201,20210929,24600,22200,0,1,78211,-56011
INJ_201,20210930,16200,16200,0,0,53963,-37763
INJ_201,20211001,25800,20700,0,-1,83864,-63164
INJ_201,20211002,26400,26400,0,1,87951,-61551
INJ_201,20211004,32100,32100,0,0,106955,-74855
INJ_201,20211005,31800,31800,0,-2,105952,-74152
INJ_201,20211006,36300,36300,0,1,120950,-84650
INJ_201,20211007,37800,37800,0,-1,125940,-88140
INJ_201,20211008,26400,26400,0,-2,87962,-61562
INJ_201,20211009,23400,23400,0,0,77954,-54554
INJ_201,20211011,27600,23400,0,0,77903,-54503
INJ_201,20211012,33000,33000,0,-2,109939,-76939
INJ_201,20211013,8400,8400,19,201,27981,-19581
INJ_201,20211022,24300,21900,0,1,72954,-51054
INJ_201,20211023,13200,13200,0,0,43979,-30779
INJ_201,20211025,2100,2100,0,0,6992,-4892
INJ_201,20211026,6900,6900,0,-1,22993,-16093
INJ_201,20211027,44100,41100,0,1,136923,-95823
INJ_201,20211028,22200,18000,0,0,68152,-50152
INJ_201,20211029,36600,36600,0,0,121943,-85343
INJ_201,20211030,81000,81000,0,-1,269857,-188857
INJ_201,20211101,35700,31500,0,0,104942,-73442
INJ_201,20211102,29700,25500,0,1,84963,-59463
INJ_201,20211103,30600,28200,0,2,93951,-65751
INJ_201,20211104,18000,15600,0,0,51976,-36376
INJ_201,20211105,29400,29400,0,0,97951,-68551
INJ_201,20211106,18300,18300,0,0,60970,-42670
INJ_201,20211108,33300,33300,0,0,110950,-77650
INJ_201,20211109,17700,17700,0,1,58967,-41267
INJ_201,20211110,21300,19500,0,0,70963,-51463
INJ_201,20211111,41700,39300,0,-1,136923,-97623
INJ_201,20211112,15000,13800,0,1,45976,-32176
INJ_201,20211113,19500,17700,5,999,68968,-51268
INJ_201,20211115,3000,3000,0,0,0,3000
INJ_201,20211116,6000,6000,0,0,19991,-13991
INJ_201,20211117,36600,34200,0,0,113949,-79749
INJ_201,20211118,16200,16200,0,-2,53974,-37774
INJ_201,20211119,15600,15600,0,1,51972,-36372
INJ_201,20211120,29400,27000,0,0,89954,-62954
INJ_201,20211122,4800,4800,0,0,15989,-11189
INJ_201,20211126,900,900,0,0,2997,-2097
INJ_201,20211127,57300,47400,0,0,175983,-128583
INJ_201,20211129,30000,20400,0,-1,77287,-56887
INJ_201,20211130,21900,21900,0,2,72959,-51059
INJ_201,20211201,19500,16500,0,0,54974,-38474
INJ_201,20211202,34200,28500,0,1,104326,-75826
INJ_201,20211203,23100,23100,0,2,76965,-53865
INJ_201,20211204,36300,35100,0,1,116941,-81841
INJ_201,20211206,18000,18000,0,1,59971,-41971
INJ_201,20211207,29100,27300,0,0,90960,-63660
INJ_201,20211208,19200,19200,0,0,63957,-44757
INJ_201,20211209,54600,52800,0,0,175910,-123110
INJ_201,20211210,35400,28800,0,0,95928,-67128
INJ_201,20211211,21600,21600,0,0,71967,-50367
INJ_201,20211213,43200,43200,0,-2,143923,-100723
INJ_201,20211214,39000,34200,0,0,113955,-79755
INJ_201,20211215,41400,37200,0,2,129812,-92612
INJ_201,20211216,8400,8400,0,0,27987,-19587
INJ_201,20211217,21600,16800,0,2,55847,-39047
INJ_201,20211218,36000,14100,0,-1,46983,-32883
INJ_201,20211221,21900,18900,0,1,62967,-44067
INJ_201,20211222,40200,37200,0,3,123939,-86739
INJ_201,20211223,19200,19200,0,-2,63954,-44754
INJ_201,20211224,36000,33000,0,-1,109917,-76917
INJ_201,20211225,29700,25500,0,-1,96442,-70942
INJ_201,20211227,24600,24600,0,2,81951,-57351
INJ_201,20211228,42900,38100,0,0,126942,-88842
INJ_201,20211229,27000,23400,0,1,77963,-54563
INJ_201,20211230,14400,9000,0,0,29988,-20988
INJ_201,20211231,56400,55500,0,-1,184919,-129419
INJ_201,20220101,19200,19200,0,600,63975,-44775
INJ_201,20220102,5700,5700,0,0,18987,-13287
INJ_201,20220103,24600,24600,0,1,81943,-57343
INJ_201,20220104,19200,19200,0,-2,63941,-44741
INJ_201,20220105,4800,2400,0,0,1078,1322
INJ_201,20220110,4800,2400,0,0,1077,1323
INJ_201,20220126,27300,27300,0,-1,90955,-63655
INJ_201,20220127,38100,38100,0,0,126950,-88850
INJ_201,20220128,33300,33300,0,1,110956,-77656
INJ_201,20220129,16500,16500,0,0,54974,-38474
INJ_201,20220131,42300,42300,0,2,140928,-98628
INJ_201,20220201,19500,19500,0,0,64975,-45475
INJ_201,20220202,27300,26700,0,1,88936,-62236
INJ_201,20220203,6900,6900,0,1,22992,-16092
INJ_201,20220204,23100,21900,0,0,73471,-51571
INJ_201,20220205,42300,42300,0,0,140935,-98635
INJ_201,20220207,15900,15900,0,0,52970,-37070
INJ_201,20220208,23700,23700,0,0,78958,-55258
INJ_201,20220209,27000,27000,0,0,89961,-62961
INJ_201,20220210,12000,12000,0,0,39980,-27980
INJ_201,20220211,10800,10800,0,1,35976,-25176
INJ_201,20220212,16200,16200,0,0,53970,-37770
INJ_201,20220214,21300,21300,0,0,70971,-49671
INJ_201,20220215,37200,28800,0,0,95940,-67140
INJ_201,20220216,29700,29700,0,2,98949,-69249
INJ_201,20220217,27000,24600,0,0,81958,-57358
INJ_201,20220218,17400,17400,0,0,57976,-40576
INJ_201,20220219,14400,3600,0,1,2950,650
INJ_201,20220806,12600,0,0,0,2866,-2866
INJ_201,20220916,625,250,0,0,4197,-3947
INJ_201,20220924,750,750,0,0,5993,-5243
INJ_201,20221005,1250,1250,0,0,9997,-8747
INJ_201,20221007,500,500,0,0,3996,-3496
INJ_201,20221008,375,0,0,0,578,-578
INJ_201,20221015,375,0,0,0,1082,-1082
INJ_201,20221028,250,250,0,0,1996,-1746
INJ_201,20221101,375,0,0,-1,2204,-2204
INJ_201,20221119,750,750,0,1,5997,-5247
INJ_201,20221124,375,375,0,-1,2997,-2622
INJ_201,20221206,375,375,0,0,2997,-2622
INJ_201,20221209,625,625,0,0,4993,-4368
INJ_201,20221210,1875,1875,0,0,14991,-13116
INJ_201,20221220,250,250,0,0,1995,-1745
INJ_201,20221222,500,500,0,0,3997,-3497
INJ_201,20221223,375,375,0,0,2997,-2622
INJ_201,20221230,375,0,0,0,2205,-2205
INJ_201,20221231,500,500,0,0,3995,-3495
INJ_201,20230103,500,500,0,-1,3997,-3497
INJ_201,20230112,750,750,0,1,5999,-5249
INJ_201,20230130,500,500,0,0,3994,-3494
INJ_201,20230203,875,875,0,0,6997,-6122
INJ_201,20230209,500,500,0,-1,3998,-3498
INJ_201,20230215,250,250,0,0,1995,-1745
INJ_201,20230220,6300,5400,0,0,19928,-14528
INJ_201,20230221,500,500,0,0,3999,-3499
INJ_201,20230224,250,250,0,0,1998,-1748
INJ_201,20230304,2250,2250,0,1,17998,-15748
INJ_201,20230308,500,500,0,-1,3998,-3498
INJ_201,20230313,4200,4200,0,1,13996,-9796
INJ_201,20230314,20430,18030,0,-1,60003,-41973
INJ_201,20230325,250,250,0,0,1996,-1746
INJ_201,20230328,500,500,0,0,3999,-3499
INJ_201,20230331,375,375,0,-1,2999,-2624
INJ_201,20230405,875,875,0,0,6998,-6123
INJ_201,20230408,500,500,0,-1,3998,-3498
INJ_201,20230418,375,375,0,1,2999,-2624
INJ_201,20230419,875,875,0,-1,6995,-6120
INJ_201,20230428,1500,1000,0,0,7997,-6997
INJ_201,20230429,500,500,0,0,3998,-3498
INJ_201,20230502,750,750,0,0,5998,-5248
INJ_201,20230505,10300,9400,0,-1,35981,-26581
INJ_201,20230506,9450,9450,0,1,34978,-25528
INJ_201,20230508,36900,32400,-4,-500,107970,-75570
INJ_201,20230509,30770,30770,0,1,113962,-83192
INJ_201,20230510,36570,36570,0,1,158950,-122380
INJ_201,20230511,33120,31050,0,-1,138658,-107608
INJ_201,20230512,26680,24840,0,0,100724,-75884
INJ_201,20230513,17250,17250,0,0,74974,-57724
INJ_201,20230515,29210,25530,0,-2,114420,-88890
INJ_201,20230516,18630,18630,0,0,80974,-62344
INJ_201,20230517,34500,34500,0,1,149965,-115465
INJ_201,20230518,12420,12420,0,-1,53987,-41567
INJ_201,20230519,21620,21620,0,1,93976,-72356
INJ_201,20230520,17020,17020,0,-1,73974,-56954
INJ_201,20230522,38280,33450,0,-3,146203,-112753
INJ_201,20230523,12850,12850,0,1,50984,-38134
INJ_201,20230524,29450,29450,0,-3,124974,-95524
INJ_201,20230525,17250,14030,0,0,60990,-46960
INJ_201,20230526,16100,16100,0,-1,69986,-53886
INJ_201,20230527,24660,23740,0,-1,101971,-78231
INJ_201,20230529,27370,26910,0,-1,118957,-92047
INJ_201,20230530,92230,8280,0,-2,35984,-27704
INJ_201,20230531,13320,1480,0,0,3999,-2519
INJ_201,20230606,25760,25760,0,0,111980,-86220
INJ_201,20230607,21620,21620,0,0,93981,-72361
INJ_201,20230608,7740,7740,0,-1,29994,-22254
INJ_201,20230609,15770,14970,0,1,90985,-76015
INJ_201,20230610,9700,8300,0,0,82973,-74673
INJ_201,20230612,8300,6300,0,1,76730,-70430
INJ_201,20230613,8380,8380,0,0,72980,-64600
INJ_201,20230614,6300,6000,0,0,59983,-53983
INJ_201,20230615,6800,6800,0,-1,67979,-61179
INJ_201,20230616,21240,21240,0,2,206957,-185717
INJ_201,20230617,11300,10500,0,1,104969,-94469
INJ_201,20230619,12040,9640,0,1,90969,-81329
INJ_201,20230620,11300,8500,0,1,84981,-76481
INJ_201,20230621,10700,10700,0,-1,106972,-96272
INJ_201,20230622,9440,9440,0,1,88978,-79538
INJ_201,20230626,10250,9450,0,0,80983,-71533
INJ_201,20230627,11700,9300,0,-2,92968,-83668
INJ_201,20230628,20920,18520,0,2,168561,-150041
INJ_201,20230630,11100,11100,0,-1,83973,-72873
INJ_201,20230701,6300,6300,0,-1,62987,-56687
INJ_201,20230703,16680,12880,0,-3,115975,-103095
INJ_201,20230704,13500,12100,0,0,120969,-108869
INJ_201,20230705,23490,20090,0,-2,181950,-161860
INJ_201,20230706,14380,14380,0,2,132974,-118594
INJ_201,20230707,17300,17300,0,1,172957,-155657
INJ_201,20230708,19680,19280,0,-1,181921,-162641
INJ_201,20230710,27610,18690,0,-2,167937,-149247
INJ_201,20230711,33100,11500,0,-1,114938,-103438
INJ_201,20230712,10040,10040,0,1,85974,-75934
INJ_201,20230713,16300,16300,0,1,153948,-137648
INJ_201,20230714,13200,13200,0,-2,131972,-118772
INJ_201,20230715,12200,11200,0,1,111977,-100777
INJ_201,20230716,1700,1700,0,-1,16997,-15297
INJ_201,20230717,11900,9500,0,0,94985,-85485
INJ_201,20230718,14560,13080,0,0,119969,-106889
INJ_201,20230719,9800,9200,0,-1,91929,-82729
INJ_202,20220126,17100,4500,0,0,14969,-10469
INJ_202,20220127,12600,7800,0,0,25934,-18134
INJ_202,20220128,6000,3300,0,0,10964,-7664
INJ_202,20220129,14700,3900,0,-1,12967,-9067
INJ_202,20220131,7800,3300,0,0,10968,-7668
INJ_202,20220201,3600,900,0,1,2991,-2091
INJ_202,20220202,3000,1500,0,0,4983,-3483
INJ_202,20220203,1800,900,0,0,3007,-2107
INJ_202,20220204,11700,1800,0,1,13212,-11412
INJ_202,20220205,21600,6000,0,-1,19954,-13954
INJ_202,20220207,5400,1800,0,-1,5994,-4194
INJ_202,20220208,26100,6600,0,0,21969,-15369
INJ_202,20220209,10500,4800,0,-1,14070,-9270
INJ_202,20220210,3600,1500,0,0,4981,-3481
INJ_202,20220211,14400,1800,0,0,5993,-4193
INJ_202,20220212,1800,600,0,0,1992,-1392
INJ_202,20220214,44700,7800,0,2,25961,-18161
INJ_202,20220215,12600,6300,0,0,20939,-14639
INJ_202,20220216,4200,1500,0,1,4985,-3485
INJ_202,20220217,12300,5100,0,-1,16963,-11863
INJ_202,20220218,7500,1500,0,0,4989,-3489
INJ_202,20220219,16200,3300,0,0,10973,-7673
INJ_202,20220714,600,600,0,0,1991,-1391
INJ_202,20220715,5700,5700,0,-1,18964,-13264
INJ_202,20220716,19500,14100,0,0,46898,-32798
INJ_202,20220717,1800,1800,0,0,5992,-4192
INJ_202,20220718,8100,5700,0,1,18949,-13249
INJ_202,20220719,3900,3900,0,1,12966,-9066
INJ_202,20220720,7800,7800,0,-1,25934,-18134
INJ_202,20220722,8700,6900,0,-1,22932,-16032
INJ_202,20220723,10800,9600,0,2,31912,-22312
INJ_202,20220725,8400,6600,0,1,21954,-15354
INJ_202,20220726,4500,4500,0,0,14963,-10463
INJ_202,20220727,5700,5700,0,0,18943,-13243
INJ_202,20220728,7500,7500,0,0,24943,-17443
INJ_202,20220729,6900,5400,0,0,17956,-12556
INJ_202,20220730,4200,4200,0,-1,13962,-9762
INJ_202,20220801,2400,2400,0,0,7977,-5577
INJ_202,20220802,3900,3900,0,-1,12962,-9062
INJ_202,20220803,16800,16800,0,1,55855,-39055
INJ_202,20220804,15600,15600,0,0,51882,-36282
INJ_202,20220805,7200,7200,0,1,23940,-16740
INJ_202,20220806,18600,18600,0,1,61829,-43229
INJ_202,20220808,9000,7500,0,1,24945,-17445
INJ_202,20220809,15600,13800,0,2,45878,-32078
INJ_202,20220810,3000,3000,0,0,9963,-6963
INJ_202,20220811,10800,9900,0,1,32911,-23011
INJ_202,20220812,1500,1500,0,0,4985,-3485
INJ_202,20220813,5100,5100,0,0,16963,-11863
INJ_202,20220814,3000,3000,0,1,9973,-6973
INJ_202,20220815,7200,6000,0,-1,19937,-13937
INJ_202,20220816,6300,6300,0,0,20947,-14647
INJ_202,20220817,3930,3930,0,0,13014,-9084
INJ_202,20220818,4500,2700,0,0,8984,-6284
INJ_202,20220819,8400,7500,0,1,24941,-17441
INJ_202,20220820,12900,10500,0,2,34899,-24399
INJ_202,20220822,7200,5400,0,0,17967,-12567
INJ_202,20220823,3300,3300,0,0,10963,-7663
INJ_202,20220826,9900,9900,0,0,32921,-23021
INJ_202,20220827,8400,6900,0,-1,22920,-16020
INJ_202,20220901,1500,1500,0,1,4991,-3491
INJ_202,20220903,3600,1800,0,-1,5988,-4188
INJ_202,20220905,2100,2100,0,0,6978,-4878
INJ_202,20220907,9900,7800,0,0,25927,-18127
INJ_202,20220908,4800,4800,0,-1,15967,-11167
INJ_202,20220909,5100,4500,0,-1,14956,-10456
INJ_202,20220910,4200,3300,0,0,10964,-7664
INJ_202,20220912,1800,900,0,0,2991,-2091
INJ_202,20220913,16200,15300,0,-2,50904,-35604
INJ_202,20220914,4200,3300,0,0,10962,-7662
INJ_202,20220915,2100,2100,0,-1,6984,-4884
INJ_202,20220916,5700,5100,0,1,16964,-11864
INJ_202,20220917,3600,2400,0,0,7974,-5574
INJ_202,20230314,3000,2100,0,-1,6986,-4886
INJ_202,20230322,4200,1800,0,1,5981,-4181
INJ_202,20230323,22200,10200,0,-1,33928,-23728
INJ_202,20230324,10200,6900,0,0,22949,-16049
INJ_202,20230325,18600,8100,0,-1,26915,-18815
INJ_202,20230327,6000,2400,0,0,7972,-5572
INJ_202,20230328,12600,7800,0,0,25962,-18162
INJ_202,20230329,4800,1500,0,1,4987,-3487
INJ_202,20230330,7800,1800,0,0,5982,-4182
INJ_202,20230401,1500,1500,0,-1,4984,-3484
INJ_202,20230404,13500,5100,0,0,16966,-11866
INJ_202,20230405,1500,1500,0,0,4991,-3491
INJ_202,20230406,10800,1800,0,0,5990,-4190
INJ_202,20230407,10500,7500,0,0,24945,-17445
INJ_202,20230408,5400,3900,0,-1,12965,-9065
INJ_202,20230410,4200,4200,0,0,13969,-9769
INJ_202,20230412,33000,3000,0,0,9989,-6989
INJ_202,20230413,6900,2100,0,0,6982,-4882
INJ_202,20230414,13800,4800,0,0,15950,-11150
INJ_202,20230417,1800,900,0,0,2993,-2093
INJ_202,20230418,29100,8100,0,0,26970,-18870
INJ_202,20230419,8100,3600,0,-1,11959,-8359
INJ_202,20230420,6300,6300,0,1,20960,-14660
INJ_202,20230421,5100,2400,0,0,7981,-5581
INJ_202,20230424,9600,3300,0,0,10969,-7669
INJ_202,20230425,3600,2700,0,0,8982,-6282
INJ_202,20230426,900,900,0,0,2989,-2089
INJ_202,20230427,5100,4200,0,0,13945,-9745
INJ_202,20230428,3900,3900,0,-1,12957,-9057
INJ_202,20230429,17700,15300,0,0,50904,-35604
INJ_202,20230501,8100,6900,0,0,22949,-16049
INJ_202,20230502,11700,9000,0,0,29931,-20931
INJ_202,20230503,21000,10800,0,0,40686,-29886
INJ_202,20230504,6900,3000,0,0,9963,-6963
INJ_202,20230505,27900,9900,0,-2,32932,-23032
INJ_202,20230506,19800,11700,0,-2,38917,-27217
INJ_202,20230508,27300,11100,-1,-500,36921,-25821
INJ_202,20230509,13200,10200,0,-1,39915,-29715
INJ_202,20230510,10000,8800,0,2,43885,-35085
INJ_202,20230511,4200,2800,0,1,14220,-11420
INJ_202,20230512,7800,5000,0,0,24962,-19962
INJ_202,20230513,11800,5600,0,1,27933,-22333
INJ_202,20230515,3200,2200,0,1,11144,-8944
INJ_202,20230516,6600,4800,0,-1,23945,-19145
INJ_202,20230517,7600,6000,0,1,29937,-23937
INJ_202,20230518,2000,2000,0,-1,9972,-7972
INJ_202,20230519,13400,6200,0,0,23644,-17444
INJ_202,20230520,3800,2800,0,-1,13955,-11155
INJ_202,20230522,18800,7800,0,-1,39246,-31446
INJ_202,20230523,16800,3800,0,1,6999,-3199
INJ_202,20230524,7400,3400,0,1,16962,-13562
INJ_202,20230525,1200,1200,0,0,5979,-4779
INJ_202,20230526,8600,3800,0,1,14954,-11154
INJ_202,20230527,4800,4800,0,1,23937,-19137
INJ_202,20230529,5200,4400,0,0,21955,-17555
INJ_202,20230530,8400,3600,0,0,17961,-14361
INJ_202,20230531,5400,4600,0,2,22929,-18329
INJ_202,20230601,6200,3800,0,-1,18950,-15150
INJ_202,20230602,3200,2000,0,0,9983,-7983
INJ_202,20230603,7800,4600,0,-1,22927,-18327
INJ_202,20230605,3600,3200,0,0,15955,-12755
INJ_202,20230606,4200,4200,0,1,20947,-16747
INJ_202,20230607,6600,6600,0,0,32922,-26322
INJ_202,20230608,1000,1000,0,0,4992,-3992
INJ_202,20230609,2100,1800,0,0,13956,-12156
INJ_202,20230610,3000,2400,0,-1,23930,-21530
INJ_202,20230612,3900,3700,0,0,38809,-35109
INJ_202,20230613,2100,2100,0,1,20954,-18854
INJ_202,20230614,1500,1300,0,-1,12964,-11664
INJ_202,20230615,1100,1100,0,0,10972,-9872
INJ_202,20230616,3600,3600,0,1,35897,-32297
INJ_202,20230617,3300,1700,0,0,16967,-15267
INJ_202,20230619,1900,1200,0,0,11963,-10763
INJ_202,20230620,2900,2900,0,1,28937,-26037
INJ_202,20230621,1500,1500,0,1,14968,-13468
INJ_202,20230622,3700,3700,0,1,36906,-33206
INJ_202,20230623,8000,7000,0,3,69863,-62863
INJ_202,20230624,9100,8600,0,0,55887,-47287
INJ_202,20230626,4000,3600,0,0,35899,-32299
INJ_202,20230627,2300,2300,0,0,22936,-20636
INJ_202,20230628,4600,4600,0,0,45889,-41289
INJ_202,20230630,3500,3500,0,-1,34923,-31423
INJ_202,20230701,1300,1300,0,0,12966,-11666
INJ_202,20230703,6000,5300,0,1,52866,-47566
INJ_202,20230704,4700,4500,0,-1,44856,-40356
INJ_202,20230705,4200,3400,0,0,33919,-30519
INJ_202,20230706,3500,3500,0,1,34901,-31401
INJ_202,20230707,4100,4100,0,2,40911,-36811
INJ_202,20230708,4500,4500,0,0,44900,-40400
INJ_202,20230710,6100,6100,0,-1,54871,-48771
INJ_202,20230711,2100,2100,0,0,20942,-18842
INJ_202,20230712,2600,2600,0,0,25943,-23343
INJ_202,20230713,6700,2300,0,-1,22930,-20630
INJ_202,20230714,3700,3700,0,2,36901,-33201
INJ_202,20230715,2900,2900,0,1,28935,-26035
INJ_202,20230717,5700,5500,0,0,54874,-49374
INJ_202,20230718,5100,4500,0,0,44869,-40369
INJ_202,20230719,2300,2300,0,-1,22969,-20669
INJ_203,20210928,7200,7200,0,1,23987,-16787
INJ_203,20210929,12300,9300,0,0,37711,-28411
INJ_203,20210930,2700,2700,0,1,8988,-6288
INJ_203,20211001,19200,13200,0,0,62161,-48961
INJ_203,20211002,16500,16500,0,-1,54971,-38471
INJ_203,20211004,9900,9900,0,0,32972,-23072
INJ_203,20211005,15600,15600,0,0,51954,-36354
INJ_203,20211006,8700,8700,0,-1,28970,-20270
INJ_203,20211007,18300,18300,0,0,60955,-42655
INJ_203,20211008,10800,10800,0,-1,35981,-25181
INJ_203,20211009,12900,12900,0,0,42972,-30072
INJ_203,20211011,10200,10200,0,2,33971,-23771
INJ_203,20211012,2700,2700,0,0,8992,-6292
INJ_203,20211013,8400,8400,7,806,27985,-19585
INJ_203,20211022,10500,10500,0,-1,34979,-24479
INJ_203,20211023,11100,11100,0,0,36983,-25883
INJ_203,20211025,900,900,0,0,2998,-2098
INJ_203,20211026,2100,2100,0,0,6989,-4889
INJ_203,20211027,3300,3300,0,0,10983,-7683
INJ_203,20211028,10500,7800,0,1,29591,-21791
INJ_203,20211029,12900,11700,0,-1,38974,-27274
INJ_203,20211030,16500,16500,0,2,54957,-38457
INJ_203,20211101,8400,8400,0,0,27966,-19566
INJ_203,20211102,11700,11700,0,0,38961,-27261
INJ_203,20211103,8700,8700,0,0,28983,-20283
INJ_203,20211104,4200,3300,0,0,10986,-7686
INJ_203,20211105,15900,15900,0,-1,52971,-37071
INJ_203,20211106,6600,6600,0,0,21983,-15383
INJ_203,20211108,20700,20700,0,-1,68953,-48253
INJ_203,20211109,5700,5700,0,1,18977,-13277
INJ_203,20211110,10800,10800,0,-1,29973,-19173
INJ_203,20211111,25800,21300,0,2,64943,-43643
INJ_203,20211112,5100,5100,0,1,16981,-11881
INJ_203,20211113,10500,10500,0,596,40980,-30480
INJ_203,20211115,3000,3000,0,0,0,3000
INJ_203,20211116,3900,3900,0,1,12991,-9091
INJ_203,20211117,14400,14400,0,0,47957,-33557
INJ_203,20211118,3600,3600,0,-1,11988,-8388
INJ_203,20211119,1500,1500,0,1,4994,-3494
INJ_203,20211120,8400,8400,0,0,27975,-19575
INJ_203,20211122,3300,3300,0,0,10995,-7695
INJ_203,20211127,15600,13200,0,0,46017,-32817
INJ_203,20211129,11400,11400,0,1,28626,-17226
INJ_203,20211130,10200,10200,0,0,33978,-23778
INJ_203,20211201,10200,10200,0,0,33973,-23773
INJ_203,20211202,10200,8700,0,-2,31556,-22856
INJ_203,20211203,10200,10200,0,-1,33976,-23776
INJ_203,20211204,12600,10800,0,-1,35969,-25169
INJ_203,20211206,6900,6900,0,-1,22979,-16079
INJ_203,20211207,13200,11400,0,-2,37981,-26581
INJ_203,20211208,6600,6600,0,1,21991,-15391
INJ_203,20211209,12600,11400,0,-1,37966,-26566
INJ_203,20211210,19200,14400,0,-1,47959,-33559
INJ_203,20211211,3900,3900,0,0,12985,-9085
INJ_203,20211213,10500,10500,0,-1,34970,-24470
INJ_203,20211214,17400,16200,0,-1,53966,-37766
INJ_203,20211215,16800,15600,0,0,46083,-30483
INJ_203,20211216,600,600,0,0,1998,-1398
INJ_203,20211217,7500,6300,0,0,20986,-14686
INJ_203,20211218,4800,4800,0,1,15986,-11186
INJ_203,20211221,9300,9300,0,-1,30979,-21679
INJ_203,20211222,14700,13800,0,1,45968,-32168
INJ_203,20211223,4200,4200,0,0,13982,-9782
INJ_203,20211224,17100,15300,0,0,50965,-35665
INJ_203,20211225,9900,7200,0,-1,30501,-23301
INJ_203,20211227,6300,6300,0,1,20982,-14682
INJ_203,20211228,18600,16500,0,-1,54956,-38456
INJ_203,20211229,12900,12900,0,0,42967,-30067
INJ_203,20211230,10500,7500,0,0,24984,-17484
INJ_203,20211231,23400,23400,0,-1,77947,-54547
INJ_203,20220101,7200,7200,0,1,23991,-16791
INJ_203,20220102,4200,4200,0,0,13987,-9787
INJ_203,20220103,12000,12000,0,-1,39971,-27971
INJ_203,20220104,10800,10800,0,-1,35978,-25178
INJ_203,20220105,1800,900,0,0,1071,-171
INJ_203,20220110,2400,1200,0,0,1103,97
INJ_203,20220126,12900,12900,0,1,42968,-30068
INJ_203,20220127,12300,12300,0,-2,40961,-28661
INJ_203,20220128,12900,12900,0,-1,42966,-30066
INJ_203,20220129,9000,9000,0,0,29984,-20984
INJ_203,20220131,26100,26100,0,1,86960,-60860
INJ_203,20220201,9300,9300,0,-1,30976,-21676
INJ_203,20220202,17700,17700,0,-2,58951,-41251
INJ_203,20220203,2100,2100,0,1,6989,-4889
INJ_203,20220204,15600,15600,0,-1,51968,-36368
INJ_203,20220205,24000,24000,0,-2,79955,-55955
INJ_203,20220207,1800,1800,0,0,5998,-4198
INJ_203,20220208,11400,11400,0,1,37975,-26575
INJ_203,20220209,7200,7200,0,1,23980,-16780
INJ_203,20220210,6300,6300,0,0,20985,-14685
INJ_203,20220211,6900,6900,0,0,22988,-16088
INJ_203,20220212,8400,8400,0,0,27983,-19583
INJ_203,20220214,10500,10500,0,-1,34981,-24481
INJ_203,20220215,27000,24300,0,0,80960,-56660
INJ_203,20220216,21000,18300,0,-1,60957,-42657
INJ_203,20220217,9900,9900,0,2,32972,-23072
INJ_203,20220218,8700,8700,0,0,28981,-20281
INJ_203,20220219,5400,900,0,0,2999,-2099
INJ_203,20220806,10800,1800,0,0,3131,-1331
INJ_203,20220912,8250,750,0,0,5997,-5247
INJ_203,20220916,375,375,0,0,796,-421
INJ_203,20220921,2250,375,0,0,2999,-2624
INJ_203,20221008,10750,1625,0,0,12408,-10783
INJ_203,20221010,1000,250,0,0,1997,-1747
INJ_203,20221015,4375,1000,0,0,6905,-5905
INJ_203,20221017,22500,1250,0,0,9996,-8746
INJ_203,20221019,11750,1250,0,0,9994,-8744
INJ_203,20221028,1000,250,0,0,1996,-1746
INJ_203,20221101,375,375,0,0,792,-417
INJ_203,20221105,6250,625,0,0,4996,-4371
INJ_203,20221107,8250,750,0,0,5997,-5247
INJ_203,20221208,8250,750,0,0,5999,-5249
INJ_203,20221220,2250,375,0,0,2997,-2622
INJ_203,20221224,10500,1125,0,0,8996,-7871
INJ_203,20221230,375,375,0,0,791,-416
INJ_203,20230112,1000,250,0,0,2000,-1750
INJ_203,20230123,1000,250,0,0,1999,-1749
INJ_203,20230209,1000,250,0,3,2000,-1750
INJ_203,20230220,23400,2700,0,0,7068,-4368
INJ_203,20230304,875,875,0,0,7001,-6126
INJ_203,20230307,250,250,0,0,1999,-1749
INJ_203,20230309,750,750,0,0,6000,-5250
INJ_203,20230313,7800,4800,0,0,15997,-11197
INJ_203,20230314,23100,16800,0,1,55992,-39192
INJ_203,20230316,250,250,0,0,2000,-1750
INJ_203,20230331,250,250,0,0,1999,-1749
INJ_203,20230403,250,250,0,0,1996,-1746
INJ_203,20230404,375,375,0,0,2999,-2624
INJ_203,20230405,1000,1000,0,-1,7999,-6999
INJ_203,20230408,750,750,0,0,6000,-5250
INJ_203,20230413,750,750,0,-1,6000,-5250
INJ_203,20230419,250,250,0,0,1999,-1749
INJ_203,20230420,750,750,0,0,5999,-5249
INJ_203,20230502,250,250,0,-1,1998,-1748
INJ_203,20230504,625,625,0,1,4999,-4374
INJ_203,20230505,12000,8400,0,-1,27993,-19593
INJ_203,20230506,10200,10200,0,-1,33995,-23795
INJ_203,20230508,36500,30250,-3,-271,101968,-71718
INJ_203,20230509,24700,24700,0,2,93979,-69279
INJ_203,20230510,32660,32660,0,2,141974,-109314
INJ_203,20230511,37720,35420,0,3,159367,-123947
INJ_203,20230512,27140,24840,0,2,101611,-76771
INJ_203,20230513,20010,17710,0,1,76970,-59260
INJ_203,20230515,27830,25070,0,0,114013,-88943
INJ_203,20230516,21390,21390,0,2,92981,-71591
INJ_203,20230517,34040,34040,0,2,147971,-113931
INJ_203,20230518,15410,15410,0,2,66994,-51584
INJ_203,20230519,19320,19320,0,-1,83985,-64665
INJ_203,20230520,17480,17480,0,0,75986,-58506
INJ_203,20230522,31510,27830,0,0,126154,-98324
INJ_203,20230523,10120,10120,0,1,43988,-33868
INJ_203,20230524,30590,30590,0,-1,132970,-102380
INJ_203,20230525,17020,14950,0,-1,64991,-50041
INJ_203,20230526,19010,19010,0,-1,78989,-59979
INJ_203,20230527,23920,23920,0,1,103994,-80074
INJ_203,20230529,34270,31510,0,2,134978,-103468
INJ_203,20230530,86270,12010,0,-2,50985,-38975
INJ_203,20230606,30820,30820,0,0,133983,-103163
INJ_203,20230607,23920,23920,0,2,103999,-80079
INJ_203,20230608,7180,7180,0,-1,29999,-22819
INJ_203,20230609,18630,17630,0,1,109988,-92358
INJ_203,20230610,11080,10180,0,-2,90971,-80791
INJ_203,20230612,8000,7100,0,-1,79959,-72859
INJ_203,20230613,7800,7800,0,2,77984,-70184
INJ_203,20230614,6200,5600,0,-1,55984,-50384
INJ_203,20230615,6500,6500,0,0,64991,-58491
INJ_203,20230616,23050,23050,0,5,216982,-193932
INJ_203,20230617,14000,12000,0,2,119977,-107977
INJ_203,20230619,13400,10300,0,0,102981,-92681
INJ_203,20230620,6500,6200,0,-1,61984,-55784
INJ_203,20230621,8100,8100,0,1,80989,-72889
INJ_203,20230622,9400,9400,0,2,93974,-84574
INJ_203,20230626,8300,7300,0,0,72988,-65688
INJ_203,20230627,11500,9500,0,-2,67973,-58473
INJ_203,20230628,19610,18410,0,2,175953,-157543
INJ_203,20230630,8880,8140,0,3,75985,-67845
INJ_203,20230701,6140,6140,0,1,55987,-49847
INJ_203,20230703,12200,11700,0,3,118966,-107266
INJ_203,20230704,7300,6400,0,0,63989,-57589
INJ_203,20230705,15200,14600,0,4,145977,-131377
INJ_203,20230706,9600,9600,0,0,95978,-86378
INJ_203,20230707,16080,16080,0,2,149989,-133909
INJ_203,20230708,20000,20000,0,3,199923,-179923
INJ_203,20230710,22400,20400,0,4,203957,-183557
INJ_203,20230711,25900,12700,0,1,126963,-114263
INJ_203,20230712,9740,6840,0,-3,71978,-65138
INJ_203,20230713,19400,17500,0,5,183962,-166462
INJ_203,20230714,10600,10600,0,0,105985,-95385
INJ_203,20230715,9000,9000,0,1,89985,-80985
INJ_203,20230716,1500,1500,0,0,14997,-13497
INJ_203,20230717,17000,13000,0,0,130001,-117001
INJ_203,20230718,15480,14740,0,5,141979,-127239
INJ_203,20230719,9720,9720,0,0,80957,-71237
INJ_204,20210927,3800,3300,0,0,63967,-60667
INJ_204,20210928,12700,12700,0,0,112944,-100244
INJ_204,20210929,9900,9900,0,0,72958,-63058
INJ_204,20210930,5400,5400,0,2,53963,-48563
INJ_204,20211001,13500,13500,0,1,118930,-105430
INJ_204,20211002,6400,6400,0,1,53962,-47562
INJ_204,20211004,4200,4200,0,0,41975,-37775
INJ_204,20211005,6200,6200,0,0,53963,-47763
INJ_204,20211006,10200,10200,0,1,75944,-65744
INJ_204,20211007,3700,3700,0,0,20991,-17291
INJ_204,20211008,16500,15800,0,-1,140955,-125155
INJ_204,20211009,2100,2100,0,0,20990,-18890
INJ_204,20211011,4800,4800,0,0,47829,-43029
INJ_204,20211012,8000,8000,0,0,79955,-71955
INJ_204,20211013,2000,2000,5,735,19991,-17991
INJ_204,20211014,4900,4100,0,-1,40970,-36870
INJ_204,20211015,2100,2100,0,1,20990,-18890
INJ_204,20211016,10800,9200,0,1,91947,-82747
INJ_204,20211018,10300,10300,0,3,102947,-92647
INJ_204,20211019,3500,3500,0,0,34981,-31481
INJ_204,20211020,5000,5000,0,0,49975,-44975
INJ_204,20211021,4000,4000,0,0,39980,-35980
INJ_204,20211022,5500,5500,0,3,44974,-39474
INJ_204,20211023,11900,11900,0,1,102947,-91047
INJ_204,20211025,4000,4000,0,1,25989,-21989
INJ_204,20211026,7800,7800,0,-1,67964,-60164
INJ_204,20211027,8300,8300,0,0,72959,-64659
INJ_204,20211028,4500,4500,0,2,44980,-40480
INJ_204,20211029,14700,12000,0,0,109936,-97936
INJ_204,20211030,6000,5400,0,1,53970,-48570
INJ_204,20211101,7400,7400,0,2,63965,-56565
INJ_204,20211102,8900,8900,0,-1,88947,-80047
INJ_204,20211103,5600,5600,0,0,41984,-36384
INJ_204,20211104,7600,7600,0,1,65969,-58369
INJ_204,20211105,7500,6000,0,1,53472,-47472
INJ_204,20211106,5400,5400,0,-1,53966,-48566
INJ_204,20211108,6600,6600,0,0,65966,-59366
INJ_204,20211109,6000,6000,0,-2,47972,-41972
INJ_204,20211110,9000,9000,0,0,79952,-70952
INJ_204,20211111,9100,8100,0,0,70963,-62863
INJ_204,20211112,11400,10700,0,3,96944,-86244
INJ_204,20211113,4500,4500,0,0,44981,-40481
INJ_204,20211115,8300,8300,0,2,82962,-74662
INJ_204,20211116,11400,10400,0,0,103943,-93543
INJ_204,20211117,7300,7300,0,1,72958,-65658
INJ_204,20211118,14000,14000,0,2,117938,-103938
INJ_204,20211119,6300,6300,0,1,62968,-56668
INJ_204,20211120,14000,14000,0,1,117924,-103924
INJ_204,20211122,6500,5500,0,1,54970,-49470
INJ_204,20211123,2100,2100,0,-1,20988,-18888
INJ_204,20211124,4500,4500,0,1,44980,-40480
INJ_204,20211125,4900,4900,0,1,48971,-44071
INJ_204,20211126,14700,13900,0,0,110948,-97048
INJ_204,20211127,9800,9800,0,-2,87951,-78151
INJ_204,20211129,6200,5600,0,1,41973,-36373
INJ_204,20211201,11400,10600,0,1,105942,-95342
INJ_204,20211202,6600,6600,0,1,65968,-59368
INJ_204,20211203,14600,14600,0,722,115933,-101333
INJ_204,20211204,19600,16600,0,1,131927,-115327
INJ_204,20211206,10900,10300,0,-2,86954,-76654
INJ_204,20211207,6600,6600,0,1,65966,-59366
INJ_204,20211208,2400,2400,0,0,17986,-15586
INJ_204,20211209,2100,2100,0,0,20991,-18891
INJ_204,20211210,12200,10600,0,1,105948,-95348
INJ_204,20211211,11000,10200,0,-2,83960,-73760
INJ_204,20211213,16200,14700,0,2,122938,-108238
INJ_204,20211214,5900,4400,0,1,35981,-31581
INJ_204,20211215,7100,7100,0,0,70966,-63866
INJ_204,20211216,17300,12300,0,-3,110945,-98645
INJ_204,20211217,6800,5400,0,0,53972,-48572
INJ_204,20211218,1400,1400,0,1,13994,-12594
INJ_204,20211220,8800,8000,0,-2,73957,-65957
INJ_204,20211221,5400,3900,0,0,38976,-35076
INJ_204,20211222,4100,4100,0,1,40975,-36875
INJ_204,20211223,4100,4100,0,2,40973,-36873
INJ_204,20211224,9200,9200,0,-2,81945,-72745
INJ_204,20211225,10700,10700,0,0,96936,-86236
INJ_204,20211227,7300,7300,0,2,72957,-65657
INJ_204,20211228,3700,3700,0,1,36984,-33284
INJ_204,20211229,7300,7300,0,1,56968,-49668
INJ_204,20211230,9400,6400,0,1,43975,-37575
INJ_204,20211231,11600,9800,0,-1,75955,-66155
INJ_204,20220103,8900,8900,0,1,88941,-80041
INJ_204,20220104,4500,4500,0,0,44979,-40479
INJ_204,20220105,8500,8500,0,2,84956,-76456
INJ_204,20220106,15600,15600,0,3,137922,-122322
INJ_204,20220107,10600,10600,0,0,105942,-95342
INJ_204,20220108,1400,1400,0,0,13993,-12593
INJ_204,20220110,9000,9000,0,1,79692,-70692
INJ_204,20220111,8200,7600,0,2,75954,-68354
INJ_204,20220112,6400,6400,0,-1,53968,-47568
INJ_204,20220113,7400,7400,0,1,61965,-54565
INJ_204,20220114,12400,12400,0,-1,115924,-103524
INJ_204,20220115,8700,8000,0,4,79958,-71958
INJ_204,20220117,16300,12900,0,1,124703,-111803
INJ_204,20220118,6900,6300,0,2,62973,-56673
INJ_204,20220119,12800,12100,0,2,100952,-88852
INJ_204,20220120,10900,7700,0,-1,76950,-69250
INJ_204,20220121,10800,10200,0,1,101943,-91743
INJ_204,20220122,11500,11500,0,2,90955,-79455
INJ_204,20220124,8500,8500,0,3,84954,-76454
INJ_204,20220125,16400,15200,0,1,125933,-110733
INJ_204,20220126,6000,4200,0,-1,49796,-45596
INJ_204,20220127,8800,7200,0,2,71966,-64766
INJ_204,20220128,8600,8600,0,0,85960,-77360
INJ_204,20220129,13600,13600,0,1,123936,-110336
INJ_204,20220131,15700,13700,0,-1,142810,-129110
INJ_204,20220201,12500,12500,0,-1,124940,-112440
INJ_204,20220202,3700,3700,0,0,36980,-33280
INJ_204,20220203,9100,9100,0,1,90801,-81701
INJ_204,20220204,6700,6700,0,1,42976,-36276
INJ_204,20220205,6010,5210,0,0,51978,-46768
INJ_204,20220207,10600,9600,0,2,83963,-74363
INJ_204,20220208,17400,15100,0,1,138942,-123842
INJ_204,20220209,8100,8100,0,0,80957,-72857
INJ_204,20220210,7800,7800,0,0,67964,-60164
INJ_204,20220211,13200,12500,0,0,114937,-102437
INJ_204,20220212,20400,20400,0,0,183902,-163502
INJ_204,20220214,11500,8600,0,0,59965,-51365
INJ_204,20220215,6600,6600,0,1,57959,-51359
INJ_204,20220216,6500,6500,0,1,64961,-58461
INJ_204,20220217,8800,8800,0,2,77954,-69154
INJ_204,20220218,7900,7900,0,-2,78954,-71054
INJ_204,20220219,8500,7900,0,2,66962,-59062
INJ_204,20220221,10700,10700,0,2,98945,-88245
INJ_204,20220222,16000,15200,0,-1,133933,-118733
INJ_204,20220223,10600,10600,0,1,105954,-95354
INJ_204,20220224,9800,8400,0,-2,83944,-75544
INJ_204,20220225,9900,9100,0,1,82945,-73845
INJ_204,20220226,3000,3000,0,2,29986,-26986
INJ_204,20220228,8200,7400,0,2,63970,-56570
INJ_204,20220301,13100,12500,0,0,124935,-112435
INJ_204,20220302,16100,14300,0,0,132933,-118633
INJ_204,20220303,4000,4000,0,1,29985,-25985
INJ_204,20220304,1600,1600,0,0,15991,-14391
INJ_204,20220305,6000,6000,0,3,47980,-41980
INJ_204,20220307,5500,5500,0,-1,54968,-49468
INJ_204,20220309,14500,12500,0,1,124936,-112436
INJ_204,20220310,8100,8100,0,2,80957,-72857
INJ_204,20220311,10400,10400,0,7,103942,-93542
INJ_204,20220312,9900,9100,0,0,98948,-89848
INJ_204,20220314,5800,5800,0,1,57973,-52173
INJ_204,20220315,6800,6800,0,1,59967,-53167
INJ_204,20220316,11000,11000,0,2,73963,-62963
INJ_204,20220317,11300,11300,0,3,96945,-85645
INJ_204,20220318,10300,9500,0,2,84958,-75458
INJ_204,20220319,12300,12300,0,1,102941,-90641
INJ_204,20220321,7900,7100,0,0,70968,-63868
INJ_204,20220322,9400,8800,0,1,87953,-79153
INJ_204,20220323,6900,6900,0,2,68960,-62060
INJ_204,20220324,13500,11400,0,1,87956,-76556
INJ_204,20220325,7900,7900,0,1,68968,-61068
INJ_204,20220326,13740,12440,0,2,124317,-111877
INJ_204,20220328,7200,7200,0,-1,59965,-52765
INJ_204,20220329,6200,6200,0,1,61966,-55766
INJ_204,20220330,11700,11700,0,5,100953,-89253
INJ_204,20220331,14000,14000,0,2,133922,-119922
INJ_204,20220401,13200,12600,0,-2,105944,-93344
INJ_204,20220402,14600,14600,0,0,145314,-130714
INJ_204,20220404,11200,10300,0,2,97604,-87304
INJ_204,20220405,9000,8200,0,3,89892,-81692
INJ_204,20220406,6600,6600,0,1,65965,-59365
INJ_204,20220407,12300,11700,0,4,106937,-95237
INJ_204,20220408,7700,7700,0,1,76950,-69250
INJ_204,20220409,12100,12100,0,0,106933,-94833
INJ_204,20220411,8600,7800,0,-1,77953,-70153
INJ_204,20220412,15500,14700,0,2,146917,-132217
INJ_204,20220413,7000,7000,0,0,69964,-62964
INJ_204,20220414,6400,6400,0,2,63957,-57557
INJ_204,20220415,4400,3600,0,1,35981,-32381
INJ_204,20220416,3700,3700,0,0,36979,-33279
INJ_204,20220418,10000,10000,0,2,99942,-89942
INJ_204,20220419,11600,8900,0,1,88954,-80054
INJ_204,20220420,17500,16800,0,1,167896,-151096
INJ_204,20220421,21000,21000,0,6,209891,-188891
INJ_204,20220422,9400,7900,0,0,78951,-71051
INJ_204,20220424,9100,9100,0,1,90954,-81854
INJ_204,20220425,4800,4800,0,0,41977,-37177
INJ_204,20220426,15500,15500,0,0,142926,-127426
INJ_204,20220427,19600,17400,0,3,163930,-146530
INJ_204,20220428,8000,8000,0,0,79963,-71963
INJ_204,20220429,8900,8100,0,0,80954,-72854
INJ_204,20220503,13800,13800,0,1,117929,-104129
INJ_204,20220504,10700,10700,0,1,100940,-90240
INJ_204,20220505,9000,8400,0,1,83958,-75558
INJ_204,20220506,11300,9900,0,1,98950,-89050
INJ_204,20220507,13800,13000,0,-1,129935,-116935
INJ_204,20220509,11000,11000,0,2,109945,-98945
INJ_204,20220510,17400,15900,0,-1,158916,-143016
INJ_204,20220511,11400,9300,0,0,92949,-83649
INJ_204,20220512,17000,17000,0,2,163914,-146914
INJ_204,20220513,10800,10800,0,2,107940,-97140
INJ_204,20220514,15200,14400,0,3,143924,-129524
INJ_204,20220516,15600,14600,0,5,145922,-131322
INJ_204,20220517,12500,11700,0,0,116845,-105145
INJ_204,20220518,7300,7300,0,0,72947,-65647
INJ_204,20220519,15100,13100,0,2,112931,-99831
INJ_204,20220520,15600,14300,0,0,147849,-133549
INJ_204,20220521,18400,16600,0,0,165885,-149285
INJ_204,20220523,16260,16260,0,3,157907,-141647
INJ_204,20220524,12600,12600,0,2,125915,-113315
INJ_204,20220525,11600,11600,0,-1,115924,-104324
INJ_204,20220526,7500,6800,0,2,67954,-61154
INJ_204,20220527,9700,9700,0,0,87949,-78249
INJ_204,20220528,8300,8300,0,-1,82950,-74650
INJ_204,20220530,9800,9800,0,0,97946,-88146
INJ_204,20220531,16100,14500,0,3,144921,-130421
INJ_204,20220601,2100,2100,0,1,20985,-18885
INJ_204,20220602,12000,9000,0,2,84982,-75982
INJ_204,20220603,14260,14260,0,1,135019,-120759
INJ_204,20220604,9150,9150,0,3,83949,-74799
INJ_204,20220606,2400,2400,0,1,23986,-21586
INJ_204,20220607,10900,10900,0,-1,108938,-98038
INJ_204,20220608,6700,6100,0,1,60969,-54869
INJ_204,20220609,13500,10900,0,1,108937,-98037
INJ_204,20220610,8500,7400,0,1,73956,-66556
INJ_204,20220611,12850,12850,0,3,120925,-108075
INJ_204,20220613,11200,10700,0,2,109642,-98942
INJ_204,20220614,9950,7500,0,2,87784,-80284
INJ_204,20220615,24350,18750,0,4,196821,-178071
INJ_204,20220616,7150,7150,0,1,66958,-59808
INJ_204,20220617,10400,10400,0,3,91955,-81555
INJ_204,20220618,10764,9964,0,-2,81029,-71065
INJ_204,20220620,10500,8900,0,1,88856,-79956
INJ_204,20220621,7900,6700,0,1,73958,-67258
INJ_204,20220622,13450,9850,0,429,89740,-79890
INJ_204,20220623,3800,3800,0,0,37975,-34175
INJ_204,20220624,11500,10700,0,3,94953,-84253
INJ_204,20220625,14000,12400,0,0,123929,-111529
INJ_204,20220627,9950,9950,0,0,94933,-84983
INJ_204,20220628,13400,13400,0,0,133881,-120481
INJ_204,20220629,13800,13800,0,-1,128917,-115117
INJ_204,20220630,13900,13100,0,2,130941,-117841
INJ_204,20220701,8250,8250,0,0,68961,-60711
INJ_204,20220702,12200,12200,0,1,112931,-100731
INJ_204,20220704,9900,9900,0,4,68948,-59048
INJ_204,20220705,3800,3800,0,1,37972,-34172
INJ_204,20220706,7900,7900,0,0,66959,-59059
INJ_204,20220707,9550,9550,0,0,66954,-57404
INJ_204,20220708,8250,8250,0,1,77955,-69705
INJ_204,20220709,13650,13650,0,1,107947,-94297
INJ_204,20220711,3700,3700,0,1,36980,-33280
INJ_204,20220712,4050,4050,0,0,35975,-31925
INJ_204,20220713,6600,6600,0,0,65969,-59369
INJ_204,20220714,6200,5400,0,0,53973,-48573
INJ_204,20220715,7500,7500,0,1,74957,-67457
INJ_204,20220716,6300,6300,0,1,62963,-56663
INJ_204,20220718,8950,8950,0,-2,84955,-76005
INJ_204,20220719,10550,10150,0,0,96953,-86803
INJ_204,20220720,3300,3300,0,1,32983,-29683
INJ_204,20220721,8450,8450,0,2,79960,-71510
INJ_204,20220722,13800,11800,0,-1,96935,-85135
INJ_204,20220723,9400,9400,0,1,81941,-72541
INJ_204,20220725,4050,4050,0,0,35977,-31927
INJ_204,20220726,14750,13950,0,0,131932,-117982
INJ_204,20220727,6300,6300,0,0,62967,-56667
INJ_204,20220728,6800,6800,0,0,67962,-61162
INJ_204,20220729,10300,9500,0,0,94953,-85453
INJ_204,20220730,6600,6600,0,0,65734,-59134
INJ_204,20220801,2000,2000,0,1,19992,-17992
INJ_204,20220802,9700,8900,0,1,79948,-71048
INJ_204,20220803,12250,12250,0,-2,114928,-102678
INJ_204,20220804,3800,3800,0,0,37977,-34177
INJ_204,20220805,16350,14550,0,4,104852,-90302
INJ_204,20220806,7300,7300,0,0,72964,-65664
INJ_204,20220808,11550,10950,0,-1,98947,-87997
INJ_204,20220809,7050,6450,0,2,56964,-50514
INJ_204,20220810,8000,8000,0,-1,79952,-71952
INJ_204,20220811,21150,21150,0,3,182880,-161730
INJ_204,20220812,12700,12700,0,4,111931,-99231
INJ_204,20220813,13550,12750,0,-1,110927,-98177
INJ_204,20220815,6900,6900,0,-1,68953,-62053
INJ_204,20220816,14550,12050,0,0,106946,-94896
INJ_204,20220817,14750,13950,0,0,125928,-111978
INJ_204,20220818,14950,14950,0,-1,141926,-126976
INJ_204,20220819,11050,10250,0,0,88950,-78700
INJ_204,20220820,9000,9000,0,2,89958,-80958
INJ_204,20220822,6350,6350,0,1,55966,-49616
INJ_204,20220823,11800,11800,0,3,111930,-100130
INJ_204,20220824,11800,11000,0,1,109930,-98930
INJ_204,20220825,13000,12200,0,0,121938,-109738
INJ_204,20220826,11650,11650,0,2,111947,-100297
INJ_204,20220827,15800,14600,0,1,138911,-124311
INJ_204,20220829,9200,9200,0,1,91954,-82754
INJ_204,20220830,11100,9700,0,1,96947,-87247
INJ_204,20220831,12100,12100,0,2,120940,-108840
INJ_204,20220901,4200,4200,0,0,41969,-37769
INJ_204,20220902,12050,3250,0,-1,24985,-21735
INJ_204,20220903,11200,800,0,1,7997,-7197
INJ_204,20220905,12400,1400,0,0,9622,-8222
INJ_204,20220907,5250,750,0,-1,2997,-2247
INJ_204,20220908,2000,1000,0,0,1975,-975
INJ_204,20220909,9800,9000,0,0,80960,-71960
INJ_204,20220910,7300,7300,0,0,72958,-65658
INJ_204,20220912,11600,11600,0,0,103947,-92347
INJ_204,20220913,6300,6300,0,1,62969,-56669
INJ_204,20220914,1900,1900,0,-1,18983,-17083
INJ_204,20220915,8500,8500,0,3,84943,-76443
INJ_204,20220916,6700,6700,0,-1,66959,-60259
INJ_204,20220917,17300,15300,0,-1,146914,-131614
INJ_204,20220919,6800,6000,0,0,67968,-61968
INJ_204,20220920,3100,3100,0,-1,30982,-27882
INJ_204,20220921,10700,10700,0,1,106949,-96249
INJ_204,20220922,5000,5000,0,0,40983,-35983
INJ_204,20220923,14700,13300,0,2,132921,-119621
INJ_204,20220924,4200,4200,0,0,41979,-37779
INJ_204,20220926,14700,12500,0,2,124815,-112315
INJ_204,20220927,10700,9400,0,0,93944,-84544
INJ_204,20220928,3800,3800,2,911,37981,-34181
INJ_204,20220929,8100,6000,0,1,59964,-53964
INJ_204,20220930,6700,5700,0,0,56968,-51268
INJ_204,20221001,1800,1800,0,1,17991,-16191
INJ_204,20221004,10900,10100,2,911,100951,-90851
INJ_204,20221005,4600,4600,0,0,45977,-41377
INJ_204,20221006,8300,8300,0,2,82945,-74645
INJ_204,20221007,13500,13500,0,1,134924,-121424
INJ_204,20221008,8500,8500,0,1,84950,-76450
INJ_204,20221010,7700,6200,0,718,80953,-74753
INJ_204,20221011,1900,1900,0,0,0,1900
INJ_204,20221012,3000,3000,0,0,20988,-17988
INJ_204,20221013,1900,1900,0,1,18989,-17089
INJ_204,20221014,1800,1500,0,-1,14892,-13392
INJ_204,20221015,6700,6700,0,1,66960,-60260
INJ_204,20221017,8900,8900,0,1,88937,-80037
INJ_204,20221018,10000,10000,0,-1,99946,-89946
INJ_204,20221019,7900,7300,0,3,66967,-59667
INJ_204,20221021,7500,7500,0,0,74957,-67457
INJ_204,20221022,4200,4200,0,1,41975,-37775
INJ_204,20221024,8500,7600,0,0,75952,-68352
INJ_204,20221025,2100,2100,0,-1,20986,-18886
INJ_204,20221026,9700,9200,0,1,91946,-82746
INJ_204,20221027,5600,5600,0,0,55970,-50370
INJ_204,20221028,8800,8100,0,2,80952,-72852
INJ_204,20221029,13500,13500,0,0,134926,-121426
INJ_204,20221031,9850,9850,0,-2,90956,-81106
INJ_204,20221101,6000,6000,0,0,59967,-53967
INJ_204,20221102,8750,8750,0,1,82949,-74199
INJ_204,20221104,5200,5200,0,1,51973,-46773
INJ_204,20221105,5900,5300,0,-1,52974,-47674
INJ_204,20221107,6300,6300,0,2,62966,-56666
INJ_204,20221108,6250,6250,0,1,54973,-48723
INJ_204,20221109,7400,7400,0,-1,73962,-66562
INJ_204,20221110,2900,2100,0,1,20986,-18886
INJ_204,20221111,8100,8100,0,0,80950,-72850
INJ_204,20221112,2100,2100,0,1,20988,-18888
INJ_204,20221114,5000,4200,0,2,41978,-37778
INJ_204,20221115,2600,2600,0,0,25983,-23383
INJ_204,20221116,9500,9500,0,2,94940,-85440
INJ_204,20221117,11600,9800,0,0,97943,-88143
INJ_204,20221118,6700,6700,0,-2,66960,-60260
INJ_204,20221119,10400,10400,0,-1,103945,-93545
INJ_204,20221121,9400,9400,0,1,93944,-84544
INJ_204,20221122,7200,7200,0,-2,71965,-64765
INJ_204,20221123,7900,7900,0,2,78965,-71065
INJ_204,20221124,5000,4200,0,0,41973,-37773
INJ_204,20221125,6700,6700,0,0,66960,-60260
INJ_204,20221126,6800,6800,0,0,67961,-61161
INJ_204,20221129,10050,10050,0,3,95949,-85899
INJ_204,20221130,2100,2100,0,-1,20987,-18887
INJ_204,20221201,2200,1400,0,0,13994,-12594
INJ_204,20221202,11900,7700,0,-1,76951,-69251
INJ_204,20221203,6800,6800,0,0,67959,-61159
INJ_204,20221205,7050,7050,0,1,65953,-58903
INJ_204,20221206,6200,5600,0,1,55968,-50368
INJ_204,20221207,2200,1400,0,-1,13995,-12595
INJ_204,20221208,3450,3450,0,-1,29983,-26533
INJ_204,20221210,11500,7500,0,3,74963,-67463
INJ_204,20221212,2100,2100,0,0,20987,-18887
INJ_204,20221213,3900,1400,0,0,13990,-12590
INJ_204,20221214,16400,1400,0,-1,13993,-12593
INJ_204,20221215,11200,800,0,0,7997,-7197
INJ_204,20221216,22200,1800,0,0,15788,-13988
INJ_204,20221217,11200,800,0,0,7997,-7197
INJ_204,20221219,17800,1400,0,0,13993,-12593
INJ_204,20221220,31400,3000,0,-3,26619,-23619
INJ_204,20221221,16400,1400,0,1,13994,-12594
INJ_204,20221222,10400,800,0,-3,7996,-7196
INJ_204,20221223,22200,5100,0,-7,31979,-26879
INJ_204,20221224,4200,600,0,0,5997,-5397
INJ_204,20221226,16400,5500,0,-1,54969,-49469
INJ_204,20221227,8400,8400,0,-1,83952,-75552
INJ_204,20221228,5850,5850,0,2,50970,-45120
INJ_204,20221229,10300,9700,0,0,87946,-78246
INJ_204,20221230,3600,2800,0,-1,27985,-25185
INJ_204,20221231,6300,6300,0,2,62967,-56667
INJ_204,20230102,2100,2100,0,0,20987,-18887
INJ_204,20230103,7400,7400,0,0,61963,-54563
INJ_204,20230104,2400,2400,0,0,23986,-21586
INJ_204,20230105,4050,4050,0,0,32993,-28943
INJ_204,20230106,8000,8000,0,2,79975,-71975
INJ_204,20230107,6400,6400,0,0,63985,-57585
INJ_204,20230109,3100,3100,0,1,30992,-27892
INJ_204,20230110,1700,1700,0,-1,16994,-15294
INJ_204,20230111,5000,5000,0,0,49992,-44992
INJ_204,20230112,4900,4900,0,1,48989,-44089
INJ_204,20230113,2200,1400,0,0,13994,-12594
INJ_204,20230114,5900,5900,0,0,58984,-53084
INJ_204,20230116,5900,4100,0,0,43979,-39879
INJ_204,20230117,8000,7000,0,1,69983,-62983
INJ_204,20230118,4100,4100,0,0,40990,-36890
INJ_204,20230119,6800,5200,0,-1,51989,-46789
INJ_204,20230120,5100,4100,0,0,40988,-36888
INJ_204,20230121,7700,6500,0,1,64982,-58482
INJ_204,20230123,2100,2100,0,0,20996,-18896
INJ_204,20230124,8850,7550,0,2,70987,-63437
INJ_204,20230125,6050,6050,0,-1,46994,-40944
INJ_204,20230126,3800,3800,0,0,37993,-34193
INJ_204,20230127,5300,5300,0,2,52989,-47689
INJ_204,20230128,3500,3500,0,-1,34994,-31494
INJ_204,20230130,4900,4900,0,2,48986,-44086
INJ_204,20230131,9300,9000,0,2,80976,-71976
INJ_204,20230201,5950,5950,0,1,54988,-49038
INJ_204,20230202,3900,3900,0,0,29992,-26092
INJ_204,20230203,3800,3800,0,0,37984,-34184
INJ_204,20230204,3600,3200,0,0,31992,-28792
INJ_204,20230206,2050,2050,0,0,15995,-13945
INJ_204,20230207,3950,3950,0,2,31991,-28041
INJ_204,20230208,5000,5000,0,-1,37991,-32991
INJ_204,20230209,3200,3200,0,1,31991,-28791
INJ_204,20230210,4400,4400,0,0,43986,-39586
INJ_204,20230211,6300,6300,0,0,53979,-47679
INJ_204,20230213,4500,4500,0,0,44986,-40486
INJ_204,20230214,30300,3300,0,-2,32987,-29687
INJ_204,20230215,2400,2400,0,-1,23993,-21593
INJ_204,20230216,6100,6100,0,1,48992,-42892
INJ_204,20230217,12150,10650,0,-1,92984,-82334
INJ_204,20230218,3100,3100,0,0,30990,-27890
INJ_204,20230220,2600,2600,0,0,25990,-23390
INJ_204,20230221,2750,2750,0,-1,22993,-20243
INJ_204,20230222,7900,7100,0,1,52986,-45886
INJ_204,20230223,3150,2750,0,0,26993,-24243
INJ_204,20230224,8300,8300,0,0,82977,-74677
INJ_204,20230225,8450,7650,0,1,71982,-64332
INJ_204,20230227,8650,4650,0,0,41992,-37342
INJ_204,20230228,2400,1600,0,-1,15995,-14395
INJ_204,20230301,3000,3000,0,1,29992,-26992
INJ_204,20230302,9250,9250,0,-2,87978,-78728
INJ_204,20230303,4100,4100,0,1,34993,-30893
INJ_204,20230304,6800,6000,0,1,59991,-53991
INJ_204,20230306,3100,3100,0,-1,30990,-27890
INJ_204,20230307,6700,6700,0,1,60986,-54286
INJ_204,20230308,5700,5700,0,-1,47989,-42289
INJ_204,20230309,7200,6400,0,1,57988,-51588
INJ_204,20230310,8900,8900,0,2,88985,-80085
INJ_204,20230311,6900,6900,0,-2,68990,-62090
INJ_204,20230313,4200,4200,0,1,41990,-37790
INJ_204,20230314,1750,1750,0,0,12993,-11243
INJ_204,20230315,6200,6200,0,1,61987,-55787
INJ_204,20230316,9850,9850,0,-1,78983,-69133
INJ_204,20230317,5500,4500,0,0,48985,-44485
INJ_204,20230318,6500,5700,0,0,41986,-36286
INJ_204,20230320,8200,8200,0,1,63979,-55779
INJ_204,20230321,8150,8150,0,0,61984,-53834
INJ_204,20230322,15150,13850,0,1,106975,-93125
INJ_204,20230323,5650,5650,0,0,33994,-28344
INJ_204,20230324,11550,11550,0,2,92982,-81432
INJ_204,20230325,3300,3300,0,0,32988,-29688
INJ_204,20230327,11600,11600,0,0,88980,-77380
INJ_204,20230328,4700,4700,0,1,46992,-42292
INJ_204,20230329,5100,5100,0,0,50981,-45881
INJ_204,20230330,2900,2900,0,1,28989,-26089
INJ_204,20230331,5250,4750,0,0,42983,-38233
INJ_204,20230401,7000,7000,0,0,69977,-62977
INJ_204,20230403,12500,12500,0,2,100970,-88470
INJ_204,20230404,5000,5000,0,1,49989,-44989
INJ_204,20230405,84400,6650,0,-1,46989,-40339
INJ_204,20230406,17300,16700,0,3,118973,-102273
INJ_204,20230407,9450,8450,0,0,61991,-53541
INJ_204,20230408,11500,11500,0,2,90970,-79470
INJ_204,20230410,10350,8550,0,-1,77980,-69430
INJ_204,20230411,6000,6000,0,1,59985,-53985
INJ_204,20230412,12600,12600,0,1,98983,-86383
INJ_204,20230413,11900,10900,0,0,108982,-98082
INJ_204,20230414,6450,6450,0,0,44989,-38539
INJ_204,20230415,9050,9050,0,1,70982,-61932
INJ_204,20230417,8650,8650,0,2,81983,-73333
INJ_204,20230418,12300,10300,0,1,102969,-92669
INJ_204,20230419,11550,11550,0,0,89930,-78380
INJ_204,20230420,15700,15700,0,0,105966,-90266
INJ_204,20230421,13400,13400,0,2,97965,-84565
INJ_204,20230424,20150,16900,0,0,117953,-101053
INJ_204,20230425,20650,13900,0,0,92097,-78197
INJ_204,20230426,7100,7100,0,5,64985,-57885
INJ_204,20230427,6750,6750,0,0,44980,-38230
INJ_204,20230428,5250,5250,0,1,47988,-42738
INJ_204,20230429,8850,8850,0,1,62986,-54136
INJ_204,20230501,7800,6000,0,-1,59987,-53987
INJ_204,20230502,14050,12300,0,-1,92976,-80676
INJ_204,20230503,18150,18150,0,0,128971,-110821
INJ_204,20230504,19800,19800,0,0,149943,-130143
INJ_204,20230505,16250,16250,0,2,91969,-75719
INJ_204,20230506,12560,11960,0,3,112036,-100076
INJ_204,20230508,10100,9500,0,0,79979,-70479
INJ_204,20230509,7800,7200,0,-1,62985,-55785
INJ_204,20230510,8200,8200,0,2,81988,-73788
INJ_204,20230511,10900,10900,0,0,108979,-98079
INJ_204,20230512,10000,10000,0,0,99981,-89981
INJ_204,20230513,6200,6200,0,1,61981,-55781
INJ_204,20230515,11950,11950,0,-1,90975,-79025
INJ_204,20230516,15550,14750,0,1,103979,-89229
INJ_204,20230517,18550,17550,0,2,119975,-102425
INJ_204,20230518,11750,11750,0,3,94979,-83229
INJ_204,20230519,5100,3550,0,1,30992,-27442
INJ_204,20230520,11100,11100,0,1,110972,-99872
INJ_204,20230522,17300,14900,0,1,127963,-113063
INJ_204,20230523,7800,6200,0,1,61987,-55787
INJ_204,20230524,7100,7100,0,0,70984,-63884
INJ_204,20230525,7700,7700,0,0,76981,-69281
INJ_204,20230526,12200,12200,0,0,94987,-82787
INJ_204,20230527,6200,6200,0,4,61989,-55789
INJ_204,20230529,11850,11850,0,1,98973,-87123
INJ_204,20230530,21100,21100,0,-1,138950,-117850
INJ_204,20230531,16050,15450,0,0,110951,-95501
INJ_204,20230601,9650,8850,0,-2,62984,-54134
INJ_204,20230602,16150,16150,0,3,141961,-125811
INJ_204,20230603,7500,6900,0,0,68987,-62087
INJ_204,20230605,16000,15200,0,9,145971,-130771
INJ_204,20230606,9200,7600,0,-2,75984,-68384
INJ_204,20230607,13900,13400,0,1,112975,-99575
INJ_204,20230608,9800,9800,0,2,97984,-88184
INJ_204,20230609,9200,9200,0,0,91987,-82787
INJ_204,20230610,8400,8400,0,4,83978,-75578
INJ_204,20230612,11200,9450,0,3,74981,-65531
INJ_204,20230613,8400,7400,0,2,73981,-66581
INJ_204,20230614,3800,3000,0,0,29991,-26991
INJ_204,20230615,8300,8300,0,0,67984,-59684
INJ_204,20230616,8150,8150,0,0,61989,-53839
INJ_204,20230617,9900,9900,0,3,98969,-89069
INJ_204,20230619,10000,9000,0,2,89976,-80976
INJ_204,20230620,11300,10700,0,5,106919,-96219
INJ_204,20230621,16000,16000,0,8,147969,-131969
INJ_204,20230622,14050,14050,0,3,120975,-106925
INJ_204,20230623,17000,17000,0,2,124941,-107941
INJ_204,20230624,10350,8750,0,0,61794,-53044
INJ_204,20230626,14000,13200,0,1,107967,-94767
INJ_204,20230627,6450,5450,0,0,49985,-44535
INJ_204,20230628,12300,11300,0,0,103975,-92675
INJ_204,20230630,2150,2150,0,1,16996,-14846
INJ_204,20230701,4500,4500,0,-1,44989,-40489
INJ_204,20230703,9300,9300,0,2,68979,-59679
INJ_204,20230704,17000,16000,0,3,135967,-119967
INJ_204,20230705,9000,9000,0,4,74976,-65976
INJ_204,20230706,16300,14700,0,-2,86973,-72273
INJ_204,20230707,11250,11250,0,-1,104981,-93731
INJ_204,20230708,6500,6500,0,-1,64983,-58483
INJ_204,20230710,13950,12950,0,1,94969,-82019
INJ_204,20230711,5400,5400,0,2,53979,-48579
INJ_204,20230712,6200,6200,0,0,61798,-55598
INJ_204,20230713,24150,9200,0,-1,89833,-80633
INJ_204,20230714,24900,20050,0,3,152952,-132902
INJ_204,20230715,16700,15000,0,3,138114,-123114
INJ_204,20230717,30600,8700,0,-1,86985,-78285
INJ_204,20230718,10900,10900,0,2,81977,-71077
INJ_204,20230719,5900,5900,0,0,58984,-53084
INJ_205,20210927,3375,3375,0,0,8980,-5605
INJ_205,20210928,4500,4500,0,-1,11969,-7469
INJ_205,20210929,3000,3000,0,0,7984,-4984
INJ_205,20210930,1875,1875,0,1,4992,-3117
INJ_205,20211002,3375,3375,0,0,8983,-5608
INJ_205,20211004,1500,1500,0,0,3993,-2493
INJ_205,20211005,1875,1875,0,0,4993,-3118
INJ_205,20211006,6000,6000,0,-1,15976,-9976
INJ_205,20211008,7875,7875,0,0,20956,-13081
INJ_205,20211009,1875,1875,0,0,4993,-3118
INJ_205,20211011,1500,1500,0,0,3980,-2480
INJ_205,20211012,6000,6000,0,0,15976,-9976
INJ_205,20211014,2250,2250,0,0,5989,-3739
INJ_205,20211015,1875,1875,0,0,4991,-3116
INJ_205,20211016,4875,3000,0,-1,7982,-4982
INJ_205,20211018,1500,1500,0,0,3989,-2489
INJ_205,20211019,3000,3000,0,0,7979,-4979
INJ_205,20211021,3000,3000,0,1,7980,-4980
INJ_205,20211022,1500,1500,0,0,3990,-2490
INJ_205,20211023,1125,1125,0,0,2992,-1867
INJ_205,20211025,1500,1500,0,-1,3993,-2493
INJ_205,20211026,3375,3375,0,0,8984,-5609
INJ_205,20211027,1500,1500,0,0,3992,-2492
INJ_205,20211030,1875,1875,0,0,4992,-3117
INJ_205,20211101,2250,2250,0,0,5991,-3741
INJ_205,20211102,4125,4125,0,0,10972,-6847
INJ_205,20211103,1125,1125,0,-1,2992,-1867
INJ_205,20211104,1500,1500,0,1,3993,-2493
INJ_205,20211105,4500,4500,0,0,11983,-7483
INJ_205,20211106,3375,3375,0,-1,8979,-5604
INJ_205,20211108,3000,3000,0,0,7982,-4982
INJ_205,20211109,1500,1500,0,0,3991,-2491
INJ_205,20211110,1500,1500,0,0,3990,-2490
INJ_205,20211111,3000,3000,0,0,7986,-4986
INJ_205,20211112,4500,4500,0,0,11974,-7474
INJ_205,20211115,5250,5250,0,1,13978,-8728
INJ_205,20211116,3000,3000,0,0,7983,-4983
INJ_205,20211117,5250,5250,0,-1,13973,-8723
INJ_205,20211118,5625,5625,0,-1,14973,-9348
INJ_205,20211119,3750,3750,0,0,9982,-6232
INJ_205,20211120,2625,2625,0,1,6983,-4358
INJ_205,20211126,10500,8625,0,0,22957,-14332
INJ_205,20211127,3375,3375,0,0,8984,-5609
INJ_205,20211129,1500,1500,0,0,3990,-2490
INJ_205,20211201,5625,5625,0,1,14962,-9337
INJ_205,20211202,1500,1500,0,0,3991,-2491
INJ_205,20211203,1500,1500,0,0,3991,-2491
INJ_205,20211204,9000,9000,0,1,23950,-14950
INJ_205,20211207,1500,1500,0,0,3992,-2492
INJ_205,20211210,9375,6375,0,0,16962,-10587
INJ_205,20211211,6750,4875,0,1,12967,-8092
INJ_205,20211213,4125,4125,0,0,10977,-6852
INJ_205,20211214,2625,2625,0,0,6980,-4355
INJ_205,20211215,3375,3375,0,0,8979,-5604
INJ_205,20211216,3375,3375,0,0,8985,-5610
INJ_205,20211217,1125,1125,0,-1,2990,-1865
INJ_205,20211218,1875,1875,0,1,4990,-3115
INJ_205,20211220,6000,6000,0,0,15981,-9981
INJ_205,20211221,1500,1500,0,0,3990,-2490
INJ_205,20211222,3375,3375,0,1,8985,-5610
INJ_205,20211223,9375,9375,0,1,24965,-15590
INJ_205,20211224,4500,4500,0,-1,11977,-7477
INJ_205,20211225,3375,3375,0,0,8984,-5609
INJ_205,20211227,1125,1125,0,0,2993,-1868
INJ_205,20211228,1500,1500,0,0,3990,-2490
INJ_205,20211229,3000,3000,0,0,7980,-4980
INJ_205,20211230,1500,1500,0,0,3991,-2491
INJ_205,20211231,1875,1875,0,0,4993,-3118
INJ_205,20220103,4125,4125,0,0,10982,-6857
INJ_205,20220104,1500,1500,0,-1,3994,-2494
INJ_205,20220105,1125,1125,0,0,2992,-1867
INJ_205,20220106,5625,5625,0,1,14969,-9344
INJ_205,20220107,4500,4500,0,0,11975,-7475
INJ_205,20220108,1500,1500,0,0,3993,-2493
INJ_205,20220110,3375,3375,0,1,8984,-5609
INJ_205,20220111,1875,1875,0,-1,4992,-3117
INJ_205,20220112,3375,3375,0,1,8986,-5611
INJ_205,20220113,4500,4500,0,-1,11979,-7479
INJ_205,20220114,4875,4875,0,0,12978,-8103
INJ_205,20220117,3750,2250,0,0,9976,-7726
INJ_205,20220118,4875,4875,0,-1,12976,-8101
INJ_205,20220119,4875,4875,0,-1,12977,-8102
INJ_205,20220120,7500,3750,0,0,9907,-6157
INJ_205,20220121,6000,6000,0,-1,15962,-9962
INJ_205,20220122,3375,3375,0,1,8985,-5610
INJ_205,20220124,1500,1500,0,-1,3991,-2491
INJ_205,20220125,1875,1875,0,1,4992,-3117
INJ_205,20220128,2250,2250,0,0,5994,-3744
INJ_205,20220129,4875,4875,0,0,12973,-8098
INJ_205,20220131,8250,6000,0,1,21104,-15104
INJ_205,20220201,3375,3375,0,0,8986,-5611
INJ_205,20220202,3000,3000,0,-1,7985,-4985
INJ_205,20220203,6000,4125,0,1,11014,-6889
INJ_205,20220204,2625,2625,0,0,6983,-4358
INJ_205,20220205,2250,1125,0,0,2994,-1869
INJ_205,20220207,5250,5250,0,0,13977,-8727
INJ_205,20220208,1875,1875,0,0,4994,-3119
INJ_205,20220209,4875,4875,0,0,12979,-8104
INJ_205,20220210,3000,3000,0,1,7984,-4984
INJ_205,20220211,3750,3750,0,-1,9983,-6233
INJ_205,20220212,7875,7875,0,1,20967,-13092
INJ_205,20220214,3750,3750,0,0,9981,-6231
INJ_205,20220215,1125,1125,0,0,2991,-1866
INJ_205,20220216,5250,5250,0,0,13966,-8716
INJ_205,20220217,4875,4875,0,0,12977,-8102
INJ_205,20220218,4500,4500,0,-1,11978,-7478
INJ_205,20220219,6375,4875,0,1,12973,-8098
INJ_205,20220221,2625,2625,0,0,6981,-4356
INJ_205,20220222,4500,4500,0,-1,11978,-7478
INJ_205,20220223,5250,5250,0,1,13979,-8729
INJ_205,20220224,3000,3000,0,0,7984,-4984
INJ_205,20220225,8625,6750,0,0,17969,-11219
INJ_205,20220226,2625,2625,0,0,6982,-4357
INJ_205,20220228,1125,1125,0,0,2895,-1770
INJ_205,20220301,3375,3375,0,0,8983,-5608
INJ_205,20220302,7875,7875,0,1,20956,-13081
INJ_205,20220303,1500,1500,0,1,3991,-2491
INJ_205,20220304,1500,1500,0,0,3993,-2493
INJ_205,20220307,5625,5625,0,-1,14974,-9349
INJ_205,20220309,19500,15750,0,0,41929,-26179
INJ_205,20220310,3750,3750,0,0,9984,-6234
INJ_205,20220311,2625,2625,0,-1,6985,-4360
INJ_205,20220312,7875,7875,0,1,20961,-13086
INJ_205,20220314,3750,3750,0,-1,9985,-6235
INJ_205,20220315,7875,7875,0,0,20964,-13089
INJ_205,20220316,3750,3750,0,1,9984,-6234
INJ_205,20220317,8625,8625,0,0,22966,-14341
INJ_205,20220318,10125,7875,0,1,20962,-13087
INJ_205,20220319,9375,9375,0,0,24960,-15585
INJ_205,20220321,4125,3000,0,1,7984,-4984
INJ_205,20220322,6000,6000,0,-1,15976,-9976
INJ_205,20220323,2625,2625,0,0,6983,-4358
INJ_205,20220324,6000,6000,0,0,15962,-9962
INJ_205,20220326,1500,1500,0,-1,3990,-2490
INJ_205,20220328,5250,5250,0,0,13977,-8727
INJ_205,20220329,3375,3375,0,0,8984,-5609
INJ_205,20220330,3000,3000,0,0,7989,-4989
INJ_205,20220331,4875,4875,0,-1,12977,-8102
INJ_205,20220401,3000,3000,0,0,7986,-4986
INJ_205,20220402,5250,5250,0,0,13971,-8721
INJ_205,20220404,1125,1125,0,0,2993,-1868
INJ_205,20220405,3375,3375,0,0,8986,-5611
INJ_205,20220407,11250,11250,0,0,29956,-18706
INJ_205,20220408,1875,1875,0,0,4992,-3117
INJ_205,20220409,3750,3750,0,0,9987,-6237
INJ_205,20220411,4875,4875,0,1,12974,-8099
INJ_205,20220412,1125,1125,0,0,2992,-1867
INJ_205,20220413,3000,3000,0,-1,7984,-4984
INJ_205,20220414,9000,9000,0,0,23967,-14967
INJ_205,20220415,6000,4125,0,0,10976,-6851
INJ_205,20220418,4125,4125,0,-1,10976,-6851
INJ_205,20220419,2250,2250,0,0,5983,-3733
INJ_205,20220420,3750,3750,0,-1,9974,-6224
INJ_205,20220421,13875,12000,0,0,31949,-19949
INJ_205,20220422,1125,1125,0,0,2989,-1864
INJ_205,20220424,3000,3000,0,-1,7984,-4984
INJ_205,20220425,1875,1875,0,0,4990,-3115
INJ_205,20220426,7125,7125,0,1,18963,-11838
INJ_205,20220427,8625,8625,0,0,22957,-14332
INJ_205,20220428,4875,4875,0,-1,12977,-8102
INJ_205,20220503,5250,5250,0,1,13969,-8719
INJ_205,20220504,5250,5250,0,-1,13964,-8714
INJ_205,20220505,3000,3000,0,0,7982,-4982
INJ_205,20220506,10500,9000,0,0,23959,-14959
INJ_205,20220507,9000,9000,0,0,23959,-14959
INJ_205,20220509,3375,3375,0,-1,8977,-5602
INJ_205,20220510,5625,3750,0,0,9984,-6234
INJ_205,20220511,6000,6000,0,0,15963,-9963
INJ_205,20220512,4875,4875,0,0,12973,-8098
INJ_205,20220513,1875,1875,0,-1,4990,-3115
INJ_205,20220514,9375,9375,0,2,24949,-15574
INJ_205,20220516,4500,4500,0,0,11976,-7476
INJ_205,20220517,3375,3375,0,-1,8984,-5609
INJ_205,20220518,6375,6375,0,1,16966,-10591
INJ_205,20220519,8325,6450,0,0,17968,-11518
INJ_205,20220520,10500,9000,0,0,29950,-20950
INJ_205,20220521,8700,5700,0,0,18967,-13267
INJ_205,20220523,6300,6300,0,1,20956,-14656
INJ_205,20220524,2700,2700,0,0,8984,-6284
INJ_205,20220525,3000,3000,0,1,9986,-6986
INJ_205,20220526,900,900,0,0,2993,-2093
INJ_205,20220527,2100,2100,0,0,6984,-4884
INJ_205,20220528,4500,4500,0,0,14975,-10475
INJ_205,20220530,7200,7200,0,-1,23958,-16758
INJ_205,20220531,4200,4200,0,1,13973,-9773
INJ_205,20220602,3900,2700,0,-1,8835,-6135
INJ_205,20220603,6600,6600,0,1,21945,-15345
INJ_205,20220604,1500,1500,0,-1,4991,-3491
INJ_205,20220607,3900,3900,0,1,12971,-9071
INJ_205,20220608,3000,3000,0,0,9982,-6982
INJ_205,20220609,6150,4650,0,1,11977,-7327
INJ_205,20220610,6300,6300,0,0,20958,-14658
INJ_205,20220611,6000,6000,0,0,19951,-13951
INJ_205,20220613,1500,1500,0,1,4990,-3490
INJ_205,20220614,1200,1200,0,0,3991,-2791
INJ_205,20220615,4200,4200,0,0,13966,-9766
INJ_205,20220616,1200,1200,0,0,3990,-2790
INJ_205,20220617,1200,1200,0,1,3991,-2791
INJ_205,20220618,8400,6900,0,0,18332,-11432
INJ_205,20220620,1800,1800,0,0,5981,-4181
INJ_205,20220621,2400,2400,0,0,7982,-5582
INJ_205,20220622,5550,4350,0,0,10972,-6622
INJ_205,20220623,1200,1200,0,0,3989,-2789
INJ_205,20220624,4500,4500,0,-1,14972,-10472
INJ_205,20220625,1200,1200,0,0,3992,-2792
INJ_205,20220627,6600,6600,0,0,21946,-15346
INJ_205,20220628,4200,4200,0,0,13961,-9761
INJ_205,20220629,3900,3900,0,0,12975,-9075
INJ_205,20220630,6300,5100,0,0,16963,-11863
INJ_205,20220701,2100,2100,0,0,6984,-4884
INJ_205,20220702,3600,3600,0,0,11974,-8374
INJ_205,20220704,3600,3600,0,1,11980,-8380
INJ_205,20220706,4200,4200,0,0,13971,-9771
INJ_205,20220708,5700,5700,0,0,18965,-13265
INJ_205,20220709,5700,5700,0,1,18966,-13266
INJ_205,20220711,3900,3900,0,0,12975,-9075
INJ_205,20220712,1200,1200,0,0,3991,-2791
INJ_205,20220713,3000,3000,0,1,9981,-6981
INJ_205,20220714,3300,3300,0,1,10973,-7673
INJ_205,20220715,4200,4200,0,-1,13974,-9774
INJ_205,20220716,2700,2700,0,0,8983,-6283
INJ_205,20220718,3300,3300,0,-1,10975,-7675
INJ_205,20220719,6300,6300,0,1,20965,-14665
INJ_205,20220720,2700,2700,0,0,8982,-6282
INJ_205,20220721,1500,1500,0,0,4992,-3492
INJ_205,20220722,4200,4200,0,0,13976,-9776
INJ_205,20220723,5100,5100,0,0,16966,-11866
INJ_205,20220725,2700,2700,0,0,8983,-6283
INJ_205,20220726,12500,10700,0,-1,30927,-20227
INJ_205,20220727,2400,2400,0,1,7981,-5581
INJ_205,20220728,3000,3000,0,0,9981,-6981
INJ_205,20220729,6300,6300,0,-1,20961,-14661
INJ_205,20220730,1200,1200,0,0,3991,-2791
INJ_205,20220801,1800,1800,0,0,5991,-4191
INJ_205,20220802,9000,8100,0,0,26954,-18854
INJ_205,20220803,4500,4500,0,0,14972,-10472
INJ_205,20220804,1200,1200,0,1,3991,-2791
INJ_205,20220805,11050,9550,0,-1,25946,-16396
INJ_205,20220806,2700,2700,0,1,8981,-6281
INJ_205,20220808,13500,13500,0,-1,44919,-31419
INJ_205,20220809,3300,3300,0,-1,10983,-7683
INJ_205,20220810,5700,5700,0,0,18966,-13266
INJ_205,20220811,8300,8300,0,1,22953,-14653
INJ_205,20220812,5700,5700,0,0,18966,-13266
INJ_205,20220813,1800,1800,0,0,5981,-4181
INJ_205,20220815,4800,4800,0,-1,15966,-11166
INJ_205,20220816,6600,3900,0,0,12767,-8867
INJ_205,20220817,9300,9300,0,0,30950,-21650
INJ_205,20220818,5100,5100,0,0,16967,-11867
INJ_205,20220819,4800,4800,0,0,15899,-11099
INJ_205,20220820,3600,3600,0,0,11974,-8374
INJ_205,20220822,3000,3000,0,-1,9983,-6983
INJ_205,20220823,8400,8400,0,0,27937,-19537
INJ_205,20220824,3900,3900,0,0,12983,-9083
INJ_205,20220825,8050,8050,0,0,20951,-12901
INJ_205,20220826,2400,2400,0,-1,7982,-5582
INJ_205,20220827,9000,7200,0,0,23950,-16750
INJ_205,20220829,7200,7200,0,0,23957,-16757
INJ_205,20220830,5400,4200,0,0,13972,-9772
INJ_205,20220831,3600,3600,0,0,11974,-8374
INJ_205,20220901,1500,1500,0,0,4993,-3493
INJ_205,20220902,3600,3600,0,0,11974,-8374
INJ_205,20220903,1800,1800,0,0,5978,-4178
INJ_205,20220905,2700,2700,0,0,8982,-6282
INJ_205,20220906,1500,1500,0,1,4989,-3489
INJ_205,20220907,1800,1800,0,-1,5989,-4189
INJ_205,20220908,1500,1500,0,0,4990,-3490
INJ_205,20220909,5100,3900,0,1,12972,-9072
INJ_205,20220910,1800,1800,0,0,5982,-4182
INJ_205,20220912,2100,2100,0,1,6981,-4881
INJ_205,20220913,900,900,0,0,2992,-2092
INJ_205,20220915,3000,3000,0,-1,9980,-6980
INJ_205,20220916,4200,4200,0,0,13974,-9774
INJ_205,20220917,7800,6900,0,-1,22954,-16054
INJ_205,20220919,2100,2100,0,0,6983,-4883
INJ_205,20220920,2400,2400,0,-1,7982,-5582
INJ_205,20220921,2700,2700,0,0,8982,-6282
INJ_205,20220922,7200,7200,0,1,23968,-16768
INJ_205,20220923,6900,4800,0,-1,15969,-11169
INJ_205,20220924,2700,2700,0,1,8985,-6285
INJ_205,20220926,3900,2400,0,0,7982,-5582
INJ_205,20220927,8100,6900,0,0,22958,-16058
INJ_205,20220928,1200,1200,0,0,3995,-2795
INJ_205,20220929,900,900,0,0,2992,-2092
INJ_205,20220930,6000,4200,0,0,13973,-9773
INJ_205,20221001,1200,1200,0,0,3990,-2790
INJ_205,20221004,2100,2100,5,656,6980,-4880
INJ_205,20221007,1200,1200,0,0,3993,-2793
INJ_205,20221010,5400,2700,0,0,8983,-6283
INJ_205,20221014,1800,1800,0,0,5991,-4191
INJ_205,20221015,6600,6600,0,1,21965,-15365
INJ_205,20221017,1500,1500,0,1,4992,-3492
INJ_205,20221018,4800,4800,0,0,15976,-11176
INJ_205,20221019,2100,2100,0,1,6981,-4881
INJ_205,20221021,5400,5400,0,-1,17976,-12576
INJ_205,20221022,2700,2700,0,0,8984,-6284
INJ_205,20221025,1500,1500,0,0,4993,-3493
INJ_205,20221026,11100,9300,0,0,30950,-21650
INJ_205,20221027,900,900,0,-1,2991,-2091
INJ_205,20221028,6300,6300,0,1,20966,-14666
INJ_205,20221029,2400,2400,0,0,7985,-5585
INJ_205,20221031,5400,4500,0,1,14976,-10476
INJ_205,20221101,5100,5100,0,-1,16975,-11875
INJ_205,20221102,2700,2700,0,-1,8984,-6284
INJ_205,20221104,3000,3000,0,1,9981,-6981
INJ_205,20221105,3600,2400,0,-1,7985,-5585
INJ_205,20221107,2700,2700,0,0,8986,-6286
INJ_205,20221108,3000,3000,0,0,9986,-6986
INJ_205,20221109,2700,2700,0,1,8982,-6282
INJ_205,20221110,1200,1200,0,0,3990,-2790
INJ_205,20221112,1500,1500,0,0,4991,-3491
INJ_205,20221114,900,900,0,0,2990,-2090
INJ_205,20221116,7800,7800,0,-1,25960,-18160
INJ_205,20221117,5400,5400,0,-1,17968,-12568
INJ_205,20221118,1500,1500,0,0,4992,-3492
INJ_205,20221119,5400,3000,0,0,15412,-12412
INJ_205,20221123,2700,2700,0,0,8980,-6280
INJ_205,20221124,3600,2400,0,1,7982,-5582
INJ_205,20221125,900,900,0,0,2991,-2091
INJ_205,20221129,2400,2400,0,1,7982,-5582
INJ_205,20221201,2400,2400,0,0,7983,-5583
INJ_205,20221202,2400,2400,0,0,7981,-5581
INJ_205,20221203,2400,2400,0,0,7982,-5582
INJ_205,20221205,4200,4200,0,0,13961,-9761
INJ_205,20221206,2700,2700,0,0,8980,-6280
INJ_205,20221208,5100,5100,0,0,16975,-11875
INJ_205,20221210,6900,4200,0,-1,13970,-9770
INJ_205,20221212,1200,1200,0,0,3993,-2793
INJ_205,20221213,5700,5700,0,0,18974,-13274
INJ_205,20221214,1200,1200,0,0,3991,-2791
INJ_205,20221216,1500,1500,0,-1,4992,-3492
INJ_205,20221219,2400,1200,0,0,3991,-2791
INJ_205,20221220,4500,3000,0,0,9986,-6986
INJ_205,20221221,1200,1200,0,0,3994,-2794
INJ_205,20221222,1500,1500,0,0,4994,-3494
INJ_205,20221223,9000,6000,0,1,19966,-13966
INJ_205,20221224,3600,3600,0,-1,11984,-8384
INJ_205,20221226,3900,3900,0,1,12974,-9074
INJ_205,20221227,1200,1200,0,-1,3993,-2793
INJ_205,20221228,3900,3900,0,1,12983,-9083
INJ_205,20221229,3000,3000,0,0,9984,-6984
INJ_205,20221230,3000,3000,0,-1,9981,-6981
INJ_205,20221231,3000,3000,0,1,9981,-6981
INJ_205,20230103,3600,3600,0,-1,11975,-8375
INJ_205,20230105,1200,1200,0,0,3989,-2789
INJ_205,20230107,4500,4500,0,0,14973,-10473
INJ_205,20230109,1200,1200,0,0,3989,-2789
INJ_205,20230113,2400,1200,0,0,3989,-2789
INJ_205,20230116,3300,3300,0,0,10983,-7683
INJ_205,20230117,6000,6000,0,1,19963,-13963
INJ_205,20230118,9000,9000,0,0,29946,-20946
INJ_205,20230119,3900,2700,0,-1,8982,-6282
INJ_205,20230120,5400,5400,0,0,17968,-12568
INJ_205,20230121,1500,1500,0,0,4990,-3490
INJ_205,20230123,1500,1500,0,1,4993,-3493
INJ_205,20230124,3300,2100,0,0,6981,-4881
INJ_205,20230125,1200,1200,0,-1,3990,-2790
INJ_205,20230127,9900,9900,0,1,32945,-23045
INJ_205,20230130,1500,1500,0,0,4993,-3493
INJ_205,20230202,11400,11400,0,1,37941,-26541
INJ_205,20230203,3600,3600,0,0,11970,-8370
INJ_205,20230204,900,900,0,0,2991,-2091
INJ_205,20230207,2400,2400,0,0,7991,-5591
INJ_205,20230209,1800,1800,0,0,5990,-4190
INJ_205,20230210,3000,3000,0,0,9986,-6986
INJ_205,20230213,2400,2400,0,0,7980,-5580
INJ_205,20230214,4500,900,0,-1,2990,-2090
INJ_205,20230215,6600,6600,0,-1,21967,-15367
INJ_205,20230216,1200,1200,0,1,3992,-2792
INJ_205,20230217,5700,5700,0,-1,18964,-13264
INJ_205,20230218,1500,1500,0,0,4993,-3493
INJ_205,20230220,1800,1800,0,0,5993,-4193
INJ_205,20230221,3900,3900,0,-1,12983,-9083
INJ_205,20230222,4200,2700,0,1,8985,-6285
INJ_205,20230223,11100,11100,0,-1,36953,-25853
INJ_205,20230224,3900,3900,0,0,12966,-9066
INJ_205,20230225,10800,9600,0,-1,31944,-22344
INJ_205,20230227,13800,4800,0,1,15969,-11169
INJ_205,20230228,2400,1200,0,-1,3988,-2788
INJ_205,20230301,4200,4200,0,0,13974,-9774
INJ_205,20230302,6300,6300,0,0,20952,-14652
INJ_205,20230303,9900,9900,1,52,32947,-23047
INJ_205,20230304,5700,3900,1,49,12968,-9068
INJ_205,20230306,2730,2730,0,600,9077,-6347
INJ_205,20230307,8100,6300,0,-1,20955,-14655
INJ_205,20230308,1500,1500,1,197,4991,-3491
INJ_205,20230309,12900,11400,2,544,37927,-26527
INJ_205,20230310,5700,5700,0,450,18961,-13261
INJ_205,20230311,10200,10200,1,52,33943,-23743
INJ_205,20230313,5100,5100,0,766,16960,-11860
INJ_205,20230314,4800,4800,0,603,15973,-11173
INJ_205,20230315,4200,4200,0,0,13970,-9770
INJ_205,20230316,4200,4200,0,600,13968,-9768
INJ_205,20230317,5100,3600,0,0,11971,-8371
INJ_205,20230318,5400,4200,0,0,13974,-9774
INJ_205,20230320,2400,2400,0,450,7979,-5579
INJ_205,20230321,1200,1200,1,201,3992,-2792
INJ_205,20230322,4800,4800,0,448,15964,-11164
INJ_205,20230323,1200,1200,0,451,3990,-2790
INJ_205,20230324,6900,6900,0,603,22956,-16056
INJ_205,20230325,6600,6600,0,0,21969,-15369
INJ_205,20230327,2400,2400,0,751,7983,-5583
INJ_205,20230328,1500,1500,0,0,4990,-3490
INJ_205,20230329,2100,2100,0,0,6987,-4887
INJ_205,20230330,3900,3900,0,0,12972,-9072
INJ_205,20230331,4200,4200,0,-1,13976,-9776
INJ_205,20230403,7800,7800,0,449,25955,-18155
INJ_205,20230404,4200,4200,0,0,13970,-9770
INJ_205,20230405,5400,900,0,1,2991,-2091
INJ_205,20230406,7800,7800,0,750,25958,-18158
INJ_205,20230407,5700,4200,0,448,13975,-9775
INJ_205,20230408,5400,5400,0,598,17971,-12571
INJ_205,20230410,3300,2100,0,1,6981,-4881
INJ_205,20230411,5700,5700,0,0,18964,-13264
INJ_205,20230412,4800,4800,0,0,15968,-11168
INJ_205,20230413,11700,9900,0,1,32934,-23034
INJ_205,20230414,1200,1200,0,752,3992,-2792
INJ_205,20230415,6300,6300,0,450,20968,-14668
INJ_205,20230417,2400,2400,0,0,7983,-5583
INJ_205,20230418,11400,9900,0,-1,32950,-23050
INJ_205,20230419,4200,4200,0,451,13974,-9774
INJ_205,20230420,4200,4200,1,52,13962,-9762
INJ_205,20230421,4500,4500,0,452,14962,-10462
INJ_205,20230424,3600,3600,1,349,11973,-8373
INJ_205,20230425,5100,5100,1,200,16975,-11875
INJ_205,20230426,1500,1500,0,0,4990,-3490
INJ_205,20230428,1200,1200,0,0,3991,-2791
INJ_205,20230429,1500,1500,0,601,4988,-3488
INJ_205,20230501,5100,3900,0,0,12971,-9071
INJ_205,20230502,3300,3300,0,920,10971,-7671
INJ_205,20230503,2400,2400,0,748,7981,-5581
INJ_205,20230504,14850,14850,0,600,45922,-31072
INJ_205,20230505,2400,2400,1,196,7986,-5586
INJ_205,20230506,7800,6300,0,0,20952,-14652
INJ_205,20230508,10200,10200,0,1,33947,-23747
INJ_205,20230509,5100,5100,0,0,16974,-11874
INJ_205,20230510,1500,1500,0,0,4990,-3490
INJ_205,20230511,6000,6000,0,0,19960,-13960
INJ_205,20230512,7800,6300,0,0,20954,-14654
INJ_205,20230513,3900,3900,0,0,12968,-9068
INJ_205,20230515,6600,6600,0,449,21962,-15362
INJ_205,20230516,4500,4500,2,100,14964,-10464
INJ_205,20230517,6600,6600,2,248,21952,-15352
INJ_205,20230518,1800,1800,0,601,5992,-4192
INJ_205,20230520,4200,4200,0,0,13975,-9775
INJ_205,20230522,3900,2700,0,448,8978,-6278
INJ_205,20230523,6900,3900,0,0,12967,-9067
INJ_205,20230524,6000,6000,0,0,19961,-13961
INJ_205,20230525,4800,4800,0,1,15974,-11174
INJ_205,20230526,5100,5100,0,598,16965,-11865
INJ_205,20230529,1200,1200,1,48,3991,-2791
INJ_205,20230530,4200,4200,0,900,13975,-9775
INJ_205,20230531,6000,5100,0,900,16965,-11865
INJ_205,20230601,4500,3000,0,454,9985,-6985
INJ_205,20230602,3600,3600,0,748,11973,-8373
INJ_205,20230603,6300,6300,0,0,13976,-7676
INJ_205,20230605,4800,3900,0,-2,12975,-9075
INJ_205,20230606,6900,4200,0,0,13977,-9777
INJ_205,20230607,2400,2400,1,196,7986,-5586
INJ_205,20230608,7500,7500,0,0,24962,-17462
INJ_205,20230609,7200,7200,0,-1,23961,-16761
INJ_205,20230610,1500,1500,0,1,4993,-3493
INJ_205,20230612,3300,3300,0,451,10981,-7681
INJ_205,20230613,4800,4800,0,-1,15970,-11170
INJ_205,20230614,1200,1200,0,0,3993,-2793
INJ_205,20230615,4500,4500,0,747,14982,-10482
INJ_205,20230616,2700,2700,1,200,8978,-6278
INJ_205,20230617,2400,2400,0,-1,7984,-5584
INJ_205,20230619,7800,6300,0,0,20965,-14665
INJ_205,20230620,5100,5100,0,0,16965,-11865
INJ_205,20230621,1500,1500,0,0,4991,-3491
INJ_205,20230622,6600,5400,0,604,17965,-12565
INJ_205,20230623,2400,2400,0,903,7990,-5590
INJ_205,20230624,1800,1800,0,450,5991,-4191
INJ_205,20230626,8850,7350,0,-1,20956,-13606
INJ_205,20230627,1200,1200,0,0,3992,-2792
INJ_205,20230628,9150,9150,0,0,26960,-17810
INJ_205,20230701,3000,3000,0,0,9982,-6982
INJ_205,20230703,1500,1500,0,0,4990,-3490
INJ_205,20230704,9300,8100,0,748,26942,-18842
INJ_205,20230705,1500,1500,0,751,4992,-3492
INJ_205,20230706,4500,1500,2,550,4994,-3494
INJ_205,20230707,6300,6300,0,0,20951,-14651
INJ_205,20230708,4800,4800,0,1,15971,-11171
INJ_205,20230710,6000,6000,0,0,19965,-13965
INJ_205,20230711,8400,8400,0,0,27956,-19556
INJ_205,20230712,4500,2700,0,0,8980,-6280
INJ_205,20230713,55800,10200,1,201,33947,-23747
INJ_205,20230714,31500,4200,0,600,13969,-9769
INJ_205,20230715,122700,14400,0,1,47920,-33520
INJ_205,20230717,14100,2100,0,0,6980,-4880
INJ_205,20230718,5400,4200,1,203,13975,-9775
INJ_205,20230719,2700,2700,0,0,8986,-6286
INJ_206,20210927,4000,4000,0,1,25984,-21984
INJ_206,20210928,5400,5400,0,0,39971,-34571
INJ_206,20210929,1800,1800,0,1,17987,-16187
INJ_206,20210930,700,700,0,188,6992,-6292
INJ_206,20211001,5600,5600,0,74,45957,-40357
INJ_206,20211002,4400,4400,0,2,35974,-31574
INJ_206,20211004,3000,3000,0,1,19981,-16981
INJ_206,20211005,700,700,0,0,6994,-6294
INJ_206,20211006,7500,1500,0,0,6994,-5494
INJ_206,20211007,1200,1200,0,0,11992,-10792
INJ_206,20211008,7900,7900,0,1,35963,-28063
INJ_206,20211009,1500,1500,0,0,6994,-5494
INJ_206,20211011,3400,3400,0,1,13824,-10424
INJ_206,20211012,4400,4400,0,2,35976,-31576
INJ_206,20211013,1300,1300,0,930,6994,-5694
INJ_206,20211014,2300,1900,0,1,18982,-17082
INJ_206,20211015,700,700,0,0,6990,-6290
INJ_206,20211016,4300,4000,0,-1,31979,-27979
INJ_206,20211018,7200,7200,0,-1,57963,-50763
INJ_206,20211019,3700,3700,0,1,22987,-19287
INJ_206,20211020,3000,3000,0,0,15990,-12990
INJ_206,20211021,2600,2600,0,0,17987,-15387
INJ_206,20211022,1700,1700,0,1,16989,-15289
INJ_206,20211023,2600,2600,0,-2,25976,-23376
INJ_206,20211025,900,900,0,0,2998,-2098
INJ_206,20211026,3600,3600,0,1,21976,-18376
INJ_206,20211027,3000,3000,0,-1,21980,-18980
INJ_206,20211028,2900,2900,0,0,20989,-18089
INJ_206,20211029,6200,5500,0,145,54971,-49471
INJ_206,20211030,1300,1300,0,-1,6993,-5693
INJ_206,20211101,2900,2900,0,1,28979,-26079
INJ_206,20211102,4200,4200,0,-1,31975,-27775
INJ_206,20211103,2900,2900,0,0,20982,-18082
INJ_206,20211104,3900,3900,0,-1,28983,-25083
INJ_206,20211105,2700,2700,0,0,26987,-24287
INJ_206,20211106,4600,4600,0,2,35972,-31372
INJ_206,20211108,5100,5100,0,-1,24977,-19877
INJ_206,20211109,1400,1400,0,1,13990,-12590
INJ_206,20211110,1500,1500,0,-1,14988,-13488
INJ_206,20211111,3200,2800,0,60,19986,-17186
INJ_206,20211112,3700,3700,0,0,22980,-19280
INJ_206,20211113,2100,2100,0,56,20991,-18891
INJ_206,20211115,5700,5700,0,1,34984,-29284
INJ_206,20211116,8000,7500,0,-2,52968,-45468
INJ_206,20211117,5900,5900,0,-1,44971,-39071
INJ_206,20211118,4800,4800,0,2,31975,-27175
INJ_206,20211119,4200,4200,0,0,25984,-21784
INJ_206,20211120,4800,4800,0,60,39970,-35170
INJ_206,20211122,1700,1700,0,0,10989,-9289
INJ_206,20211123,1200,1200,0,41,11989,-10789
INJ_206,20211124,2100,2100,0,0,20987,-18887
INJ_206,20211125,1700,1700,0,-1,16990,-15290
INJ_206,20211126,4300,3900,0,0,30979,-27079
INJ_206,20211127,4300,4300,0,0,34981,-30681
INJ_206,20211129,4500,3000,0,-1,19983,-16983
INJ_206,20211201,7200,7200,0,0,43971,-36771
INJ_206,20211202,2900,2900,0,-1,28983,-26083
INJ_206,20211203,6100,6100,0,282,52968,-46868
INJ_206,20211204,6800,6800,0,1,41975,-35175
INJ_206,20211206,4500,4200,0,1,35978,-31778
INJ_206,20211207,3900,3900,0,0,28982,-25082
INJ_206,20211208,1500,1500,0,0,14992,-13492
INJ_206,20211209,1200,1200,0,0,11993,-10793
INJ_206,20211210,9200,7400,0,0,41970,-34570
INJ_206,20211211,5500,4300,0,-1,34978,-30678
INJ_206,20211213,4700,4700,0,54,30978,-26278
INJ_206,20211214,3900,2300,0,0,22993,-20693
INJ_206,20211215,2900,2900,0,1,18988,-16088
INJ_206,20211216,5100,5100,0,0,44968,-39868
INJ_206,20211217,900,900,0,0,8996,-8096
INJ_206,20211218,2200,2200,0,1,13993,-11793
INJ_206,20211220,5300,4800,0,-1,41971,-37171
INJ_206,20211221,3300,3300,0,1,22985,-19685
INJ_206,20211222,2200,2200,0,1,15992,-13792
INJ_206,20211224,5400,5400,0,-1,37973,-32573
INJ_206,20211225,3400,3400,0,0,25979,-22579
INJ_206,20211227,3100,3100,0,-1,22982,-19882
INJ_206,20211228,3500,3100,0,0,24983,-21883
INJ_206,20211229,3400,3400,0,1,33978,-30578
INJ_206,20211230,1800,1800,0,0,17880,-16080
INJ_206,20211231,2900,2600,0,0,17992,-15392
INJ_206,20220103,4100,3800,0,0,31979,-28179
INJ_206,20220104,2300,2300,0,1,16989,-14689
INJ_206,20220105,5200,5200,0,-1,43962,-38762
INJ_206,20220106,5500,5500,0,0,44977,-39477
INJ_206,20220107,4700,4700,0,0,46974,-42274
INJ_206,20220108,2100,2100,0,0,14996,-12896
INJ_206,20220110,6100,6100,0,1,42966,-36866
INJ_206,20220111,2600,2600,0,93,17985,-15385
INJ_206,20220112,4600,4600,0,0,35976,-31376
INJ_206,20220113,2500,2500,0,-1,24977,-22477
INJ_206,20220114,4400,4400,0,-2,35970,-31570
INJ_206,20220115,2900,2900,0,0,18988,-16088
INJ_206,20220117,13500,7000,0,1,62925,-55925
INJ_206,20220118,3900,3900,0,-1,22981,-19081
INJ_206,20220119,5100,5100,0,1,50973,-45873
INJ_206,20220120,8200,5300,0,1,44963,-39663
INJ_206,20220121,7100,6300,0,-1,46964,-40664
INJ_206,20220122,8900,8900,0,-1,64959,-56059
INJ_206,20220124,4900,4900,0,-1,42962,-38062
INJ_206,20220125,8300,7500,0,1,66950,-59450
INJ_206,20220126,1600,1200,0,-1,15864,-14664
INJ_206,20220127,2700,2700,0,0,26988,-24288
INJ_206,20220128,4800,4800,0,-1,39969,-35169
INJ_206,20220129,8700,8700,0,-3,60957,-52257
INJ_206,20220131,13800,12800,0,0,96283,-83483
INJ_206,20220201,7800,7800,0,1,63960,-56160
INJ_206,20220202,2100,2100,0,0,20989,-18889
INJ_206,20220203,4100,3800,0,-1,29979,-26179
INJ_206,20220204,1600,1600,0,-1,15990,-14390
INJ_206,20220205,1100,1100,0,0,10993,-9893
INJ_206,20220207,4400,4400,0,-1,33978,-29578
INJ_206,20220208,7000,7000,0,0,53968,-46968
INJ_206,20220209,5600,5600,0,1,37968,-32368
INJ_206,20220210,3300,3300,0,68,22980,-19680
INJ_206,20220211,4000,4000,0,-1,39968,-35968
INJ_206,20220212,8100,8100,0,1,58958,-50858
INJ_206,20220214,4900,3500,0,0,28986,-25486
INJ_206,20220215,4600,4600,0,1,37967,-33367
INJ_206,20220216,6900,6900,0,0,52967,-46067
INJ_206,20220217,4700,4700,0,1,40968,-36268
INJ_206,20220218,5900,5900,0,1,40971,-35071
INJ_206,20220219,6000,5200,0,0,51968,-46768
INJ_206,20220221,7500,7500,0,70,58957,-51457
INJ_206,20220222,7400,7400,0,0,51974,-44574
INJ_206,20220223,4500,4500,0,1,44971,-40471
INJ_206,20220224,700,700,0,1,6994,-6294
INJ_206,20220225,4800,4100,0,-1,30982,-26882
INJ_206,20220226,2900,2900,0,20,28983,-26083
INJ_206,20220228,5700,4200,0,0,31974,-27774
INJ_206,20220301,10800,10400,0,-1,63959,-53559
INJ_206,20220302,8900,8900,0,0,76961,-68061
INJ_206,20220303,3200,3200,0,-2,31986,-28786
INJ_206,20220304,1300,1300,0,1,12993,-11693
INJ_206,20220305,1800,1800,0,48,17984,-16184
INJ_206,20220307,2900,2900,0,1,28977,-26077
INJ_206,20220309,9200,8000,0,0,63967,-55967
INJ_206,20220310,4700,4700,0,-1,40977,-36277
INJ_206,20220311,6400,6400,0,23,53963,-47563
INJ_206,20220312,10100,10100,0,0,44970,-34870
INJ_206,20220314,4700,4700,0,0,30979,-26279
INJ_206,20220315,1800,1800,0,0,17988,-16188
INJ_206,20220316,7600,7100,0,1,44984,-37884
INJ_206,20220317,8600,8600,0,0,77958,-69358
INJ_206,20220318,11300,10100,0,1,58971,-48871
INJ_206,20220319,4700,4700,0,-1,40970,-36270
INJ_206,20220321,7000,6300,0,-2,52970,-46670
INJ_206,20220322,3100,2800,0,0,27986,-25186
INJ_206,20220323,3100,3100,0,1,22983,-19883
INJ_206,20220324,4400,4400,0,34,27988,-23588
INJ_206,20220325,4000,4000,0,0,29988,-25988
INJ_206,20220326,4300,4300,0,1,36575,-32275
INJ_206,20220328,6400,6400,0,2,57958,-51558
INJ_206,20220329,4200,4200,0,0,27974,-23774
INJ_206,20220330,6600,6600,0,37,55967,-49367
INJ_206,20220331,6900,6900,0,-2,50969,-44069
INJ_206,20220401,5500,5100,0,2,50958,-45858
INJ_206,20220402,9500,9500,0,2,70951,-61451
INJ_206,20220404,5800,3800,0,0,23325,-19525
INJ_206,20220405,800,800,0,0,60,740
INJ_206,20220407,11000,11000,0,1,93937,-82937
INJ_206,20220408,5800,5000,0,0,49967,-44967
INJ_206,20220409,2300,2300,0,-2,14988,-12688
INJ_206,20220411,5500,5500,0,2,40971,-35471
INJ_206,20220412,5100,4800,0,0,47967,-43167
INJ_206,20220413,2100,2100,0,0,20984,-18884
INJ_206,20220414,4400,4400,0,0,43970,-39570
INJ_206,20220415,2500,1900,0,1,18989,-17089
INJ_206,20220416,2900,2900,0,0,28974,-26074
INJ_206,20220418,5400,5400,0,0,53961,-48561
INJ_206,20220419,4500,4500,0,1,36854,-32354
INJ_206,20220420,10000,10000,0,-1,85945,-75945
INJ_206,20220421,10800,10800,0,-1,87933,-77133
INJ_206,20220422,6100,5000,0,0,49971,-44971
INJ_206,20220424,4900,4900,0,0,32979,-28079
INJ_206,20220425,1900,1900,0,1,18987,-17087
INJ_206,20220426,6900,6900,0,1,68965,-62065
INJ_206,20220427,8100,7700,0,-1,76957,-69257
INJ_206,20220428,6500,6500,0,0,38977,-32477
INJ_206,20220429,5800,5100,0,-1,50963,-45863
INJ_206,20220503,5700,5700,0,1,32972,-27272
INJ_206,20220504,6600,6600,0,-1,49972,-43372
INJ_206,20220505,4010,4010,0,157,39989,-35979
INJ_206,20220506,6300,5800,0,-1,41975,-36175
INJ_206,20220507,9300,9300,0,2,76956,-67656
INJ_206,20220509,4600,4600,0,0,45980,-41380
INJ_206,20220510,11900,11100,0,-1,94940,-83840
INJ_206,20220511,6200,6200,0,1,55956,-49756
INJ_206,20220512,15300,15000,0,2,119927,-104927
INJ_206,20220513,6300,6000,0,1,51977,-45977
INJ_206,20220514,8200,7800,0,-1,61961,-54161
INJ_206,20220516,9600,9100,0,-1,72963,-63863
INJ_206,20220517,5500,5500,0,2,38971,-33471
INJ_206,20220518,4800,4800,0,-1,41970,-37170
INJ_206,20220519,5950,4450,0,0,33929,-29479
INJ_206,20220520,11500,11500,0,4,85946,-74446
INJ_206,20220521,6450,5350,0,-1,45966,-40616
INJ_206,20220523,11400,10600,0,-1,84941,-74341
INJ_206,20220524,6900,6900,0,-1,62961,-56061
INJ_206,20220525,4500,4500,0,0,38966,-34466
INJ_206,20220526,2800,2800,0,0,27981,-25181
INJ_206,20220527,3700,3700,0,0,36975,-33275
INJ_206,20220528,5050,5050,0,0,33979,-28929
INJ_206,20220530,4300,4300,0,2,42976,-38676
INJ_206,20220531,8300,7800,0,1,71955,-64155
INJ_206,20220601,1200,1200,0,0,11992,-10792
INJ_206,20220602,4750,3750,0,-1,32977,-29227
INJ_206,20220603,9200,9200,0,3,73948,-64748
INJ_206,20220604,4300,4300,0,0,42972,-38672
INJ_206,20220606,1650,1650,0,0,8992,-7342
INJ_206,20220607,8950,8950,0,0,75954,-67004
INJ_206,20220608,3100,2800,0,0,27986,-25186
INJ_206,20220609,9250,8450,0,1,76947,-68497
INJ_206,20220610,5900,4900,0,1,36976,-32076
INJ_206,20220611,9000,9000,0,0,89953,-80953
INJ_206,20220613,3800,2000,0,1,17274,-15274
INJ_206,20220614,4750,2750,0,0,7155,-4405
INJ_206,20220615,19400,4600,0,0,20040,-15440
INJ_206,20220616,4700,4700,0,-1,40978,-36278
INJ_206,20220617,3600,3600,0,0,35981,-32381
INJ_206,20220618,6022,6022,0,210,44174,-38152
INJ_206,20220620,9410,7010,0,1,69866,-62856
INJ_206,20220621,7950,6900,0,1,49952,-43052
INJ_206,20220622,9900,7200,0,-1,59954,-52754
INJ_206,20220623,2850,2850,0,0,23985,-21135
INJ_206,20220624,6850,6850,0,-2,54956,-48106
INJ_206,20220625,8350,8350,0,70,69910,-61560
INJ_206,20220627,15750,15750,0,-1,146894,-131144
INJ_206,20220628,9050,9050,0,0,82946,-73896
INJ_206,20220629,10200,10200,0,0,101941,-91741
INJ_206,20220630,9950,9200,0,1,82949,-73749
INJ_206,20220701,7700,7700,0,1,55973,-48273
INJ_206,20220702,11350,11350,0,2,72938,-61588
INJ_206,20220704,5750,5750,0,0,43965,-38215
INJ_206,20220705,2800,2800,0,1,27981,-25181
INJ_206,20220706,2850,2850,0,0,17982,-15132
INJ_206,20220707,4550,4550,0,-1,31976,-27426
INJ_206,20220708,3500,3500,0,-1,34979,-31479
INJ_206,20220709,8750,8750,0,3,70955,-62205
INJ_206,20220711,1600,1600,0,-1,15990,-14390
INJ_206,20220712,3050,3050,0,1,25982,-22932
INJ_206,20220713,2700,2300,0,-1,22980,-20680
INJ_206,20220714,3900,3400,0,0,33976,-30576
INJ_206,20220715,4750,4750,0,0,42971,-38221
INJ_206,20220716,3150,3150,0,0,26985,-23835
INJ_206,20220718,8250,8250,0,-1,68957,-60707
INJ_206,20220719,5150,5150,0,-1,46964,-41814
INJ_206,20220720,2400,2400,0,-1,23990,-21590
INJ_206,20220721,5300,5300,0,0,46982,-41682
INJ_206,20220722,6700,6300,0,-2,53960,-47660
INJ_206,20220723,7650,7650,0,195,65967,-58317
INJ_206,20220725,2100,2100,0,0,20986,-18886
INJ_206,20220726,9600,9200,0,1,67955,-58755
INJ_206,20220727,3400,3400,0,1,27975,-24575
INJ_206,20220728,3300,3300,0,-2,20985,-17685
INJ_206,20220729,5300,4900,0,1,48967,-44067
INJ_206,20220730,3350,3350,0,1,28978,-25628
INJ_206,20220801,1150,1150,0,0,6996,-5846
INJ_206,20220802,6650,6250,0,-1,57963,-51713
INJ_206,20220803,6800,6800,0,0,67946,-61146
INJ_206,20220804,3150,3150,0,142,23981,-20831
INJ_206,20220805,8960,7760,0,60,66962,-59202
INJ_206,20220806,5450,5450,0,0,49970,-44520
INJ_206,20220808,6350,5850,0,1,53967,-48117
INJ_206,20220809,3700,3700,0,1,30978,-27278
INJ_206,20220810,3900,3900,0,0,32974,-29074
INJ_206,20220811,10150,10150,0,1,90914,-80764
INJ_206,20220812,7100,6700,0,1,66949,-60249
INJ_206,20220813,4800,4800,0,1,47957,-43157
INJ_206,20220815,6050,6050,0,68,46972,-40922
INJ_206,20220816,9450,8250,0,0,77952,-69702
INJ_206,20220817,8900,8900,0,2,73948,-65048
INJ_206,20220818,7200,7200,0,0,71959,-64759
INJ_206,20220819,7500,7500,0,-1,59969,-52469
INJ_206,20220820,3450,3450,0,1,29978,-26528
INJ_206,20220822,3300,3300,0,-2,32979,-29679
INJ_206,20220823,6550,6550,0,0,57964,-51414
INJ_206,20220824,4200,4200,0,0,41972,-37772
INJ_206,20220825,6100,6100,0,-2,54963,-48863
INJ_206,20220826,4500,4500,0,-1,44971,-40471
INJ_206,20220827,9400,7900,0,1,67942,-60042
INJ_206,20220829,5650,5650,0,0,48978,-43328
INJ_206,20220830,6650,6150,0,1,53962,-47812
INJ_206,20220831,4500,4500,0,0,44970,-40470
INJ_206,20220901,1900,1900,0,83,18988,-17088
INJ_206,20220902,9900,2600,0,-1,19986,-17386
INJ_206,20220903,7700,700,0,94,6998,-6298
INJ_206,20220905,2800,400,0,0,3997,-3597
INJ_206,20220908,800,400,0,1,1595,-1195
INJ_206,20220909,4500,3800,0,0,37979,-34179
INJ_206,20220910,6950,6950,0,2,52969,-46019
INJ_206,20220912,6600,6600,0,3,53968,-47368
INJ_206,20220913,3300,3300,0,1,32981,-29681
INJ_206,20220914,1400,1400,0,-1,13989,-12589
INJ_206,20220915,4300,4300,0,1,36977,-32677
INJ_206,20220916,1800,1800,0,0,17982,-16182
INJ_206,20220917,11850,10150,0,-1,93935,-83785
INJ_206,20220919,4550,4550,0,1,23980,-19430
INJ_206,20220920,3450,3450,0,0,26984,-23534
INJ_206,20220921,5350,5350,0,0,48970,-43620
INJ_206,20220922,4000,4000,0,2,33985,-29985
INJ_206,20220923,10100,8800,0,1,81941,-73141
INJ_206,20220924,1500,1500,0,0,14987,-13487
INJ_206,20220926,7400,6500,0,0,64960,-58460
INJ_206,20220927,5300,4800,0,-1,47975,-43175
INJ_206,20220928,2400,2400,0,1,23990,-21590
INJ_206,20220929,3600,3600,0,0,35972,-32372
INJ_206,20220930,3800,3400,0,2,27985,-24585
INJ_206,20221001,1550,1550,0,-1,10992,-9442
INJ_206,20221004,7050,7050,2,509,56970,-49920
INJ_206,20221005,1950,1950,0,0,14990,-13040
INJ_206,20221006,4900,4900,0,0,42968,-38068
INJ_206,20221007,5600,5600,0,0,55957,-50357
INJ_206,20221008,3900,3900,0,-2,38969,-35069
INJ_206,20221010,3700,2800,0,0,34974,-32174
INJ_206,20221011,700,700,0,0,0,700
INJ_206,20221012,1200,1200,0,-1,11993,-10793
INJ_206,20221013,1400,1400,0,0,13994,-12594
INJ_206,20221014,1600,1200,0,0,11994,-10794
INJ_206,20221015,4300,4300,0,67,42971,-38671
INJ_206,20221017,3800,3800,0,0,37930,-34130
INJ_206,20221018,5200,5200,0,3,45963,-40763
INJ_206,20221019,3000,2500,0,0,24984,-22484
INJ_206,20221021,3900,3900,0,2,38973,-35073
INJ_206,20221022,1500,1500,0,1,14984,-13484
INJ_206,20221024,6300,5600,0,0,55939,-50339
INJ_206,20221025,700,700,0,-1,6993,-6293
INJ_206,20221026,5500,4800,0,1,41968,-37168
INJ_206,20221027,4000,4000,0,1,39976,-35976
INJ_206,20221028,6300,6300,0,85,62965,-56665
INJ_206,20221029,9550,9550,0,-4,87947,-78397
INJ_206,20221031,6350,6350,0,-2,58971,-52621
INJ_206,20221101,2950,2650,0,0,21978,-19328
INJ_206,20221102,4600,4600,0,1,39972,-35372
INJ_206,20221104,4300,4300,0,40,36978,-32678
INJ_206,20221105,5050,4550,0,1,37976,-33426
INJ_206,20221107,2700,2700,0,-2,26985,-24285
INJ_206,20221108,3400,3400,0,0,33981,-30581
INJ_206,20221109,5650,5650,0,0,48965,-43315
INJ_206,20221110,800,800,0,0,7991,-7191
INJ_206,20221111,5300,4500,0,0,44965,-40465
INJ_206,20221112,700,700,0,-1,6995,-6295
INJ_206,20221114,2100,2100,0,1,20987,-18887
INJ_206,20221115,700,700,0,-1,6992,-6292
INJ_206,20221116,4850,4850,0,0,43963,-39113
INJ_206,20221117,7250,6550,0,1,48965,-42415
INJ_206,20221118,2700,2700,0,0,26980,-24280
INJ_206,20221119,6950,6950,0,0,61966,-55016
INJ_206,20221121,3800,3800,0,0,37967,-34167
INJ_206,20221122,1500,1500,0,-1,14988,-13488
INJ_206,20221123,5450,5450,0,2,43978,-38528
INJ_206,20221124,3300,2800,0,0,15988,-13188
INJ_206,20221125,2900,2900,0,0,28977,-26077
INJ_206,20221126,3100,3100,0,1,30982,-27882
INJ_206,20221129,5700,5700,0,0,50974,-45274
INJ_206,20221130,1200,1200,0,-1,11991,-10791
INJ_206,20221201,1100,1100,0,0,10997,-9897
INJ_206,20221202,5750,5750,0,0,46964,-41214
INJ_206,20221203,6650,6650,0,50,55963,-49313
INJ_206,20221205,5800,5800,0,3,51971,-46171
INJ_206,20221206,4000,4000,0,-1,33974,-29974
INJ_206,20221207,1900,1900,0,0,18988,-17088
INJ_206,20221208,1900,1900,0,-1,18990,-17090
INJ_206,20221210,6200,4900,0,1,42980,-38080
INJ_206,20221212,800,800,0,0,7996,-7196
INJ_206,20221214,5400,4800,0,0,47970,-43170
INJ_206,20221215,400,400,0,0,3997,-3597
INJ_206,20221216,5900,4900,0,2,45178,-40278
INJ_206,20221217,400,400,0,0,3996,-3596
INJ_206,20221219,5300,4800,0,1,47964,-43164
INJ_206,20221220,11700,9800,0,2,95309,-85509
INJ_206,20221221,3750,3750,0,-1,32798,-29048
INJ_206,20221222,2000,2000,0,0,19984,-17984
INJ_206,20221223,16050,10450,0,-2,112894,-102444
INJ_206,20221224,1500,1500,0,0,14992,-13492
INJ_206,20221226,7600,7600,0,73,63966,-56366
INJ_206,20221227,4850,4850,0,1,43980,-39130
INJ_206,20221228,3500,3500,0,-2,34972,-31472
INJ_206,20221229,3700,3400,0,1,33975,-30575
INJ_206,20221230,3300,2800,0,0,27977,-25177
INJ_206,20221231,3200,3200,0,2,25973,-22773
INJ_206,20230102,1200,1200,0,0,11986,-10786
INJ_206,20230103,2500,2500,0,0,24979,-22479
INJ_206,20230104,900,900,0,0,8995,-8095
INJ_206,20230109,3100,3100,5,772,30995,-27895
INJ_206,20230110,1600,1600,0,0,15999,-14399
INJ_206,20230111,5500,5500,0,0,48993,-43493
INJ_206,20230112,5450,5450,0,1,49994,-44544
INJ_206,20230113,2950,2250,0,-1,14999,-12749
INJ_206,20230114,4000,4000,0,0,39988,-35988
INJ_206,20230116,7000,5300,0,1,43994,-38694
INJ_206,20230117,8750,7950,0,-2,74993,-67043
INJ_206,20230118,3400,3400,0,0,28000,-24600
INJ_206,20230119,4500,3800,0,0,37986,-34186
INJ_206,20230120,4000,4000,0,-1,39989,-35989
INJ_206,20230121,8100,6800,0,-2,61990,-55190
INJ_206,20230123,700,700,0,1,6997,-6297
INJ_206,20230124,7200,5400,0,-2,53991,-48591
INJ_206,20230125,4800,4800,0,1,47994,-43194
INJ_206,20230126,3550,3550,0,0,27996,-24446
INJ_206,20230127,5350,5350,0,0,46000,-40650
INJ_206,20230128,3700,3700,0,0,30999,-27299
INJ_206,20230130,4500,4500,0,-2,44981,-40481
INJ_206,20230131,10200,9000,0,0,83977,-74977
INJ_206,20230201,4400,4400,0,0,44001,-39601
INJ_206,20230202,4150,4150,0,-1,30991,-26841
INJ_206,20230203,4900,4900,0,0,48989,-44089
INJ_206,20230204,4000,3700,0,1,30991,-27291
INJ_206,20230206,1700,1700,0,0,16996,-15296
INJ_206,20230207,2600,2600,0,0,25995,-23395
INJ_206,20230208,2800,2800,0,-1,27996,-25196
INJ_206,20230209,4000,4000,0,0,27991,-23991
INJ_206,20230210,4500,4500,0,-1,44991,-40491
INJ_206,20230211,4800,4500,0,1,44995,-40495
INJ_206,20230213,4600,4600,0,0,45986,-41386
INJ_206,20230214,31100,3600,0,2,29994,-26394
INJ_206,20230215,2000,2000,0,1,19999,-17999
INJ_206,20230216,5300,4600,0,0,46000,-41400
INJ_206,20230217,10150,9650,0,1,85999,-76349
INJ_206,20230218,3600,3600,0,0,29998,-26398
INJ_206,20230220,3850,3850,0,0,33997,-30147
INJ_206,20230221,3000,3000,0,0,29995,-26995
INJ_206,20230222,4400,3700,0,1,36998,-33298
INJ_206,20230223,4900,4500,0,2,34997,-30497
INJ_206,20230224,8550,8550,0,1,68981,-60431
INJ_206,20230225,8000,7300,0,0,60987,-53687
INJ_206,20230227,8200,4700,0,0,40999,-36299
INJ_206,20230228,2000,1300,0,0,12998,-11698
INJ_206,20230301,2600,2600,0,0,25998,-23398
INJ_206,20230302,10850,10850,0,-2,91986,-81136
INJ_206,20230303,3700,3700,0,0,30999,-27299
INJ_206,20230304,7350,6650,0,1,59002,-52352
INJ_206,20230306,6350,6350,0,2,58988,-52638
INJ_206,20230307,5600,5600,0,-1,55994,-50394
INJ_206,20230308,4600,4600,0,1,45994,-41394
INJ_206,20230309,4200,3900,0,0,38996,-35096
INJ_206,20230310,11200,10800,0,1,89999,-79199
INJ_206,20230311,7250,7250,0,0,61997,-54747
INJ_206,20230313,5150,5150,0,1,46992,-41842
INJ_206,20230314,1700,1700,0,-1,10998,-9298
INJ_206,20230315,5600,5600,0,0,55990,-50390
INJ_206,20230316,10400,10400,0,0,67982,-57582
INJ_206,20230317,10700,9300,0,-2,70992,-61692
INJ_206,20230318,6450,5350,0,-1,42995,-37645
INJ_206,20230320,9950,9950,0,-1,58984,-49034
INJ_206,20230321,7600,7600,0,3,57992,-50392
INJ_206,20230322,15100,14300,0,2,106983,-92683
INJ_206,20230323,4750,4750,0,2,24999,-20249
INJ_206,20230324,10300,10300,0,-1,81995,-71695
INJ_206,20230325,5000,5000,0,1,43987,-38987
INJ_206,20230327,12450,12450,0,2,95976,-83526
INJ_206,20230328,5300,5300,0,1,47002,-41702
INJ_206,20230329,4100,4100,0,0,40987,-36887
INJ_206,20230330,2400,2400,0,0,23992,-21592
INJ_206,20230331,4800,4800,0,-1,41990,-37190
INJ_206,20230401,6200,6200,0,-1,61993,-55793
INJ_206,20230403,15350,15350,0,-2,100976,-85626
INJ_206,20230404,4100,4100,0,1,34995,-30895
INJ_206,20230405,79450,6900,0,1,44992,-38092
INJ_206,20230406,20150,18150,0,-1,113990,-95840
INJ_206,20230407,8950,8150,0,1,52995,-44845
INJ_206,20230408,11050,11050,0,0,84968,-73918
INJ_206,20230410,10400,8900,0,0,79988,-71088
INJ_206,20230411,5900,5900,0,0,52995,-47095
INJ_206,20230412,14900,14900,0,1,115991,-101091
INJ_206,20230413,10300,9500,0,-1,88994,-79494
INJ_206,20230414,8400,8400,0,0,44999,-36599
INJ_206,20230415,9550,9550,0,0,69982,-60432
INJ_206,20230417,8550,8550,0,-2,74982,-66432
INJ_206,20230418,10900,10100,0,0,94980,-84880
INJ_206,20230419,12100,12100,0,1,90971,-78871
INJ_206,20230420,15650,15650,0,2,106985,-91335
INJ_206,20230421,12250,10750,0,1,81979,-71229
INJ_206,20230424,18800,17300,0,1,124962,-107662
INJ_206,20230425,17850,14350,0,2,80851,-66501
INJ_206,20230426,6200,6200,0,0,61986,-55786
INJ_206,20230427,7300,7300,0,1,45988,-38688
INJ_206,20230428,4700,4700,0,0,46985,-42285
INJ_206,20230429,7800,7800,0,0,59987,-52187
INJ_206,20230501,7250,6350,0,0,58989,-52639
INJ_206,20230502,12500,10750,0,0,87986,-77236
INJ_206,20230503,17900,17900,0,3,121993,-104093
INJ_206,20230504,16300,16300,0,-3,129959,-113659
INJ_206,20230505,16200,16200,0,5,89979,-73779
INJ_206,20230506,11150,11150,0,0,97897,-86747
INJ_206,20230508,8900,8400,0,0,83984,-75584
INJ_206,20230509,5800,5800,0,-2,51990,-46190
INJ_206,20230510,8850,8850,0,2,77991,-69141
INJ_206,20230511,12300,12300,0,1,101994,-89694
INJ_206,20230512,13700,13700,0,-2,109994,-96294
INJ_206,20230513,5700,5700,0,1,56975,-51275
INJ_206,20230515,11650,11650,0,0,81974,-70324
INJ_206,20230516,15050,14450,0,3,97976,-83526
INJ_206,20230517,16250,16250,0,0,106705,-90455
INJ_206,20230518,11400,11400,0,0,92994,-81594
INJ_206,20230519,4600,3500,0,0,34998,-31498
INJ_206,20230520,11200,11200,0,-2,105975,-94775
INJ_206,20230522,19300,16900,0,1,123976,-107076
INJ_206,20230523,6100,5700,0,-1,56989,-51289
INJ_206,20230524,9050,9050,0,-1,73985,-64935
INJ_206,20230525,9000,9000,0,1,71995,-62995
INJ_206,20230526,9850,9850,0,1,81993,-72143
INJ_206,20230527,7000,7000,0,0,69998,-62998
INJ_206,20230529,11350,11350,0,1,87988,-76638
INJ_206,20230530,21450,21450,0,2,137962,-116512
INJ_206,20230531,15950,15550,0,0,96974,-81424
INJ_206,20230601,8000,8000,0,-1,55989,-47989
INJ_206,20230602,17250,17250,0,-3,137960,-120710
INJ_206,20230603,11300,10600,0,0,81991,-71391
INJ_206,20230605,17050,16350,0,0,137979,-121629
INJ_206,20230606,8650,7950,0,0,74996,-67046
INJ_206,20230607,13200,12600,0,0,101989,-89389
INJ_206,20230608,12000,12000,0,3,107989,-95989
INJ_206,20230609,10000,10000,0,1,81995,-71995
INJ_206,20230610,7600,7600,0,0,75976,-68376
INJ_206,20230612,12500,10750,0,1,75979,-65229
INJ_206,20230613,9350,8550,0,1,74977,-66427
INJ_206,20230614,3900,3200,0,0,31997,-28797
INJ_206,20230615,11450,11450,0,0,76990,-65540
INJ_206,20230616,7850,7850,0,3,52989,-45139
INJ_206,20230617,10750,10750,0,0,90977,-80227
INJ_206,20230619,9900,9900,0,3,86983,-77083
INJ_206,20230620,8750,8750,0,1,73969,-65219
INJ_206,20230621,7800,7800,0,-1,77984,-70184
INJ_206,20230622,16750,16750,0,1,120976,-104226
INJ_206,20230623,18050,18050,0,3,124962,-106912
INJ_206,20230624,9350,8050,0,1,60988,-52938
INJ_206,20230626,16750,13950,0,0,101978,-88028
INJ_206,20230627,5300,4500,0,0,44988,-40488
INJ_206,20230628,13650,12850,0,1,99985,-87135
INJ_206,20230630,2650,2650,0,1,15993,-13343
INJ_206,20230701,4400,4400,0,0,43985,-39585
INJ_206,20230703,8350,8350,0,0,57988,-49638
INJ_206,20230704,16650,16650,0,1,128971,-112321
INJ_206,20230705,8600,8600,0,2,46990,-38390
INJ_206,20230706,17200,15800,0,3,88987,-73187
INJ_206,20230707,13200,13200,0,0,104996,-91796
INJ_206,20230708,5700,5700,0,0,50980,-45280
INJ_206,20230710,5000,5000,0,-1,49985,-44985
INJ_206,20230711,5600,5600,0,0,49985,-44385
INJ_206,20230712,7500,6700,0,0,60980,-54280
INJ_206,20230713,37800,6900,0,-1,32013,-25113
INJ_206,20230714,34800,7850,0,-1,59994,-52144
INJ_206,20230715,30800,5700,0,3,44852,-39152
INJ_206,20230717,48200,4850,0,0,38002,-33152
INJ_206,20230718,8800,8800,0,1,60991,-52191
INJ_206,20230719,6850,6850,0,0,63983,-57133
INJ_207,20210928,5500,5500,0,0,21985,-16485
INJ_207,20210929,10500,10500,0,1,41979,-31479
INJ_207,20210930,4500,4500,0,4,17980,-13480
INJ_207,20211001,6750,5250,0,1,20990,-15740
INJ_207,20211007,4750,4750,0,0,18988,-14238
INJ_207,20211008,5750,5750,0,1,22988,-17238
INJ_207,20211012,5250,5250,0,0,20990,-15740
INJ_207,20211015,7000,5250,0,1,20987,-15737
INJ_207,20211018,3750,3750,0,-1,14991,-11241
INJ_207,20211021,5250,5250,0,0,20988,-15738
INJ_207,20211022,3750,3750,0,0,14993,-11243
INJ_207,20211028,3250,750,0,0,4399,-3649
INJ_207,20211029,15250,15250,0,1,60966,-45716
INJ_207,20211102,6500,6500,0,1,25984,-19484
INJ_207,20211105,5250,5250,0,0,20990,-15740
INJ_207,20211109,8250,6500,0,2,25988,-19488
INJ_207,20211111,5250,5250,0,-1,20984,-15734
INJ_207,20211113,7250,5250,0,0,20988,-15738
INJ_207,20211115,13500,9750,0,0,38979,-29229
INJ_207,20211117,7500,7500,0,0,29990,-22490
INJ_207,20211118,6500,6500,0,-1,25987,-19487
INJ_207,20211119,4500,4500,0,1,17986,-13486
INJ_207,20211122,5750,5750,0,1,22990,-17240
INJ_207,20211123,6250,2500,0,0,24995,-22495
INJ_207,20211124,8250,6500,0,0,25986,-19486
INJ_207,20211126,6250,6250,0,1,24986,-18736
INJ_207,20211204,10250,10250,0,1,40977,-30727
INJ_207,20211207,6500,6500,0,-1,25987,-19487
INJ_207,20211208,20000,18000,0,0,71969,-53969
INJ_207,20211209,4250,750,0,0,9208,-8458
INJ_207,20211210,7250,5250,0,0,20986,-15736
INJ_207,20211211,18500,16750,0,2,66966,-50216
INJ_207,20211213,6500,6500,0,13,25989,-19489
INJ_207,20211214,10500,10500,0,0,41978,-31478
INJ_207,20211218,16750,16750,0,-1,66972,-50222
INJ_207,20211221,3250,3250,0,0,12989,-9739
INJ_207,20211222,3750,3750,0,2,14992,-11242
INJ_207,20211223,4500,4500,0,0,17989,-13489
INJ_207,20211225,3500,3500,0,0,13989,-10489
INJ_207,20211227,4250,4250,0,1,16985,-12735
INJ_207,20211228,10250,10250,0,1,40980,-30730
INJ_207,20211230,6250,6250,0,0,24986,-18736
INJ_207,20211231,7000,7000,0,0,27982,-20982
INJ_207,20220101,2500,2500,0,-1,9991,-7491
INJ_207,20220103,10250,7750,0,0,30975,-23225
INJ_207,20220104,9750,9750,0,0,38973,-29223
INJ_207,20220106,5500,5500,0,1,21983,-16483
INJ_207,20220107,9250,9250,0,-1,36979,-27729
INJ_207,20220111,14500,12500,0,1,49970,-37470
INJ_207,20220113,5250,5250,0,0,20986,-15736
INJ_207,20220115,12500,12500,0,-1,49977,-37477
INJ_207,20220117,9250,9250,0,0,36981,-27731
INJ_207,20220118,5750,5750,0,0,22988,-17238
INJ_207,20220119,5250,5250,0,1,20989,-15739
INJ_207,20220120,4000,4000,0,0,15984,-11984
INJ_207,20220121,10500,10500,0,1,41971,-31471
INJ_207,20220125,6500,6500,0,-1,25983,-19483
INJ_207,20220126,4000,4000,0,1,15987,-11987
INJ_207,20220127,4000,4000,0,0,15993,-11993
INJ_207,20220128,7000,7000,0,1,27984,-20984
INJ_207,20220129,8750,8750,0,0,34981,-26231
INJ_207,20220131,17000,17000,0,0,67964,-50964
INJ_207,20220201,5500,4000,0,1,15991,-11991
INJ_207,20220202,6250,6250,0,0,24988,-18738
INJ_207,20220207,4000,4000,0,0,15991,-11991
INJ_207,20220209,13000,13000,0,0,51973,-38973
INJ_207,20220210,5250,5250,0,14,20989,-15739
INJ_207,20220211,4750,4750,0,1,18991,-14241
INJ_207,20220212,4750,4750,0,0,18991,-14241
INJ_207,20220215,7750,7750,0,0,30977,-23227
INJ_207,20220216,6500,6500,0,0,25985,-19485
INJ_207,20220217,3750,3750,0,2,14992,-11242
INJ_207,20220218,4750,4750,0,2,18988,-14238
INJ_207,20220219,4750,4750,0,1,18990,-14240
INJ_207,20220221,5750,5750,0,0,22991,-17241
INJ_207,20220224,4500,4500,0,1,17987,-13487
INJ_207,20220226,6500,6500,0,0,25984,-19484
INJ_207,20220228,9750,9750,0,0,38978,-29228
INJ_207,20220301,3750,3750,0,0,14991,-11241
INJ_207,20220302,14750,13000,0,0,51976,-38976
INJ_207,20220305,6750,5000,0,0,19986,-14986
INJ_207,20220308,4750,4750,0,1,18990,-14240
INJ_207,20220311,15000,11250,0,0,52971,-41721
INJ_207,20220312,12750,12750,0,3,50972,-38222
INJ_207,20220314,16000,13750,0,2,56966,-43216
INJ_207,20220315,10000,10000,0,2,39979,-29979
INJ_207,20220316,10250,10250,0,0,40980,-30730
INJ_207,20220317,9000,9000,0,0,35904,-26904
INJ_207,20220318,4500,4500,0,0,17992,-13492
INJ_207,20220319,8750,8750,0,-1,34986,-26236
INJ_207,20220321,4750,4750,0,0,18991,-14241
INJ_207,20220322,10000,10000,0,1,39981,-29981
INJ_207,20220324,5000,5000,0,0,19992,-14992
INJ_207,20220326,7000,7000,0,0,27988,-20988
INJ_207,20220328,6500,6500,0,1,25984,-19484
INJ_207,20220330,10750,9000,0,4,35983,-26983
INJ_207,20220331,6500,4500,0,9,25986,-21486
INJ_207,20220401,9750,9750,0,-1,38979,-29229
INJ_207,20220402,3250,3250,0,0,12993,-9743
INJ_207,20220407,5250,5250,0,0,20990,-15740
INJ_207,20220414,3750,3750,0,1,14993,-11243
INJ_207,20220418,5000,5000,0,0,19989,-14989
INJ_207,20220419,5250,5250,0,1,20990,-15740
INJ_207,20220421,4500,4500,0,0,17990,-13490
INJ_207,20220424,4250,4250,0,-1,16991,-12741
INJ_207,20220425,5250,5250,0,0,20988,-15738
INJ_207,20220427,9250,9250,0,3,36981,-27731
INJ_207,20220429,4750,3500,0,0,18990,-15490
INJ_207,20220505,19250,19250,0,1,76957,-57707
INJ_207,20220509,5250,5250,0,0,20990,-15740
INJ_207,20220513,15750,15750,0,0,62965,-47215
INJ_207,20220514,5250,5250,0,0,20990,-15740
INJ_207,20220517,4500,4500,0,2,17989,-13489
INJ_207,20220518,14500,14500,0,1,57965,-43465
INJ_207,20220519,3250,3250,0,0,12992,-9742
INJ_207,20220520,6500,6500,0,0,25983,-19483
INJ_207,20220521,6500,6500,0,1,25984,-19484
INJ_207,20220523,5250,5250,0,1,20986,-15736
INJ_207,20220524,5000,5000,0,-1,19980,-14980
INJ_207,20220525,5250,5250,0,0,20986,-15736
INJ_207,20220526,4500,4500,0,0,17990,-13490
INJ_207,20220530,7250,4000,0,1,15990,-11990
INJ_207,20220601,5250,5250,0,0,20988,-15738
INJ_207,20220602,13750,9750,0,0,38980,-29230
INJ_207,20220603,5250,5250,0,1,20991,-15741
INJ_207,20220604,4750,4750,0,0,18988,-14238
INJ_207,20220606,12250,12250,0,1,48978,-36728
INJ_207,20220607,5250,5250,0,1,20989,-15739
INJ_207,20220608,5250,5250,0,-1,20990,-15740
INJ_207,20220610,10000,10000,0,1,39975,-29975
INJ_207,20220611,10000,10000,0,5,39975,-29975
INJ_207,20220613,16250,16250,0,0,64961,-48711
INJ_207,20220614,6500,6500,0,0,25984,-19484
INJ_207,20220615,9500,9500,0,1,37976,-28476
INJ_207,20220617,3750,3750,0,-1,14995,-11245
INJ_207,20220618,13000,13000,0,14,51976,-38976
INJ_207,20220620,7500,7500,0,1,29982,-22482
INJ_207,20220621,4500,4500,0,0,17988,-13488
INJ_207,20220622,17000,17000,0,0,62956,-45956
INJ_207,20220625,4500,4500,0,-1,17989,-13489
INJ_207,20220627,13500,11750,0,3,46961,-35211
INJ_207,20220628,4500,4500,0,1,17991,-13491
INJ_207,20220630,11000,11000,0,0,43979,-32979
INJ_207,20220701,9000,9000,0,1,35985,-26985
INJ_207,20220702,14750,14750,0,1,58972,-44222
INJ_207,20220704,5250,5250,0,0,20986,-15736
INJ_207,20220705,4750,4750,0,2,18990,-14240
INJ_207,20220706,8750,8750,0,2,34981,-26231
INJ_207,20220707,5250,5250,0,-1,20988,-15738
INJ_207,20220708,9750,9750,0,2,38975,-29225
INJ_207,20220714,3250,3250,0,0,12994,-9744
INJ_207,20220716,9750,9750,0,1,38977,-29227
INJ_207,20220718,10250,10250,0,-2,40976,-30726
INJ_207,20220720,6250,4500,0,0,17991,-13491
INJ_207,20220721,9250,9250,0,-1,36979,-27729
INJ_207,20220722,5250,5250,0,2,20986,-15736
INJ_207,20220723,8500,8500,0,-1,33977,-25477
INJ_207,20220725,9000,9000,0,2,35981,-26981
INJ_207,20220727,3250,3250,0,-1,12996,-9746
INJ_207,20220731,7000,5250,0,0,20990,-15740
INJ_207,20220803,9500,9500,0,6,37979,-28479
INJ_207,20220804,9000,9000,0,0,35975,-26975
INJ_207,20220805,8250,6500,0,0,25985,-19485
INJ_207,20220809,3750,3750,0,0,14992,-11242
INJ_207,20220812,9000,9000,0,0,35983,-26983
INJ_207,20220815,10250,10250,0,4,40974,-30724
INJ_207,20220816,2500,2500,0,11,9997,-7497
INJ_207,20220817,9000,9000,0,0,35982,-26982
INJ_207,20220818,9750,9750,0,2,38979,-29229
INJ_207,20220820,3750,3750,0,0,14991,-11241
INJ_207,20220822,9750,9750,0,2,38975,-29225
INJ_207,20220823,5250,5250,0,1,20987,-15737
INJ_207,20220824,6750,5000,0,0,19990,-14990
INJ_207,20220825,12000,10250,0,0,40978,-30728
INJ_207,20220827,3250,3250,0,-1,12994,-9744
INJ_207,20220829,4500,4500,0,0,17991,-13491
INJ_207,20220901,5250,5250,0,0,20987,-15737
INJ_207,20220902,6750,5000,0,0,19988,-14988
INJ_207,20220903,5250,5250,0,0,20988,-15738
INJ_207,20220907,5250,5250,0,1,20988,-15738
INJ_207,20220908,8000,8000,0,-1,31984,-23984
INJ_207,20220909,10250,10250,0,-1,40979,-30729
INJ_207,20220914,5250,5250,0,1,20987,-15737
INJ_207,20220915,5250,5250,0,11,20988,-15738
INJ_207,20220916,5250,5250,0,0,20993,-15743
INJ_207,20220917,8000,8000,0,0,31983,-23983
INJ_207,20220919,3250,3250,0,0,12993,-9743
INJ_207,20220921,3500,3500,0,0,13991,-10491
INJ_207,20220927,4000,4000,0,1,15992,-11992
INJ_207,20221001,6250,6250,0,2,24987,-18737
INJ_207,20221004,14250,14250,0,4,56965,-42715
INJ_207,20221005,5250,5250,0,1,20988,-15738
INJ_207,20221007,9000,9000,4,246,35977,-26977
INJ_207,20221010,5000,5000,0,5,19989,-14989
INJ_207,20221011,11000,11000,0,1,43977,-32977
INJ_207,20221012,4500,4500,0,1,17991,-13491
INJ_207,20221013,16000,16000,0,2,63964,-47964
INJ_207,20221015,6750,5250,0,2,20989,-15739
INJ_207,20221017,9250,9250,11,585,36971,-27721
INJ_207,20221018,5250,5250,0,1,20986,-15736
INJ_207,20221024,4500,4500,0,0,0,4500
INJ_207,20221027,6500,6500,0,0,25987,-19487
INJ_207,20221028,5250,5250,0,1,20993,-15743
INJ_207,20221029,9750,9750,0,0,38984,-29234
INJ_207,20221031,5250,5250,0,0,20993,-15743
INJ_207,20221104,5250,5250,0,0,20992,-15742
INJ_207,20221107,4750,4750,0,0,18987,-14237
INJ_207,20221109,4750,4750,0,-1,18990,-14240
INJ_207,20221110,5250,5250,0,1,20989,-15739
INJ_207,20221111,6750,5000,0,-1,19988,-14988
INJ_207,20221114,5250,5250,0,1,20987,-15737
INJ_207,20221117,4750,4750,0,-1,18990,-14240
INJ_207,20221118,9000,9000,0,0,35983,-26983
INJ_207,20221122,10000,10000,0,0,39980,-29980
INJ_207,20221123,6500,4500,0,-1,25988,-21488
INJ_207,20221128,5250,5250,0,0,20989,-15739
INJ_207,20221130,8250,4750,0,-1,25989,-21239
INJ_207,20221202,5250,5250,0,1,20990,-15740
INJ_207,20221203,9500,9500,0,1,37976,-28476
INJ_207,20221205,4500,4500,0,-1,17989,-13489
INJ_207,20221206,9500,9500,0,1,37976,-28476
INJ_207,20221209,4000,4000,0,1,15990,-11990
INJ_207,20221212,9000,9000,0,-2,35979,-26979
INJ_207,20221215,32000,2000,0,0,7997,-5997
INJ_207,20221219,24500,1750,0,0,6997,-5247
INJ_207,20221221,5250,5250,0,0,20988,-15738
INJ_207,20221223,5750,5750,0,0,22983,-17233
INJ_207,20221224,4250,4250,0,0,16989,-12739
INJ_207,20221226,16250,6500,0,1,21297,-14797
INJ_207,20221227,3000,1500,0,0,1145,355
INJ_207,20221229,27500,2500,0,0,5792,-3292
INJ_207,20221230,32000,2000,0,0,7996,-5996
INJ_207,20230103,4500,1500,0,0,1676,-176
INJ_207,20230106,19250,1750,0,0,5756,-4006
INJ_207,20230111,26250,1750,0,0,6999,-5249
INJ_207,20230120,89500,6000,0,0,21379,-15379
INJ_207,20230308,28000,1750,0,0,6998,-5248
INJ_207,20230313,45000,2500,0,0,8889,-6389
INJ_207,20230314,24500,1750,0,0,6999,-5249
INJ_208,20210928,1650,1650,0,0,10982,-9332
INJ_208,20210929,1350,1350,0,-1,8979,-7629
INJ_208,20210930,600,600,0,0,3992,-3392
INJ_208,20211001,1200,600,0,0,3991,-3391
INJ_208,20211007,1350,1350,0,1,8985,-7635
INJ_208,20211008,600,600,0,-1,3992,-3392
INJ_208,20211012,450,450,0,0,2989,-2539
INJ_208,20211015,600,600,0,0,3990,-3390
INJ_208,20211018,600,600,0,0,3991,-3391
INJ_208,20211021,450,450,0,0,2994,-2544
INJ_208,20211022,750,750,0,-1,4983,-4233
INJ_208,20211029,3000,3000,0,1,19966,-16966
INJ_208,20211102,900,450,0,18,2992,-2542
INJ_208,20211105,750,750,0,5,4992,-4242
INJ_208,20211109,450,450,0,0,2994,-2544
INJ_208,20211111,600,600,0,0,3990,-3390
INJ_208,20211113,1500,750,0,1,4992,-4242
INJ_208,20211115,900,450,0,0,2992,-2542
INJ_208,20211118,600,600,0,0,3993,-3393
INJ_208,20211119,1200,1200,0,0,7992,-6792
INJ_208,20211122,600,600,0,-1,3992,-3392
INJ_208,20211123,450,450,0,1,2991,-2541
INJ_208,20211124,450,450,0,-1,2836,-2386
INJ_208,20211126,1200,1200,0,1,7983,-6783
INJ_208,20211204,1050,1050,0,54,6983,-5933
INJ_208,20211207,450,450,0,-1,2993,-2543
INJ_208,20211208,1350,1350,0,-1,8975,-7625
INJ_208,20211210,450,450,0,1,2993,-2543
INJ_208,20211211,750,750,0,0,4990,-4240
INJ_208,20211214,900,900,0,-1,5980,-5080
INJ_208,20211218,3750,2550,0,0,16966,-14416
INJ_208,20211221,750,750,0,-1,4992,-4242
INJ_208,20211222,450,450,0,0,2992,-2542
INJ_208,20211225,900,900,0,0,5989,-5089
INJ_208,20211227,450,450,0,0,2993,-2543
INJ_208,20211228,2100,2100,0,0,13973,-11873
INJ_208,20211230,450,450,0,0,2993,-2543
INJ_208,20211231,750,750,0,0,4991,-4241
INJ_208,20220101,3000,1500,0,0,9993,-8493
INJ_208,20220103,1200,1200,0,0,7983,-6783
INJ_208,20220104,2700,1950,0,7,12979,-11029
INJ_208,20220106,1200,1200,0,0,7993,-6793
INJ_208,20220107,1200,1200,0,0,7983,-6783
INJ_208,20220111,450,450,0,0,2992,-2542
INJ_208,20220113,600,600,0,10,3994,-3394
INJ_208,20220115,450,450,0,21,2994,-2544
INJ_208,20220117,1050,1050,0,0,6984,-5934
INJ_208,20220118,600,600,0,-1,3992,-3392
INJ_208,20220119,600,600,0,1,3992,-3392
INJ_208,20220120,600,600,0,15,3992,-3392
INJ_208,20220127,600,600,0,0,3992,-3392
INJ_208,20220128,1500,1500,0,-1,9977,-8477
INJ_208,20220129,1350,1350,0,0,8985,-7635
INJ_208,20220131,450,450,0,0,2993,-2543
INJ_208,20220201,600,600,0,0,3990,-3390
INJ_208,20220202,450,450,0,0,2993,-2543
INJ_208,20220207,600,600,0,0,3990,-3390
INJ_208,20220210,450,450,0,0,2994,-2544
INJ_208,20220215,1950,1950,0,0,12985,-11035
INJ_208,20220217,600,600,0,0,3992,-3392
INJ_208,20220219,1350,1350,0,24,8983,-7633
INJ_208,20220221,450,450,0,18,2994,-2544
INJ_208,20220225,819,819,0,14,5454,-4635
INJ_208,20220228,1200,1200,0,0,7981,-6781
INJ_208,20220301,750,750,0,1,4991,-4241
INJ_208,20220302,1050,1050,0,-1,6985,-5935
INJ_208,20220305,1050,1050,0,1,6983,-5933
INJ_208,20220308,450,450,0,0,2992,-2542
INJ_208,20220311,4050,3600,0,-1,23957,-20357
INJ_208,20220312,1950,1950,0,0,12967,-11017
INJ_208,20220314,1650,1650,0,0,10977,-9327
INJ_208,20220315,900,900,0,5,5983,-5083
INJ_208,20220316,900,900,0,1,5982,-5082
INJ_208,20220317,600,600,0,-1,3991,-3391
INJ_208,20220318,750,750,0,0,4992,-4242
INJ_208,20220319,1950,1950,0,0,12974,-11024
INJ_208,20220321,450,450,0,0,2992,-2542
INJ_208,20220322,1050,1050,0,0,6981,-5931
INJ_208,20220324,600,600,0,-1,3992,-3392
INJ_208,20220326,750,750,0,0,4994,-4244
INJ_208,20220328,600,600,0,0,3992,-3392
INJ_208,20220330,1800,1800,0,1,11979,-10179
INJ_208,20220401,450,450,0,0,2992,-2542
INJ_208,20220402,1350,1350,0,0,8987,-7637
INJ_208,20220407,450,450,0,0,2993,-2543
INJ_208,20220413,450,450,0,0,2992,-2542
INJ_208,20220414,600,600,0,0,3990,-3390
INJ_208,20220418,600,600,0,1,3993,-3393
INJ_208,20220421,1200,1200,0,-1,7993,-6793
INJ_208,20220424,750,750,0,27,4992,-4242
INJ_208,20220425,750,750,0,0,4991,-4241
INJ_208,20220427,450,450,0,0,2991,-2541
INJ_208,20220429,2100,2100,0,1,13973,-11873
INJ_208,20220505,2700,2700,0,0,17963,-15263
INJ_208,20220509,1200,1200,0,-1,7985,-6785
INJ_208,20220513,1500,1500,0,1,9974,-8474
INJ_208,20220514,1200,1200,0,0,7985,-6785
INJ_208,20220517,600,600,0,0,3991,-3391
INJ_208,20220518,2250,2250,0,0,14970,-12720
INJ_208,20220519,1800,1800,0,0,11983,-10183
INJ_208,20220520,600,600,0,0,3991,-3391
INJ_208,20220523,750,750,0,0,4992,-4242
INJ_208,20220525,600,600,0,0,3991,-3391
INJ_208,20220526,600,600,0,0,3992,-3392
INJ_208,20220530,1200,600,0,0,3990,-3390
INJ_208,20220601,450,450,0,0,2992,-2542
INJ_208,20220602,1800,1800,0,0,11970,-10170
INJ_208,20220603,450,450,0,12,2991,-2541
INJ_208,20220604,450,450,0,0,2991,-2541
INJ_208,20220606,450,450,0,0,2990,-2540
INJ_208,20220607,5700,5700,0,0,37934,-32234
INJ_208,20220608,6150,6150,0,19,40929,-34779
INJ_208,20220610,1500,1500,0,-1,9968,-8468
INJ_208,20220611,450,450,0,0,2993,-2543
INJ_208,20220613,4500,4500,0,0,29944,-25444
INJ_208,20220617,750,750,0,-1,4985,-4235
INJ_208,20220618,3150,3150,0,-1,20957,-17807
INJ_208,20220620,7200,7200,0,0,47913,-40713
INJ_208,20220622,1650,1650,0,0,10972,-9322
INJ_208,20220625,600,600,0,0,3991,-3391
INJ_208,20220627,3600,2400,0,0,15974,-13574
INJ_208,20220628,600,600,0,14,3990,-3390
INJ_208,20220630,3750,3750,0,0,24942,-21192
INJ_208,20220701,1350,1350,0,0,8970,-7620
INJ_208,20220702,1350,1350,0,0,8980,-7630
INJ_208,20220704,1200,1200,0,0,7981,-6781
INJ_208,20220705,450,450,0,0,2990,-2540
INJ_208,20220706,2700,2700,0,-1,17967,-15267
INJ_208,20220707,600,600,0,0,3991,-3391
INJ_208,20220708,1950,1950,0,0,12982,-11032
INJ_208,20220714,1050,1050,0,1,6981,-5931
INJ_208,20220716,1200,1200,0,16,7983,-6783
INJ_208,20220718,1350,1350,0,17,8982,-7632
INJ_208,20220720,600,600,0,0,3992,-3392
INJ_208,20220721,750,750,0,0,4994,-4244
INJ_208,20220722,600,600,0,0,3992,-3392
INJ_208,20220723,1200,1200,0,0,7982,-6782
INJ_208,20220725,900,900,0,-1,5982,-5082
INJ_208,20220727,1200,1200,0,0,7981,-6781
INJ_208,20220809,450,450,0,0,2990,-2540
INJ_208,20220812,1200,1200,0,0,7982,-6782
INJ_208,20220815,1350,1350,0,0,8982,-7632
INJ_208,20220816,1800,1800,0,0,11976,-10176
INJ_208,20220817,1350,1350,0,1,8983,-7633
INJ_208,20220818,1500,1500,0,0,9980,-8480
INJ_208,20220820,600,600,0,-1,3991,-3391
INJ_208,20220822,750,750,0,1,4990,-4240
INJ_208,20220823,600,600,0,-1,3991,-3391
INJ_208,20220825,900,900,0,0,5980,-5080
INJ_208,20220827,450,450,0,1,2991,-2541
INJ_208,20220901,450,450,0,-1,2990,-2540
INJ_208,20220902,1800,900,0,0,5992,-5092
INJ_208,20220903,450,450,0,0,2992,-2542
INJ_208,20220907,1800,1800,0,-1,11970,-10170
INJ_208,20220908,1350,1350,0,0,8984,-7634
INJ_208,20220909,1050,1050,0,0,6981,-5931
INJ_208,20220914,450,450,0,0,2990,-2540
INJ_208,20220915,600,600,0,23,3993,-3393
INJ_208,20220916,750,750,0,17,4992,-4242
INJ_208,20220917,9600,1350,0,2,8981,-7631
INJ_208,20220919,3600,600,0,-1,3991,-3391
INJ_208,20220921,2250,450,0,1,2991,-2541
INJ_208,20221001,7500,750,0,1,4992,-4242
INJ_208,20221004,6000,750,0,0,4993,-4243
INJ_208,20221007,13800,1500,0,2,9983,-8483
INJ_208,20221010,2250,450,0,0,2992,-2542
INJ_208,20221011,6000,750,0,1,4993,-4243
INJ_208,20221013,6450,1050,0,1,6985,-5935
INJ_208,20221015,2250,450,0,0,2989,-2539
INJ_208,20221017,6750,750,0,0,4990,-4240
INJ_208,20221029,4200,600,0,-1,3991,-3391
INJ_208,20221104,6000,750,0,2,4990,-4240
INJ_208,20221107,6000,750,0,1,4991,-4241
INJ_208,20221110,2700,450,0,0,2991,-2541
INJ_208,20221111,9000,900,0,-2,5992,-5092
INJ_208,20221117,6000,750,0,34,4991,-4241
INJ_208,20221118,13200,1500,0,8,9983,-8483
INJ_208,20221202,6750,750,0,0,4990,-4240
INJ_208,20221203,2250,450,0,0,2990,-2540
INJ_208,20221205,13800,1500,0,3,9981,-8481
INJ_208,20221212,10200,1350,0,1,8983,-7633
INJ_208,20221215,6000,750,0,1,4991,-4241
INJ_208,20221224,2250,450,0,1,2991,-2541
INJ_208,20221226,4200,600,0,1,3992,-3392
INJ_208,20221227,2250,450,0,0,2988,-2538
INJ_208,20221229,6750,750,0,2,4994,-4244
INJ_208,20230106,6000,750,0,0,4989,-4239
INJ_208,20230111,2250,450,0,0,2991,-2541
INJ_208,20230120,15450,2250,0,1,14968,-12718
INJ_208,20230303,1050,1050,9,897,6985,-5935
INJ_208,20230304,1050,1050,3,900,6984,-5934
INJ_208,20230306,600,600,2,698,3990,-3390
INJ_208,20230308,1200,1200,1,499,7981,-6781
INJ_208,20230309,2550,2550,11,405,16976,-14426
INJ_208,20230310,450,450,5,703,2993,-2543
INJ_208,20230311,1050,1050,10,209,6984,-5934
INJ_208,20230313,1500,750,5,106,4992,-4242
INJ_208,20230314,600,600,4,848,3994,-3394
INJ_208,20230316,600,600,4,200,3990,-3390
INJ_208,20230320,900,450,2,400,2991,-2541
INJ_208,20230321,1200,1200,1,198,7981,-6781
INJ_208,20230322,450,450,4,794,2992,-2542
INJ_208,20230323,450,450,1,203,2990,-2540
INJ_208,20230324,600,600,6,892,3991,-3391
INJ_208,20230327,750,750,2,400,4992,-4242
INJ_208,20230403,450,450,7,801,2989,-2539
INJ_208,20230405,4200,600,0,2,3991,-3391
INJ_208,20230406,750,750,7,800,4991,-4241
INJ_208,20230407,450,450,4,199,2993,-2543
INJ_208,20230408,600,600,5,399,3990,-3390
INJ_208,20230414,750,750,1,200,4993,-4243
INJ_208,20230415,450,450,6,302,2992,-2542
INJ_208,20230419,450,450,4,200,2993,-2543
INJ_208,20230420,1050,1050,4,197,6982,-5932
INJ_208,20230421,450,450,4,499,2990,-2540
INJ_208,20230424,1350,1350,3,599,8986,-7636
INJ_208,20230425,3000,1200,5,103,7978,-6778
INJ_208,20230427,1200,1200,0,0,7979,-6779
INJ_208,20230429,600,600,1,502,3989,-3389
INJ_208,20230502,1800,900,3,301,5993,-5093
INJ_208,20230503,750,750,2,406,4994,-4244
INJ_208,20230504,600,600,14,854,3992,-3392
INJ_208,20230505,1200,1200,2,398,7983,-6783
INJ_208,20230515,450,450,6,651,2991,-2541
INJ_208,20230516,2100,2100,4,503,13974,-11874
INJ_208,20230517,2250,2250,6,598,14971,-12721
INJ_208,20230518,600,600,1,797,3991,-3391
INJ_208,20230522,450,450,2,734,2991,-2541
INJ_208,20230526,600,600,5,97,3991,-3391
INJ_208,20230529,1050,1050,1,200,6993,-5943
INJ_208,20230530,900,900,4,197,5981,-5081
INJ_208,20230531,900,900,5,108,5984,-5084
INJ_208,20230601,450,450,2,999,2990,-2540
INJ_208,20230602,750,750,3,602,4991,-4241
INJ_208,20230607,1200,1200,2,402,7984,-6784
INJ_208,20230612,900,450,3,299,2992,-2542
INJ_208,20230615,750,750,4,500,4990,-4240
INJ_208,20230616,1200,1200,2,698,7990,-6790
INJ_208,20230622,600,600,5,401,3990,-3390
INJ_208,20230623,900,900,2,398,5981,-5081
INJ_208,20230624,450,450,1,798,2993,-2543
INJ_208,20230704,750,750,8,99,4990,-4240
INJ_208,20230705,750,750,1,500,4991,-4241
INJ_208,20230706,2550,2550,1,496,16971,-14421
INJ_208,20230713,1200,1200,9,192,7990,-6790
INJ_208,20230714,1200,600,1,913,3991,-3391
INJ_208,20230718,1200,1200,4,204,7981,-6781
INJ_209,20210929,3750,3750,0,0,14992,-11242
INJ_209,20210930,4250,2750,0,1,10993,-8243
INJ_209,20211001,2750,2000,0,0,7995,-5995
INJ_209,20211007,1250,1250,0,-1,4999,-3749
INJ_209,20211008,1500,1500,0,0,5995,-4495
INJ_209,20211012,2250,2250,0,2,8995,-6745
INJ_209,20211015,2000,2000,0,-1,7993,-5993
INJ_209,20211018,3500,3500,0,29,13990,-10490
INJ_209,20211021,2250,2250,0,13,8995,-6745
INJ_209,20211022,3750,3750,0,0,14995,-11245
INJ_209,20211029,4500,4500,0,11,17989,-13489
INJ_209,20211102,1000,1000,0,1,3996,-2996
INJ_209,20211105,1750,1750,0,0,6993,-5243
INJ_209,20211109,1000,1000,0,1,3996,-2996
INJ_209,20211111,2000,2000,0,23,7999,-5999
INJ_209,20211113,2750,1750,0,0,6995,-5245
INJ_209,20211115,8000,6000,0,0,23989,-17989
INJ_209,20211117,1250,1250,0,0,4994,-3744
INJ_209,20211118,750,750,0,0,2996,-2246
INJ_209,20211119,1750,1750,0,2,6995,-5245
INJ_209,20211122,1500,1500,0,8,5994,-4494
INJ_209,20211123,5500,5500,0,0,6992,-1492
INJ_209,20211124,2000,1000,0,0,3997,-2997
INJ_209,20211204,4500,4500,0,-1,17986,-13486
INJ_209,20211207,1000,1000,0,0,3997,-2997
INJ_209,20211208,4500,4500,0,2,17992,-13492
INJ_209,20211210,2250,2250,0,0,8995,-6745
INJ_209,20211211,6750,6750,0,0,26984,-20234
INJ_209,20211213,1750,1750,0,1,6997,-5247
INJ_209,20211214,4500,4500,0,-1,17992,-13492
INJ_209,20211218,4250,4250,0,0,16989,-12739
INJ_209,20211221,3750,3750,0,2,14988,-11238
INJ_209,20211222,3750,3750,0,29,14992,-11242
INJ_209,20211223,3750,3750,0,1,14989,-11239
INJ_209,20211225,3250,3250,0,0,12993,-9743
INJ_209,20211227,3250,3250,0,0,12995,-9745
INJ_209,20211228,2750,2750,0,2,10990,-8240
INJ_209,20211230,1250,1250,0,0,4996,-3746
INJ_209,20220101,3750,3750,0,0,15000,-11250
INJ_209,20220103,6750,6750,0,0,26980,-20230
INJ_209,20220104,3500,3500,0,0,13992,-10492
INJ_209,20220106,750,750,0,0,2996,-2246
INJ_209,20220107,5250,5250,0,0,20989,-15739
INJ_209,20220111,3250,3250,0,1,12989,-9739
INJ_209,20220113,2000,2000,0,0,7993,-5993
INJ_209,20220115,4000,2500,0,0,9995,-7495
INJ_209,20220117,6000,6000,0,2,23991,-17991
INJ_209,20220118,1500,1500,0,27,5994,-4494
INJ_209,20220119,2000,2000,0,7,7996,-5996
INJ_209,20220120,3250,3250,0,0,12992,-9742
INJ_209,20220121,6500,6500,0,0,25987,-19487
INJ_209,20220125,1750,1750,0,0,6993,-5243
INJ_209,20220126,4250,4250,0,3,16992,-12742
INJ_209,20220127,3250,3250,0,6,12995,-9745
INJ_209,20220128,7500,7500,0,1,29994,-22494
INJ_209,20220129,5500,5500,0,3,21988,-16488
INJ_209,20220131,6250,6250,0,2,24986,-18736
INJ_209,20220201,5250,3250,0,1,12990,-9740
INJ_209,20220202,1250,1250,0,0,4997,-3747
INJ_209,20220207,3250,3250,0,-1,12995,-9745
INJ_209,20220209,3500,3500,0,14,13988,-10488
INJ_209,20220210,2250,2250,0,1,8993,-6743
INJ_209,20220211,3500,3500,0,-1,13992,-10492
INJ_209,20220212,3500,3500,0,43,13992,-10492
INJ_209,20220215,6000,6000,0,0,23993,-17993
INJ_209,20220216,1750,1750,0,0,6997,-5247
INJ_209,20220217,3500,3500,0,1,13993,-10493
INJ_209,20220218,3500,3500,0,0,13991,-10491
INJ_209,20220219,1250,1250,0,9,4997,-3747
INJ_209,20220221,1750,1750,0,1,6997,-5247
INJ_209,20220224,3750,3750,0,2,14990,-11240
INJ_209,20220226,1750,1750,0,0,6992,-5242
INJ_209,20220228,4750,4750,0,0,18987,-14237
INJ_209,20220301,3750,3750,0,0,14994,-11244
INJ_209,20220302,1750,1750,0,0,6994,-5244
INJ_209,20220305,5000,2500,0,10,9993,-7493
INJ_209,20220308,2750,2750,0,1,10995,-8245
INJ_209,20220311,8500,7500,0,0,21982,-14482
INJ_209,20220312,9250,9250,0,49,36983,-27733
INJ_209,20220314,9000,8250,0,1,30978,-22728
INJ_209,20220315,5000,5000,0,1,19984,-14984
INJ_209,20220316,4750,4750,0,3,18991,-14241
INJ_209,20220317,7000,7000,0,1,27986,-20986
INJ_209,20220318,2500,2500,0,0,9996,-7496
INJ_209,20220319,4500,4500,0,17,17991,-13491
INJ_209,20220321,2750,2750,0,0,10994,-8244
INJ_209,20220322,4750,4750,0,0,18989,-14239
INJ_209,20220324,2250,2250,0,0,8995,-6745
INJ_209,20220326,500,500,0,0,1998,-1498
INJ_209,20220328,750,750,0,0,2997,-2247
INJ_209,20220330,4500,4500,0,15,17991,-13491
INJ_209,20220331,3750,3750,0,0,6994,-3244
INJ_209,20220401,6000,6000,0,1,23980,-17980
INJ_209,20220402,2750,2750,0,0,10994,-8244
INJ_209,20220407,2250,2250,0,0,8990,-6740
INJ_209,20220413,1250,1250,0,0,4998,-3748
INJ_209,20220414,3500,3500,0,1,13986,-10486
INJ_209,20220418,2250,2250,0,0,8995,-6745
INJ_209,20220419,3000,3000,0,0,11993,-8993
INJ_209,20220421,1750,1750,0,8,6995,-5245
INJ_209,20220424,2750,2750,0,30,10992,-8242
INJ_209,20220425,1750,1750,0,1,6997,-5247
INJ_209,20220427,6500,6500,0,1,25988,-19488
INJ_209,20220429,1250,1250,0,0,0,1250
INJ_209,20220505,9750,9750,0,8,38971,-29221
INJ_209,20220509,1000,1000,0,0,3997,-2997
INJ_209,20220513,7000,7000,0,1,27989,-20989
INJ_209,20220514,1000,1000,0,1,3997,-2997
INJ_209,20220517,2750,2750,0,0,10991,-8241
INJ_209,20220518,7000,7000,0,3,27988,-20988
INJ_209,20220519,2000,2000,0,0,7991,-5991
INJ_209,20220520,750,750,0,-1,2996,-2246
INJ_209,20220521,1750,1750,0,2,6994,-5244
INJ_209,20220523,1750,1750,0,1,6993,-5243
INJ_209,20220524,3750,3750,0,-1,14996,-11246
INJ_209,20220525,2000,2000,0,1,7993,-5993
INJ_209,20220526,2750,2750,0,0,10995,-8245
INJ_209,20220530,6500,3250,0,-1,12995,-9745
INJ_209,20220601,2250,2250,0,0,8993,-6743
INJ_209,20220602,3750,3750,0,1,14991,-11241
INJ_209,20220603,2250,2250,0,24,8993,-6743
INJ_209,20220604,2750,2750,0,0,10995,-8245
INJ_209,20220606,4000,4000,0,1,15989,-11989
INJ_209,20220607,1750,1750,0,44,6997,-5247
INJ_209,20220608,1000,1000,0,1,3998,-2998
INJ_209,20220610,4000,4000,0,-1,15993,-11993
INJ_209,20220611,5750,5750,0,1,22983,-17233
INJ_209,20220613,13500,9750,0,1,38979,-29229
INJ_209,20220614,1750,1750,0,2,6993,-5243
INJ_209,20220615,7000,7000,0,1,27980,-20980
INJ_209,20220617,3750,3750,0,0,14997,-11247
INJ_209,20220618,6500,6500,0,42,25988,-19488
INJ_209,20220620,5250,5250,0,27,20983,-15733
INJ_209,20220621,3750,3750,0,6,14992,-11242
INJ_209,20220622,14500,13250,0,3,57962,-44712
INJ_209,20220625,2750,2750,0,-1,10993,-8243
INJ_209,20220627,10500,9000,0,1,35978,-26978
INJ_209,20220628,4250,2750,0,0,10993,-8243
INJ_209,20220630,8000,8000,0,11,31989,-23989
INJ_209,20220701,5750,5750,0,26,22993,-17243
INJ_209,20220702,7750,7750,0,35,30968,-23218
INJ_209,20220704,1000,1000,0,0,3994,-2994
INJ_209,20220705,2750,2750,0,0,10990,-8240
INJ_209,20220706,3250,3250,0,20,12990,-9740
INJ_209,20220707,2000,2000,0,0,7995,-5995
INJ_209,20220708,3500,3500,0,1,13988,-10488
INJ_209,20220714,3250,3250,0,0,12994,-9744
INJ_209,20220716,4750,4750,0,0,18989,-14239
INJ_209,20220718,4000,4000,0,1,15992,-11992
INJ_209,20220720,4250,2750,0,0,10995,-8245
INJ_209,20220721,6000,6000,0,0,23984,-17984
INJ_209,20220722,2000,2000,0,0,7991,-5991
INJ_209,20220723,7500,6000,0,-1,23986,-17986
INJ_209,20220725,6000,6000,0,-1,23989,-17989
INJ_209,20220727,3000,3000,0,2,11996,-8996
INJ_209,20220731,3000,3000,0,1,11992,-8992
INJ_209,20220803,7000,7000,0,-1,27979,-20979
INJ_209,20220804,7500,7500,0,0,29983,-22483
INJ_209,20220805,2500,1750,0,0,6997,-5247
INJ_209,20220809,3750,3750,0,1,14987,-11237
INJ_209,20220812,5500,5500,0,2,21985,-16485
INJ_209,20220815,4000,4000,0,-1,15988,-11988
INJ_209,20220816,2750,2750,0,0,10993,-8243
INJ_209,20220817,5250,5250,0,1,20986,-15736
INJ_209,20220818,4250,4250,0,0,16988,-12738
INJ_209,20220820,3500,3500,0,0,13995,-10495
INJ_209,20220822,5500,5500,0,2,21983,-16483
INJ_209,20220823,2000,2000,0,0,7994,-5994
INJ_209,20220824,3000,2250,0,15,8992,-6742
INJ_209,20220825,5750,4750,0,1,18991,-14241
INJ_209,20220827,4250,4250,0,0,16987,-12737
INJ_209,20220829,3750,3750,0,1,14995,-11245
INJ_209,20220901,2250,2250,0,0,8993,-6743
INJ_209,20220902,2500,1750,0,0,6992,-5242
INJ_209,20220903,2250,2250,0,1,8994,-6744
INJ_209,20220908,6250,6250,0,0,24991,-18741
INJ_209,20220909,4500,4500,0,0,17989,-13489
INJ_209,20220914,2250,2250,0,6,8993,-6743
INJ_209,20220915,2000,2000,0,7,7993,-5993
INJ_209,20220916,1750,1750,0,1,6995,-5245
INJ_209,20220917,6250,6250,0,-1,24986,-18736
INJ_209,20220919,4000,4000,0,9,15988,-11988
INJ_209,20220927,4250,4250,0,17,16995,-12745
INJ_209,20221001,750,750,0,1,2996,-2246
INJ_209,20221004,7000,7000,0,-2,27988,-20988
INJ_209,20221005,2000,2000,0,0,7994,-5994
INJ_209,20221007,5000,5000,3,244,19987,-14987
INJ_209,20221010,2500,2500,0,5,9995,-7495
INJ_209,20221011,4250,4250,0,2,16988,-12738
INJ_209,20221012,1750,1750,0,1,6995,-5245
INJ_209,20221013,8750,7500,0,1,29985,-22485
INJ_209,20221015,3250,2250,0,1,8995,-6745
INJ_209,20221017,5000,5000,11,71,19983,-14983
INJ_209,20221018,2000,2000,0,-1,7990,-5990
INJ_209,20221024,2750,2750,0,18,0,2750
INJ_209,20221027,1750,1750,0,7,6993,-5243
INJ_209,20221028,4250,3000,0,0,11996,-8996
INJ_209,20221029,5750,5750,0,0,22990,-17240
INJ_209,20221031,1750,1750,0,1,6997,-5247
INJ_209,20221104,1750,1750,0,-1,6998,-5248
INJ_209,20221107,2250,2250,0,0,8993,-6743
INJ_209,20221109,3500,3500,0,1,13994,-10494
INJ_209,20221110,2250,2250,0,1,8991,-6741
INJ_209,20221111,1750,1750,0,0,6993,-5243
INJ_209,20221114,750,750,0,0,2997,-2247
INJ_209,20221117,2250,2250,0,0,8991,-6741
INJ_209,20221118,3750,3750,0,0,14994,-11244
INJ_209,20221122,5750,5750,0,1,22989,-17239
INJ_209,20221123,3750,3750,0,1,6996,-3246
INJ_209,20221128,1750,1750,0,1,6994,-5244
INJ_209,20221130,4250,3500,0,0,6995,-3495
INJ_209,20221202,1750,1750,0,2,6994,-5244
INJ_209,20221203,4750,4750,0,0,18985,-14235
INJ_209,20221205,1250,1250,0,0,4998,-3748
INJ_209,20221206,6250,6250,0,2,24986,-18736
INJ_209,20221209,3250,3250,0,-1,12997,-9747
INJ_209,20221212,5250,5250,0,0,20991,-15741
INJ_209,20221215,5000,5000,0,1,19986,-14986
INJ_209,20221219,7000,5500,0,1,21983,-16483
INJ_209,20221221,1750,1750,0,0,6993,-5243
INJ_209,20221223,1500,1500,0,0,5997,-4497
INJ_209,20221224,3250,3250,0,0,12994,-9744
INJ_209,20221226,2500,750,0,1,7689,-6939
INJ_209,20221227,1000,1000,0,1,3995,-2995
INJ_209,20221229,7000,4500,0,1,22185,-17685
INJ_209,20221230,4500,4500,0,1,17989,-13489
INJ_209,20230103,1000,1000,0,0,3998,-2998
INJ_209,20230111,5750,5750,0,-1,22999,-17249
INJ_209,20230120,17000,15000,0,2,62595,-47595
INJ_209,20230308,33750,3250,0,0,10011,-6761
INJ_209,20230313,33500,2750,0,1,9056,-6306
INJ_209,20230314,32000,2000,0,0,7999,-5999
INJ_301,20210927,10500,10500,0,1,34995,-24495
INJ_301,20210929,24600,24600,0,0,81991,-57391
INJ_301,20210930,22500,22500,0,0,74974,-52474
INJ_301,20211001,12600,12600,0,1,41986,-29386
INJ_301,20211002,28500,28500,0,0,94976,-66476
INJ_301,20211004,29700,27300,0,-2,90974,-63674
INJ_301,20211005,22800,22800,0,1,75978,-53178
INJ_301,20211006,22800,22800,0,0,75987,-53187
INJ_301,20211007,39900,32400,0,-2,107984,-75584
INJ_301,20211008,35100,35100,0,2,116989,-81889
INJ_301,20211009,29400,27000,0,2,83976,-56976
INJ_301,20211011,40800,40800,0,-1,135980,-95180
INJ_301,20211012,16800,16800,6,927,55997,-39197
INJ_301,20211013,4800,4800,38,487,15998,-11198
INJ_301,20211015,7200,3600,0,0,1484,2116
INJ_301,20211022,20100,17700,0,-1,58993,-41293
INJ_301,20211023,29400,27000,0,1,89990,-62990
INJ_301,20211025,15600,15600,0,1,51989,-36389
INJ_301,20211026,4200,4200,0,0,13995,-9795
INJ_301,20211027,15000,15000,0,1,49991,-34991
INJ_301,20211028,14100,14100,0,0,38811,-24711
INJ_301,20211029,29100,29100,0,1,96996,-67896
INJ_301,20211030,46800,46800,0,1,155975,-109175
INJ_301,20211101,23400,23400,0,1,77989,-54589
INJ_301,20211102,35400,35400,0,2,117978,-82578
INJ_301,20211103,26700,26700,0,-2,88977,-62277
INJ_301,20211104,15300,15300,0,-1,50995,-35695
INJ_301,20211105,26700,25500,0,0,84991,-59491
INJ_301,20211106,21900,21900,0,1,72980,-51080
INJ_301,20211108,26400,22800,0,1,75979,-53179
INJ_301,20211109,30000,30000,0,-1,99980,-69980
INJ_301,20211110,40200,40200,0,0,133986,-93786
INJ_301,20211111,27600,24900,0,-1,82997,-58097
INJ_301,20211112,19800,15600,0,0,51992,-36392
INJ_301,20211113,41400,41400,0,-2,137972,-96572
INJ_301,20211114,3300,3300,0,1,10998,-7698
INJ_301,20211115,14400,4500,0,-1,2664,1836
INJ_301,20211116,30600,6600,0,0,29361,-22761
INJ_301,20211117,12600,12600,0,-1,41991,-29391
INJ_301,20211118,29100,29100,0,0,96971,-67871
INJ_301,20211119,32100,29700,0,-2,98975,-69275
INJ_301,20211120,51000,49200,0,3,163960,-114760
INJ_301,20211122,8400,6000,0,0,19996,-13996
INJ_301,20211126,35700,35700,0,1,118987,-83287
INJ_301,20211127,36300,33900,0,0,112901,-79001
INJ_301,20211129,11700,11700,0,-1,38986,-27286
INJ_301,20211130,34800,34800,0,-1,115956,-81156
INJ_301,20211201,33900,30300,0,0,100976,-70676
INJ_301,20211202,22500,22500,0,1,74981,-52481
INJ_301,20211203,25800,21600,0,-1,71985,-50385
INJ_301,20211204,32700,32700,0,1,108980,-76280
INJ_301,20211206,40800,37200,0,0,123973,-86773
INJ_301,20211207,24300,23100,0,2,76990,-53890
INJ_301,20211208,42300,42300,0,2,140991,-98691
INJ_301,20211209,23700,23700,0,0,78979,-55279
INJ_301,20211210,20100,17700,0,0,58995,-41295
INJ_301,20211211,47400,44400,0,1,147981,-103581
INJ_301,20211213,24600,22200,0,0,73987,-51787
INJ_301,20211214,14700,13800,0,0,45995,-32195
INJ_301,20211215,44400,35100,0,1,116969,-81869
INJ_301,20211216,35400,31200,0,0,104383,-73183
INJ_301,20211217,27000,24000,0,-2,79989,-55989
INJ_301,20211218,43800,37200,0,-1,123981,-86781
INJ_301,20211221,24000,24000,0,-1,79984,-55984
INJ_301,20211222,23700,21300,0,-1,70988,-49688
INJ_301,20211223,26700,26700,0,0,88966,-62266
INJ_301,20211224,47100,42900,0,0,142968,-100068
INJ_301,20211225,36000,36000,0,2,108463,-72463
INJ_301,20211227,39300,39300,0,-2,130976,-91676
INJ_301,20211228,28200,25800,0,1,85984,-60184
INJ_301,20211229,40200,37500,0,0,124978,-87478
INJ_301,20211230,33300,32100,0,1,106983,-74883
INJ_301,20211231,32400,32400,0,0,107989,-75589
INJ_301,20220101,41400,33000,1,200,119994,-86994
INJ_301,20220102,3600,3600,0,-1,11998,-8398
INJ_301,20220103,24000,24000,-1,-200,65984,-41984
INJ_301,20220104,25200,25200,0,0,83981,-58781
INJ_301,20220105,19500,14700,0,1,49873,-35173
INJ_301,20220126,22500,22500,0,0,74904,-52404
INJ_301,20220127,11100,8700,0,1,28951,-20251
INJ_301,20220128,30000,28800,0,-1,95847,-67047
INJ_301,20220129,21900,20700,0,0,68886,-48186
INJ_301,20220131,33000,31500,0,0,104853,-73353
INJ_301,20220201,14100,14100,0,-1,46933,-32833
INJ_301,20220202,21600,21600,0,1,71800,-50200
INJ_301,20220203,13500,13500,0,1,44930,-31430
INJ_301,20220204,9300,6900,0,0,22449,-15549
INJ_301,20220205,20130,20130,0,0,66907,-46777
INJ_301,20220207,5400,5400,0,0,17979,-12579
INJ_301,20220208,14400,14400,0,0,47943,-33543
INJ_301,20220209,22200,22200,0,0,73877,-51677
INJ_301,20220210,18600,18600,0,-1,61911,-43311
INJ_301,20220211,34500,34500,0,-1,114832,-80332
INJ_301,20220212,27900,25500,0,0,84882,-59382
INJ_301,20220214,15900,15900,0,1,52906,-37006
INJ_301,20220215,27900,27900,0,0,92854,-64954
INJ_301,20220216,14400,14400,0,0,47914,-33514
INJ_301,20220217,2100,2100,0,1,6983,-4883
INJ_301,20220218,18300,18300,0,0,60908,-42608
INJ_301,20220219,7200,2400,0,0,1686,714
INJ_301,20220711,5400,2700,0,0,1280,1420
INJ_301,20220926,250,250,0,1,1992,-1742
INJ_301,20221006,250,250,0,0,1991,-1741
INJ_301,20221008,1250,1250,0,0,9974,-8724
INJ_301,20221015,500,500,0,0,3990,-3490
INJ_301,20221105,375,375,0,0,2992,-2617
INJ_301,20221108,375,375,0,0,2992,-2617
INJ_301,20221112,375,375,0,0,2992,-2617
INJ_301,20221119,2000,1000,0,0,7991,-6991
INJ_301,20221123,375,375,0,0,2991,-2616
INJ_301,20221124,375,375,0,-1,2991,-2616
INJ_301,20221129,250,250,0,0,1991,-1741
INJ_301,20221207,500,500,0,0,3991,-3491
INJ_301,20221212,250,250,0,0,1992,-1742
INJ_301,20221219,375,375,0,0,2991,-2616
INJ_301,20221223,1250,1250,0,0,9983,-8733
INJ_301,20221227,250,250,0,0,1991,-1741
INJ_301,20221230,500,500,0,-1,3990,-3490
INJ_301,20230104,375,375,0,0,3001,-2626
INJ_301,20230106,750,750,0,0,6001,-5251
INJ_301,20230109,750,750,0,1,6001,-5251
INJ_301,20230114,900,900,0,-1,3001,-2101
INJ_301,20230123,1875,1875,0,2,15001,-13126
INJ_301,20230126,500,500,0,-1,4002,-3502
INJ_301,20230130,625,625,0,0,4997,-4372
INJ_301,20230206,500,500,0,1,4000,-3500
INJ_301,20230207,1125,1125,0,0,9000,-7875
INJ_301,20230217,375,375,0,-1,3000,-2625
INJ_301,20230221,375,375,0,1,3001,-2626
INJ_301,20230309,1000,1000,0,0,8001,-7001
INJ_301,20230313,5100,5100,0,-1,16999,-11899
INJ_301,20230314,15300,13500,0,1,44848,-31348
INJ_301,20230316,375,375,0,0,3000,-2625
INJ_301,20230328,250,250,0,0,2000,-1750
INJ_301,20230405,375,375,0,0,3000,-2625
INJ_301,20230406,500,500,0,1,4001,-3501
INJ_301,20230414,375,375,0,0,3002,-2627
INJ_301,20230418,250,250,0,-1,1999,-1749
INJ_301,20230419,375,375,0,0,3000,-2625
INJ_301,20230427,23400,1800,0,0,6000,-4200
INJ_301,20230504,2250,375,0,0,3000,-2625
INJ_301,20230508,135000,12900,0,0,24188,-11288
INJ_301,20230509,75700,7420,0,0,20318,-12898
INJ_301,20230510,69920,7360,0,0,17342,-9982
INJ_301,20230511,18400,1840,0,0,5108,-3268
INJ_301,20230512,58420,4830,0,0,17670,-12840
INJ_301,20230513,34500,3910,0,0,9844,-5934
INJ_301,20230515,95680,11960,0,0,25772,-13812
INJ_301,20230516,164220,17480,0,0,43076,-25596
INJ_301,20230517,97520,10580,0,0,28908,-18328
INJ_301,20230518,14490,2070,0,0,4131,-2061
INJ_301,20230519,61640,7360,0,0,16200,-8840
INJ_301,20230520,81420,9660,0,0,21095,-11435
INJ_301,20230522,135700,11500,0,0,34527,-23027
INJ_301,20230523,20240,1840,0,0,5917,-4077
INJ_301,20230524,24840,2070,0,0,6698,-4628
INJ_301,20230525,40020,5060,0,0,11896,-6836
INJ_301,20230526,57960,6440,0,0,15969,-9529
INJ_301,20230527,70840,10810,0,0,17243,-6433
INJ_301,20230529,76590,14260,0,0,21948,-7688
INJ_301,20230606,75900,8050,0,0,25248,-17198
INJ_301,20230607,67620,6900,0,0,18580,-11680
INJ_301,20230608,77280,7360,0,0,21830,-14470
INJ_301,20230609,16800,2600,0,0,11042,-8442
INJ_301,20230610,38800,4600,0,0,28664,-24064
INJ_301,20230612,12400,1400,0,0,11614,-10214
INJ_301,20230613,4200,600,0,0,4817,-4217
INJ_301,20230614,41500,4900,0,0,30400,-25500
INJ_301,20230615,11800,3400,0,0,9875,-6475
INJ_301,20230616,1600,800,0,0,757,43
INJ_301,20230617,10400,800,0,0,8000,-7200
INJ_301,20230619,56100,5300,0,0,41608,-36308
INJ_301,20230621,14600,2300,0,0,13539,-11239
INJ_301,20230627,3600,600,0,0,3693,-3093
INJ_301,20230628,36800,5200,0,0,28023,-22823
INJ_301,20230703,18000,2000,0,0,13235,-11235
INJ_301,20230704,22200,2500,0,0,17374,-14874
INJ_301,20230705,10400,800,0,0,8000,-7200
INJ_301,20230706,10400,800,0,0,8000,-7200
INJ_301,20230707,12300,1500,0,0,10082,-8582
INJ_301,20230708,10400,800,0,0,7999,-7199
INJ_301,20230710,21800,2600,0,0,17357,-14757
INJ_301,20230711,1500,300,0,0,2999,-2699
INJ_301,20230712,16400,1400,0,0,14000,-12600
INJ_301,20230713,14300,1700,0,0,14015,-12315
INJ_301,20230714,14600,1400,0,0,12823,-11423
INJ_301,20230715,20800,1600,0,0,15999,-14399
INJ_301,20230717,31200,2800,0,0,20966,-18166
INJ_301,20230718,57920,10040,0,0,35773,-25733
INJ_302,20211004,23400,1800,0,0,5998,-4198
INJ_302,20211005,9300,1500,0,0,4996,-3496
INJ_302,20211011,39900,3300,0,0,10995,-7695
INJ_302,20211015,3600,1800,0,0,1051,749
INJ_302,20220126,51600,7200,0,0,23977,-16777
INJ_302,20220127,18300,2100,0,0,6991,-4891
INJ_302,20220128,26400,3900,0,0,12982,-9082
INJ_302,20220129,32700,3300,0,0,10988,-7688
INJ_302,20220131,58500,6300,0,0,20974,-14674
INJ_302,20220201,18600,3000,0,0,9983,-6983
INJ_302,20220202,35700,3900,0,0,12982,-9082
INJ_302,20220203,12300,2100,0,0,6989,-4889
INJ_302,20220204,15000,3000,0,0,2763,237
INJ_302,20220205,9300,1500,0,0,4994,-3494
INJ_302,20220207,3000,600,0,0,1997,-1397
INJ_302,20220208,12729,2243,0,0,5994,-3751
INJ_302,20220209,33900,6300,0,0,13370,-7070
INJ_302,20220210,18600,3000,0,0,9984,-6984
INJ_302,20220211,42300,4500,0,0,14985,-10485
INJ_302,20220212,57000,8700,0,0,20864,-12164
INJ_302,20220214,63000,3000,0,0,9998,-6998
INJ_302,20220218,3000,1500,9,636,4996,-3496
INJ_302,20220715,12600,1800,0,0,5996,-4196
INJ_302,20220716,63300,9900,0,0,32974,-23074
INJ_302,20220718,20100,2700,0,0,8995,-6295
INJ_302,20220719,17100,2100,0,0,6995,-4895
INJ_302,20220720,33600,3600,0,0,11995,-8395
INJ_302,20220721,28800,3600,0,0,11991,-8391
INJ_302,20220722,68400,7200,0,0,23985,-16785
INJ_302,20220723,78000,10800,0,0,30540,-19740
INJ_302,20220727,18600,3000,0,0,9989,-6989
INJ_302,20220728,12600,1800,0,0,5995,-4195
INJ_302,20220729,64200,4200,0,0,13996,-9796
INJ_302,20220730,6000,1200,0,0,3993,-2793
INJ_302,20220801,12600,1800,0,0,5996,-4196
INJ_302,20220802,88800,7200,0,0,23988,-16788
INJ_302,20220803,90600,10500,0,0,34977,-24477
INJ_302,20220804,15600,2400,0,0,7993,-5593
INJ_302,20220805,15000,1800,0,0,5996,-4196
INJ_302,20220806,32700,3300,0,0,10993,-7693
INJ_302,20220808,18600,3000,0,0,9992,-6992
INJ_302,20220809,35400,4200,0,0,13992,-9792
INJ_302,20220810,50100,5100,0,0,16992,-11892
INJ_302,20220811,43200,4500,0,0,14992,-10492
INJ_302,20220812,9300,1500,0,0,4995,-3495
INJ_302,20220813,48600,5400,0,0,17987,-12587
INJ_302,20220814,17100,2100,0,0,6996,-4896
INJ_302,20220815,29100,4200,0,0,13993,-9793
INJ_302,20220816,26400,3600,0,0,11993,-8393
INJ_302,20220818,56100,5100,0,0,16992,-11892
INJ_302,20220819,10800,1200,0,0,3998,-2798
INJ_302,20220820,32700,3300,0,0,10993,-7693
INJ_302,20220822,12300,2100,0,0,6994,-4894
INJ_302,20220823,20100,2700,0,0,8994,-6294
INJ_302,20220826,3000,600,0,0,1998,-1398
INJ_302,20220827,2100,2100,0,0,1072,1028
INJ_302,20220902,32100,3900,0,0,12990,-9090
INJ_302,20220903,17100,2100,0,0,6994,-4894
INJ_302,20220907,9300,1500,0,0,4996,-3496
INJ_302,20220908,23400,1800,0,0,5998,-4198
INJ_302,20220909,8700,2100,0,0,4102,-2002
INJ_302,20220910,29700,3900,0,0,12991,-9091
INJ_302,20220912,6300,900,0,0,2998,-2098
INJ_302,20220913,10800,1200,0,0,3998,-2798
INJ_302,20220914,6300,900,0,0,2997,-2097
INJ_302,20220915,2700,900,0,0,1588,-688
INJ_302,20220916,3000,600,0,0,4996,-4396
INJ_302,20220917,29400,4200,0,0,10990,-6790
INJ_302,20230314,16500,1500,0,0,4993,-3493
INJ_302,20230325,13500,1800,0,0,5997,-4197
INJ_302,20230327,6300,900,0,0,2998,-2098
INJ_302,20230328,6300,900,0,0,2997,-2097
INJ_302,20230330,18600,3000,0,0,9991,-6991
INJ_302,20230401,48000,3300,0,0,10997,-7697
INJ_302,20230403,29100,4500,0,0,14951,-10451
INJ_302,20230404,70500,6300,0,0,20990,-14690
INJ_302,20230405,12300,2100,0,0,6996,-4896
INJ_302,20230406,21900,3300,0,0,10993,-7693
INJ_302,20230407,42600,4500,0,0,14994,-10494
INJ_302,20230408,31500,2700,0,0,8996,-6296
INJ_302,20230410,23400,1800,0,0,5998,-4198
INJ_302,20230411,6300,900,0,0,2998,-2098
INJ_302,20230412,3000,600,0,0,1998,-1398
INJ_302,20230414,69900,8100,0,0,26982,-18882
INJ_302,20230417,59400,5400,0,0,17990,-12590
INJ_302,20230418,79200,7200,0,0,23986,-16786
INJ_302,20230419,3000,600,0,0,1998,-1398
INJ_302,20230426,9300,1500,0,0,4997,-3497
INJ_302,20230427,69300,3900,0,0,12996,-9096
INJ_302,20230428,13800,1800,0,0,5997,-4197
INJ_302,20230429,16500,1500,0,0,4998,-3498
INJ_302,20230430,6300,900,0,0,2998,-2098
INJ_302,20230501,23100,3300,0,0,10991,-7691
INJ_302,20230502,22800,2400,0,0,7995,-5595
INJ_302,20230503,37800,5400,0,0,13201,-7801
INJ_302,20230504,66300,8100,0,0,26961,-18861
INJ_302,20230505,35700,5100,0,0,16988,-11888
INJ_302,20230506,53100,5700,0,0,18982,-13282
INJ_302,20230508,9300,1500,0,0,4996,-3496
INJ_302,20230510,19200,1800,0,0,8997,-7197
INJ_302,20230511,8400,1200,0,0,5996,-4796
INJ_302,20230512,3600,600,0,0,2998,-2398
INJ_302,20230513,1600,400,0,0,1998,-1598
INJ_302,20230515,7200,1200,0,0,5994,-4794
INJ_302,20230516,35400,4200,0,0,20988,-16788
INJ_302,20230517,8400,1800,0,0,8994,-7194
INJ_302,20230518,10000,1000,0,0,4997,-3997
INJ_302,20230519,24400,2600,0,0,12994,-10394
INJ_302,20230520,24000,3000,0,0,11235,-8235
INJ_302,20230523,3600,600,0,0,2998,-2398
INJ_302,20230524,1600,400,0,0,1998,-1598
INJ_302,20230527,22800,2400,0,0,11994,-9594
INJ_302,20230529,18000,1800,0,0,8997,-7197
INJ_302,20230531,13200,2200,0,0,10989,-8789
INJ_302,20230601,9200,1600,0,0,7993,-6393
INJ_302,20230602,14400,1200,0,0,5998,-4798
INJ_302,20230605,19600,3000,0,0,14989,-11989
INJ_302,20230606,32000,2400,0,0,11994,-9594
INJ_302,20230607,11600,1400,0,0,6996,-5596
INJ_302,20230608,11600,1800,0,0,8993,-7193
INJ_302,20230609,14300,1500,0,0,14991,-13491
INJ_302,20230610,4600,1000,0,0,9992,-8992
INJ_302,20230612,5100,900,0,0,8995,-8095
INJ_302,20230614,6700,1200,0,0,11506,-10306
INJ_302,20230615,12200,1400,0,0,11696,-10296
INJ_302,20230616,2600,500,0,0,4995,-4495
INJ_302,20230617,2800,400,0,0,3997,-3597
INJ_302,20230619,1500,300,0,0,2999,-2699
INJ_302,20230621,13400,1400,0,0,13993,-12593
INJ_302,20230622,16000,1000,0,0,9997,-8997
INJ_302,20230623,4000,500,0,0,4999,-4499
INJ_302,20230624,4300,700,0,0,6995,-6295
INJ_302,20230625,800,200,0,0,1998,-1798
INJ_302,20230627,24000,2000,0,0,19992,-17992
INJ_302,20230628,23500,2200,0,0,21991,-19791
INJ_302,20230704,3400,900,0,0,6521,-5621
INJ_302,20230706,6000,600,0,0,5996,-5396
INJ_302,20230707,6800,800,0,0,7996,-7196
INJ_302,20230712,800,200,0,0,1998,-1798
INJ_302,20230713,6000,600,0,0,5998,-5398
INJ_302,20230714,4300,700,0,0,6995,-6295
INJ_302,20230715,1800,300,0,0,2998,-2698
INJ_302,20230717,8900,1100,0,0,10994,-9894
INJ_302,20230718,9800,1400,0,0,13992,-12592
INJ_303,20210927,9300,9300,0,0,30993,-21693
INJ_303,20210929,24900,24900,0,-1,82980,-58080
INJ_303,20210930,24600,24600,0,2,81974,-57374
INJ_303,20211001,10500,10500,0,-1,34990,-24490
INJ_303,20211002,26700,26700,0,0,88973,-62273
INJ_303,20211004,27300,24300,0,1,80969,-56669
INJ_303,20211005,20100,20100,0,0,66985,-46885
INJ_303,20211006,27900,27900,0,0,92979,-65079
INJ_303,20211007,36900,30900,0,3,102976,-72076
INJ_303,20211008,33000,33000,0,0,109974,-76974
INJ_303,20211009,27900,24900,0,1,73419,-48519
INJ_303,20211011,34200,34200,0,1,113966,-79766
INJ_303,20211012,14100,14100,0,0,46974,-32874
INJ_303,20211013,3600,3600,22,809,11995,-8395
INJ_303,20211022,13800,13800,0,0,45980,-32180
INJ_303,20211023,23100,21300,0,-1,70974,-49674
INJ_303,20211025,13200,13200,0,1,43987,-30787
INJ_303,20211026,3300,3300,0,0,10994,-7694
INJ_303,20211027,12600,12600,0,0,41988,-29388
INJ_303,20211028,13500,10800,0,-1,32376,-21576
INJ_303,20211029,27300,27300,0,0,90967,-63667
INJ_303,20211030,41400,41400,0,2,137951,-96551
INJ_303,20211101,22200,22200,0,-1,73986,-51786
INJ_303,20211102,30900,30900,0,0,102968,-72068
INJ_303,20211103,24300,24300,0,0,80980,-56680
INJ_303,20211104,13200,13200,0,-1,43986,-30786
INJ_303,20211105,23700,20700,0,1,68987,-48287
INJ_303,20211106,19800,19800,0,-1,65971,-46171
INJ_303,20211108,15300,12900,0,0,42987,-30087
INJ_303,20211109,33900,33900,0,1,112972,-79072
INJ_303,20211110,33300,33300,0,-1,110972,-77672
INJ_303,20211111,23700,21600,0,-1,71983,-50383
INJ_303,20211112,20700,18000,0,1,59975,-41975
INJ_303,20211113,38400,32400,0,-2,107966,-75566
INJ_303,20211114,4500,4500,0,0,14993,-10493
INJ_303,20211115,9000,4200,0,0,1835,2365
INJ_303,20211116,27300,9600,0,1,24620,-15020
INJ_303,20211117,11700,11700,0,0,38992,-27292
INJ_303,20211118,25800,25800,0,0,85977,-60177
INJ_303,20211119,33000,33000,0,1,109970,-76970
INJ_303,20211120,43800,43800,0,1,145953,-102153
INJ_303,20211122,8700,7200,0,0,23993,-16793
INJ_303,20211126,33300,33300,0,0,110974,-77674
INJ_303,20211127,34500,31500,0,0,104977,-73477
INJ_303,20211129,9000,9000,0,0,29980,-20980
INJ_303,20211130,33600,33600,0,1,111969,-78369
INJ_303,20211201,28500,28500,0,-1,94974,-66474
INJ_303,20211202,22500,22500,0,0,74968,-52468
INJ_303,20211203,18300,17700,0,-1,58977,-41277
INJ_303,20211204,31200,31200,0,0,103965,-72765
INJ_303,20211206,37800,34800,0,0,115955,-81155
INJ_303,20211207,21900,21300,0,-1,70983,-49683
INJ_303,20211208,38700,38700,0,-2,128958,-90258
INJ_303,20211209,17700,17700,0,0,58974,-41274
INJ_303,20211210,22500,19500,0,0,64986,-45486
INJ_303,20211211,38400,36600,0,1,121965,-85365
INJ_303,20211213,26100,23100,0,3,76975,-53875
INJ_303,20211214,14100,13500,0,1,44982,-31482
INJ_303,20211215,38700,36000,0,1,119961,-83961
INJ_303,20211216,27900,27900,0,2,92577,-64677
INJ_303,20211217,22500,22500,0,0,74974,-52474
INJ_303,20211218,49800,39300,0,-1,130956,-91656
INJ_303,20211221,26700,26700,0,-1,88977,-62277
INJ_303,20211222,24600,21600,0,0,71982,-50382
INJ_303,20211223,29100,29100,0,2,96960,-67860
INJ_303,20211224,43800,38400,0,-2,127956,-89556
INJ_303,20211225,32400,32400,0,-2,101438,-69038
INJ_303,20211227,44100,44100,0,-1,146967,-102867
INJ_303,20211228,26700,23700,0,0,78972,-55272
INJ_303,20211229,39600,36600,0,-1,121970,-85370
INJ_303,20211230,25800,25800,0,1,85964,-60164
INJ_303,20211231,29100,29100,0,0,96972,-67872
INJ_303,20220101,34800,30600,2,998,107975,-77375
INJ_303,20220102,3900,3900,0,0,12993,-9093
INJ_303,20220103,23400,23400,0,-2,71979,-48579
INJ_303,20220104,25500,25500,0,0,84974,-59474
INJ_303,20220105,14400,14400,0,1,46977,-32577
INJ_303,20220126,19800,19800,0,0,65888,-46088
INJ_303,20220127,4500,4500,0,-1,14959,-10459
INJ_303,20220128,26700,26700,0,0,88865,-62165
INJ_303,20220129,17400,15600,0,0,51909,-36309
INJ_303,20220131,15000,15000,0,0,49915,-34915
INJ_303,20220201,12600,12600,0,0,41936,-29336
INJ_303,20220202,17100,13500,0,0,44922,-31422
INJ_303,20220203,14100,14100,0,-1,46923,-32823
INJ_303,20220204,9000,7200,0,0,23963,-16763
INJ_303,20220205,16500,16500,0,1,54917,-38417
INJ_303,20220207,3900,3900,0,0,12977,-9077
INJ_303,20220208,13200,13200,0,-1,43915,-30715
INJ_303,20220209,18900,18900,0,-1,62903,-44003
INJ_303,20220210,11400,11400,0,-1,37928,-26528
INJ_303,20220211,27900,27900,0,0,92854,-64954
INJ_303,20220212,25800,24000,0,0,79857,-55857
INJ_303,20220214,12600,12600,0,0,41917,-29317
INJ_303,20220215,22200,22200,0,1,73829,-51629
INJ_303,20220216,14400,14400,0,1,47910,-33510
INJ_303,20220217,1500,1500,0,0,4973,-3473
INJ_303,20220218,15000,15000,0,0,49885,-34885
INJ_303,20220219,9000,3000,0,0,1873,1127
INJ_303,20220711,6000,3000,0,0,1369,1631
INJ_303,20220826,4800,2400,0,0,1182,1218
INJ_303,20220919,625,625,0,0,4992,-4367
INJ_303,20220930,750,750,0,0,5996,-5246
INJ_303,20221008,250,250,0,-1,1997,-1747
INJ_303,20221010,1000,1000,0,0,7997,-6997
INJ_303,20221013,1000,1000,0,0,7993,-6993
INJ_303,20221015,875,875,0,1,6990,-6115
INJ_303,20221021,375,375,0,0,2997,-2622
INJ_303,20221022,875,875,0,0,6991,-6116
INJ_303,20221027,750,750,0,0,5996,-5246
INJ_303,20221110,1625,1625,0,1,12983,-11358
INJ_303,20221112,250,250,0,0,1996,-1746
INJ_303,20221119,2500,1250,0,0,9997,-8747
INJ_303,20221123,375,375,0,0,2996,-2621
INJ_303,20221129,250,250,0,0,1996,-1746
INJ_303,20221206,750,750,0,0,5998,-5248
INJ_303,20221219,625,625,0,0,4996,-4371
INJ_303,20221223,250,250,0,1,1997,-1747
INJ_303,20221224,500,500,0,-1,3998,-3498
INJ_303,20221230,625,625,0,1,4995,-4370
INJ_303,20230106,250,250,0,0,2002,-1752
INJ_303,20230111,250,250,0,-1,2001,-1751
INJ_303,20230114,1200,1200,0,0,4000,-2800
INJ_303,20230123,625,625,0,0,5002,-4377
INJ_303,20230125,500,500,0,0,4000,-3500
INJ_303,20230203,375,375,0,0,3000,-2625
INJ_303,20230221,250,250,0,-1,2000,-1750
INJ_303,20230313,4800,4800,0,1,16001,-11201
INJ_303,20230314,13800,13800,0,-2,46005,-32205
INJ_303,20230317,1000,1000,0,1,8000,-7000
INJ_303,20230324,375,375,0,1,2999,-2624
INJ_303,20230405,1875,1875,0,-1,14999,-13124
INJ_303,20230407,250,250,0,0,2002,-1752
INJ_303,20230412,375,375,0,0,3000,-2625
INJ_303,20230419,625,625,0,0,4999,-4374
INJ_303,20230427,8100,8100,0,1,26999,-18899
INJ_303,20230429,750,750,0,-1,6000,-5250
INJ_303,20230508,37800,24900,0,0,101793,-76893
INJ_303,20230509,25190,19610,0,-1,81669,-62059
INJ_303,20230510,23660,14460,0,0,72657,-58197
INJ_303,20230511,6210,4370,0,0,21894,-17524
INJ_303,20230512,15410,12420,0,0,57342,-44922
INJ_303,20230513,14490,10580,0,1,53158,-42578
INJ_303,20230515,37030,24610,0,0,133219,-108609
INJ_303,20230516,57270,37950,0,1,197927,-159977
INJ_303,20230517,42320,29210,0,-2,144105,-114895
INJ_303,20230518,6210,4140,0,0,22874,-18734
INJ_303,20230519,21160,12420,0,-1,69818,-57398
INJ_303,20230520,27830,18170,0,0,99897,-81727
INJ_303,20230522,34270,26450,0,-1,130467,-104017
INJ_303,20230523,7460,5620,0,0,24081,-18461
INJ_303,20230524,6900,4830,0,2,23298,-18468
INJ_303,20230525,18400,13340,0,0,68108,-54768
INJ_303,20230526,27830,16330,0,-1,83035,-66705
INJ_303,20230527,27790,16980,0,-2,101773,-84793
INJ_303,20230529,47150,32890,0,-2,183053,-150163
INJ_303,20230606,23420,19280,0,-1,91779,-72499
INJ_303,20230607,22080,17020,0,-1,85427,-68407
INJ_303,20230608,27980,21770,0,0,101189,-79419
INJ_303,20230609,9200,5800,0,1,72967,-67167
INJ_303,20230610,13300,9200,0,-3,109330,-100130
INJ_303,20230612,3600,2800,0,-1,30382,-27582
INJ_303,20230613,1800,1200,0,0,13180,-11980
INJ_303,20230614,13610,10010,0,1,100834,-90824
INJ_303,20230615,6400,4400,0,0,49827,-45427
INJ_303,20230616,2800,2000,0,-1,27245,-25245
INJ_303,20230617,2100,2100,0,1,21001,-18901
INJ_303,20230619,14400,11800,0,-3,129381,-117581
INJ_303,20230621,9280,6980,0,0,68467,-61487
INJ_303,20230622,2300,2300,0,0,22996,-20696
INJ_303,20230627,1800,1200,0,0,14300,-13100
INJ_303,20230628,15210,10410,0,1,119896,-109486
INJ_303,20230703,6600,4600,0,-1,52762,-48162
INJ_303,20230704,9000,8200,0,1,83313,-75113
INJ_303,20230705,2500,2500,0,-1,25002,-22502
INJ_303,20230706,5200,5200,0,0,52007,-46807
INJ_303,20230707,3400,2200,0,0,26925,-24725
INJ_303,20230708,2500,2500,0,-1,24997,-22497
INJ_303,20230710,7600,5800,0,0,66631,-60831
INJ_303,20230711,900,900,0,1,8996,-8096
INJ_303,20230712,8000,6800,0,-1,67995,-61195
INJ_303,20230713,8340,7740,0,0,74980,-67240
INJ_303,20230714,3600,3000,0,0,31178,-28178
INJ_303,20230715,4700,4700,0,1,47004,-42304
INJ_303,20230717,14040,7080,0,0,67061,-59981
INJ_303,20230718,22040,13400,0,1,166256,-152856
INJ_304,20210927,1800,1800,0,285,50990,-49190
INJ_304,20210928,10200,10200,0,1,81987,-71787
INJ_304,20210929,8800,8800,0,1,63987,-55187
INJ_304,20210930,11200,10300,0,-2,74981,-64681
INJ_304,20211001,8400,8400,0,0,55981,-47581
INJ_304,20211002,12000,11400,0,0,85981,-74581
INJ_304,20211004,12300,12300,0,1,122971,-110671
INJ_304,20211005,6800,6800,0,-1,59990,-53190
INJ_304,20211006,9900,8300,0,420,82978,-74678
INJ_304,20211007,11500,10300,0,1,96978,-86678
INJ_304,20211008,13400,12200,0,-2,93992,-81792
INJ_304,20211009,7400,7400,0,1,51990,-44590
INJ_304,20211011,9200,8400,0,1,71886,-63486
INJ_304,20211012,11000,11000,0,1,103981,-92981
INJ_304,20211014,6310,6310,2,103,63028,-56718
INJ_304,20211015,14200,13000,0,0,119966,-106966
INJ_304,20211016,3500,2700,0,0,26994,-24294
INJ_304,20211018,7500,7500,0,0,74989,-67489
INJ_304,20211019,8200,8200,0,1,71988,-63788
INJ_304,20211020,3300,3300,0,0,32993,-29693
INJ_304,20211021,7700,7700,0,2,64989,-57289
INJ_304,20211022,11000,9200,0,0,91987,-82787
INJ_304,20211023,9000,9000,0,1,79993,-70993
INJ_304,20211025,12000,12000,0,-1,119987,-107987
INJ_304,20211026,10000,10000,0,1,89977,-79977
INJ_304,20211027,4700,4700,0,0,46993,-42293
INJ_304,20211028,9900,9600,0,0,89987,-80387
INJ_304,20211029,13100,13100,0,3,102985,-89885
INJ_304,20211030,7300,6700,0,1,66987,-60287
INJ_304,20211101,7000,7000,0,0,69982,-62982
INJ_304,20211102,6100,5300,0,1,46993,-41693
INJ_304,20211103,13100,13100,0,3,108985,-95885
INJ_304,20211104,12500,12200,0,-1,99979,-87779
INJ_304,20211105,6800,6800,0,0,51997,-45197
INJ_304,20211106,9200,8600,0,1,79984,-71384
INJ_304,20211108,12100,10900,0,1,98981,-88081
INJ_304,20211109,10600,10600,0,-1,99985,-89385
INJ_304,20211110,4700,4700,0,1,30998,-26298
INJ_304,20211111,12200,12200,0,1,121972,-109772
INJ_304,20211112,4500,4500,0,0,44984,-40484
INJ_304,20211113,9600,9600,0,1,95988,-86388
INJ_304,20211115,5800,5300,0,0,52989,-47689
INJ_304,20211116,7700,6700,0,-1,66984,-60284
INJ_304,20211117,8800,8800,0,1,75990,-67190
INJ_304,20211118,9300,9300,0,-1,86979,-77679
INJ_304,20211119,7400,7400,0,0,67984,-60584
INJ_304,20211120,11400,10300,0,2,86985,-76685
INJ_304,20211122,6300,6300,0,1,62991,-56691
INJ_304,20211123,7700,7700,0,1,64987,-57287
INJ_304,20211124,10400,10400,0,2,93982,-83582
INJ_304,20211125,9900,8300,0,0,68990,-60690
INJ_304,20211126,11900,11900,0,-2,104986,-93086
INJ_304,20211127,3000,3000,0,1,29996,-26996
INJ_304,20211129,13000,12200,0,-2,101966,-89766
INJ_304,20211130,3000,3000,0,0,29994,-26994
INJ_304,20211201,8000,8000,0,-1,79975,-71975
INJ_304,20211202,11600,11600,0,-2,107976,-96376
INJ_304,20211203,11800,10400,0,2,103987,-93587
INJ_304,20211204,11300,11300,0,1,102986,-91686
INJ_304,20211206,12500,10700,0,1,94994,-84294
INJ_304,20211207,8700,7800,0,0,49993,-42193
INJ_304,20211208,4900,4900,0,1,49000,-44100
INJ_304,20211209,4400,4400,0,0,43989,-39589
INJ_304,20211210,8600,8600,0,0,75987,-67387
INJ_304,20211211,6300,6300,0,-1,52992,-46692
INJ_304,20211213,8100,8100,0,1,64992,-56892
INJ_304,20211214,11000,11000,0,-1,89998,-78998
INJ_304,20211215,1600,1600,0,1,15997,-14397
INJ_304,20211216,9000,9000,0,2,83986,-74986
INJ_304,20211217,13300,13300,0,0,132980,-119680
INJ_304,20211218,10400,9800,0,1,75996,-66196
INJ_304,20211220,12700,12700,0,1,110977,-98277
INJ_304,20211221,14200,12800,0,1,119803,-107003
INJ_304,20211222,6800,6800,0,2,67927,-61127
INJ_304,20211223,13300,13300,0,2,132968,-119668
INJ_304,20211224,4200,4200,0,0,41989,-37789
INJ_304,20211225,10400,10400,0,1,91976,-81576
INJ_304,20211227,9700,9700,0,0,72984,-63284
INJ_304,20211228,10600,10600,0,1,92954,-82354
INJ_304,20211229,3100,3100,0,-1,30994,-27894
INJ_304,20211230,5400,5400,0,0,41995,-36595
INJ_304,20211231,14200,14200,0,1,103986,-89786
INJ_304,20220101,8600,8000,0,1,55993,-47993
INJ_304,20220103,19200,18400,0,1,145964,-127564
INJ_304,20220104,8200,7600,0,2,69974,-62374
INJ_304,20220105,8200,7000,0,-2,63902,-56902
INJ_304,20220106,4500,4500,0,-1,34959,-30459
INJ_304,20220107,18000,15600,0,-2,95851,-80251
INJ_304,20220108,6800,6800,0,1,61906,-55106
INJ_304,20220110,15100,12500,0,-1,94841,-82341
INJ_304,20220112,6200,6200,0,1,61889,-55689
INJ_304,20220113,7400,7400,0,0,61900,-54500
INJ_304,20220114,11300,11300,0,0,104837,-93537
INJ_304,20220115,7500,6900,0,0,68890,-61990
INJ_304,20220117,5000,4200,0,0,29957,-25757
INJ_304,20220118,9700,8700,0,0,86887,-78187
INJ_304,20220119,12000,12000,0,1,87889,-75889
INJ_304,20220120,11100,11100,0,0,100857,-89757
INJ_304,20220121,7900,7900,0,0,68898,-60998
INJ_304,20220124,9100,9100,0,1,80869,-71769
INJ_304,20220127,5300,5300,0,0,52930,-47630
INJ_304,20220128,4100,3300,0,0,32957,-29657
INJ_304,20220129,7100,6100,0,1,50938,-44838
INJ_304,20220131,5000,4200,0,0,35949,-31749
INJ_304,20220201,5500,5500,0,0,54924,-49424
INJ_304,20220202,1700,1700,0,1,16971,-15271
INJ_304,20220203,8700,8100,0,0,66904,-58804
INJ_304,20220204,6200,6200,0,0,61910,-55710
INJ_304,20220205,7800,7800,0,3,77890,-70090
INJ_304,20220207,4000,4000,0,-1,39949,-35949
INJ_304,20220208,4200,3500,0,1,34958,-31458
INJ_304,20220209,3500,3500,0,-1,34952,-31452
INJ_304,20220210,6100,6100,0,0,60915,-54815
INJ_304,20220211,8900,6700,0,-1,58915,-52215
INJ_304,20220212,5800,5000,0,-1,27955,-22955
INJ_304,20220214,11200,11200,0,3,111828,-100628
INJ_304,20220215,8800,8800,0,-1,87867,-79067
INJ_304,20220216,14600,12300,0,0,100851,-88551
INJ_304,20220217,1900,1900,0,0,18972,-17072
INJ_304,20220218,7900,6900,0,1,68910,-62010
INJ_304,20220219,7400,7400,0,0,73889,-66489
INJ_304,20220221,1400,1400,0,0,13973,-12573
INJ_304,20220222,6100,4100,0,-1,40950,-36850
INJ_304,20220223,1100,1100,0,0,10981,-9881
INJ_304,20220224,5700,5700,0,-1,56918,-51218
INJ_304,20220225,4000,4000,0,0,39942,-35942
INJ_304,20220226,8100,8100,0,1,80881,-72781
INJ_304,20220228,5300,4700,0,0,46934,-42234
INJ_304,20220301,5800,5800,0,2,47931,-42131
INJ_304,20220302,1900,1900,0,-1,18974,-17074
INJ_304,20220303,10000,10000,0,-1,99855,-89855
INJ_304,20220304,1900,1900,0,1,18972,-17072
INJ_304,20220305,6100,6100,0,1,68890,-62790
INJ_304,20220307,6600,5800,0,-1,51922,-46122
INJ_304,20220308,7300,6700,0,1,66908,-60208
INJ_304,20220309,7700,7700,0,-1,66900,-59200
INJ_304,20220310,7500,7500,0,-1,74879,-67379
INJ_304,20220311,3500,3500,0,1,34956,-31456
INJ_304,20220312,8300,8300,0,1,82871,-74571
INJ_304,20220314,4000,4000,0,-1,39944,-35944
INJ_304,20220315,5800,5800,0,0,57910,-52110
INJ_304,20220316,5000,5000,0,-2,49934,-44934
INJ_304,20220317,3100,3100,0,-1,24955,-21855
INJ_304,20220318,7400,6800,0,2,67893,-61093
INJ_304,20220319,3100,3100,0,0,30956,-27856
INJ_304,20220321,5300,5300,0,-1,26958,-21658
INJ_304,20220322,9500,9500,0,3,94862,-85362
INJ_304,20220323,4500,4500,0,2,44933,-40433
INJ_304,20220324,8300,7500,0,0,74882,-67382
INJ_304,20220325,7000,7000,0,1,63917,-56917
INJ_304,20220326,4300,3300,0,0,32955,-29655
INJ_304,20220328,9815,9015,0,-1,80023,-71008
INJ_304,20220329,4700,4700,0,2,46916,-42216
INJ_304,20220330,11800,11800,0,3,99846,-88046
INJ_304,20220331,8100,8100,0,0,80886,-72786
INJ_304,20220401,8200,8200,0,0,75871,-67671
INJ_304,20220402,9800,9800,0,1,97862,-88062
INJ_304,20220404,7400,7400,0,1,73901,-66501
INJ_304,20220405,10600,9900,0,-1,98862,-88962
INJ_304,20220406,5100,5100,0,0,34952,-29852
INJ_304,20220407,4800,4800,0,0,41932,-37132
INJ_304,20220408,15800,12600,0,0,125822,-113222
INJ_304,20220409,4100,4100,0,0,40935,-36835
INJ_304,20220411,5800,5800,0,1,57916,-52116
INJ_304,20220412,6600,6600,0,0,49928,-43328
INJ_304,20220413,8100,8100,0,0,66901,-58801
INJ_304,20220414,1400,1400,0,0,13982,-12582
INJ_304,20220415,6200,6200,0,-1,61883,-55683
INJ_304,20220416,4600,4600,0,2,45930,-41330
INJ_304,20220418,10500,10500,0,0,96837,-86337
INJ_304,20220419,11110,8710,0,-1,80967,-72257
INJ_304,20220420,4500,4500,0,1,44929,-40429
INJ_304,20220421,18100,18100,0,-1,146775,-128675
INJ_304,20220422,7400,7400,0,0,73892,-66492
INJ_304,20220424,6100,6100,0,1,54920,-48820
INJ_304,20220425,8800,8800,0,-1,81886,-73086
INJ_304,20220426,4200,4200,0,0,41931,-37731
INJ_304,20220427,5600,5600,0,2,55904,-50304
INJ_304,20220428,4800,4800,0,0,47940,-43140
INJ_304,20220429,7000,7000,0,1,69889,-62889
INJ_304,20220503,7800,7800,0,1,65905,-58105
INJ_304,20220504,4600,4600,0,0,45937,-41337
INJ_304,20220505,8700,5100,0,0,40938,-35838
INJ_304,20220506,7500,7500,0,0,74874,-67374
INJ_304,20220507,6100,6100,0,2,50915,-44815
INJ_304,20220509,10300,10300,0,2,96852,-86552
INJ_304,20220510,9100,7500,0,0,74880,-67380
INJ_304,20220511,9500,7600,0,-1,76147,-68547
INJ_304,20220512,6800,6800,0,0,67900,-61100
INJ_304,20220513,4900,4900,0,0,48931,-44031
INJ_304,20220514,5100,5100,0,-1,38940,-33840
INJ_304,20220516,10200,10200,0,1,73891,-63691
INJ_304,20220517,10000,10000,0,0,99841,-89841
INJ_304,20220518,8300,6700,0,0,66887,-60187
INJ_304,20220519,7200,7200,0,0,71797,-64597
INJ_304,20220520,5500,3900,0,0,38937,-35037
INJ_304,20220521,6600,5800,0,-1,57902,-52102
INJ_304,20220523,9600,7400,0,3,67858,-60458
INJ_304,20220524,7200,6200,0,1,52928,-46728
INJ_304,20220525,4300,3500,0,0,34943,-31443
INJ_304,20220526,13150,13150,0,4,114824,-101674
INJ_304,20220527,9050,9050,0,-1,85882,-76832
INJ_304,20220528,4000,4000,0,1,30948,-26948
INJ_304,20220530,7800,7800,0,2,77888,-70088
INJ_304,20220531,3100,3100,0,0,30959,-27859
INJ_304,20220601,5700,5400,0,1,53915,-48515
INJ_304,20220602,5000,3000,0,0,29962,-26962
INJ_304,20220603,7850,7850,0,0,73881,-66031
INJ_304,20220604,9400,9400,0,3,93852,-84452
INJ_304,20220606,6400,6400,0,1,63913,-57513
INJ_304,20220607,6100,6100,0,-2,60817,-54717
INJ_304,20220608,3500,3500,0,0,34948,-31448
INJ_304,20220609,15900,15100,0,1,150756,-135656
INJ_304,20220610,12750,11350,0,-2,105827,-94477
INJ_304,20220611,9400,9400,0,-1,93858,-84458
INJ_304,20220613,13400,13400,0,0,124810,-111410
INJ_304,20220614,9550,8750,0,0,82865,-74115
INJ_304,20220615,11650,10850,0,2,100834,-89984
INJ_304,20220616,12300,11100,0,-1,102851,-91751
INJ_304,20220617,5100,4500,0,-1,44939,-40439
INJ_304,20220618,9850,9350,0,0,79874,-70524
INJ_304,20220620,6650,6050,0,2,55891,-49841
INJ_304,20220621,8400,8400,0,2,83875,-75475
INJ_304,20220622,6400,6400,0,2,63903,-57503
INJ_304,20220623,11100,11100,0,0,110828,-99728
INJ_304,20220624,9700,9700,0,1,96847,-87147
INJ_304,20220625,6600,6000,0,1,59907,-53907
INJ_304,20220627,17300,15900,0,0,158684,-142784
INJ_304,20220628,13600,13600,0,2,117698,-104098
INJ_304,20220629,11900,11300,0,0,112843,-101543
INJ_304,20220630,9850,9850,0,-1,93849,-83999
INJ_304,20220701,12150,11550,0,-2,110832,-99282
INJ_304,20220702,10550,9750,0,2,92841,-83091
INJ_304,20220704,6300,6300,0,0,62898,-56598
INJ_304,20220705,11600,11600,0,1,106815,-95215
INJ_304,20220706,6350,6350,0,-1,58910,-52560
INJ_304,20220707,13100,10600,0,1,90867,-80267
INJ_304,20220708,10150,10150,0,0,81886,-71736
INJ_304,20220709,9300,8500,0,0,84868,-76368
INJ_304,20220711,1400,1400,0,0,13981,-12581
INJ_304,20220712,4400,4400,0,1,43936,-39536
INJ_304,20220713,4900,4900,0,1,48927,-44027
INJ_304,20220714,3750,3750,0,0,32941,-29191
INJ_304,20220715,7950,7950,0,-1,65889,-57939
INJ_304,20220716,4450,4450,0,1,39936,-35486
INJ_304,20220718,5100,4500,0,0,44924,-40424
INJ_304,20220719,15250,13150,0,1,119764,-106614
INJ_304,20220720,8000,8000,0,1,70906,-62906
INJ_304,20220721,1700,1700,0,-1,16976,-15276
INJ_304,20220722,11950,11950,0,-1,114820,-102870
INJ_304,20220723,5750,5750,0,1,43927,-38177
INJ_304,20220725,11250,9750,0,0,77887,-68137
INJ_304,20220726,6500,6500,0,0,64905,-58405
INJ_304,20220727,6700,6700,0,1,54917,-48217
INJ_304,20220728,14550,14550,0,2,140748,-126198
INJ_304,20220729,5350,5350,0,0,48926,-43576
INJ_304,20220730,6950,6950,0,1,64910,-57960
INJ_304,20220801,5000,4500,0,0,44947,-40447
INJ_304,20220802,11500,10700,0,2,91877,-81177
INJ_304,20220803,5400,5400,0,-2,53928,-48528
INJ_304,20220804,8800,8800,0,1,75887,-67087
INJ_304,20220808,800,800,0,0,0,800
INJ_304,20220812,600,600,0,0,0,600
INJ_304,20220813,1000,1000,0,0,0,1000
INJ_304,20220817,600,600,0,0,0,600
INJ_304,20220820,800,800,0,0,0,800
INJ_304,20220921,400,400,0,0,0,400
INJ_304,20220923,1900,1900,0,0,18971,-17071
INJ_304,20220924,7700,7700,0,0,76883,-69183
INJ_304,20220926,2800,2800,0,0,27965,-25165
INJ_304,20220927,6400,4800,0,0,47933,-43133
INJ_304,20220928,5600,4600,0,-1,45940,-41340
INJ_304,20220929,5300,5300,0,0,52921,-47621
INJ_304,20220930,6800,6800,0,1,67903,-61103
INJ_304,20221001,1400,1400,0,0,13983,-12583
INJ_304,20221004,11350,11350,3,349,105848,-94498
INJ_304,20221005,7700,7700,0,0,76882,-69182
INJ_304,20221006,6200,6200,0,0,61905,-55705
INJ_304,20221007,6550,6250,1,109,60902,-54652
INJ_304,20221008,11100,10800,0,0,107845,-97045
INJ_304,20221010,4100,4100,0,-1,40939,-36839
INJ_304,20221011,2200,2200,0,0,21972,-19772
INJ_304,20221012,6400,6100,0,1,51929,-45829
INJ_304,20221013,6950,6950,0,1,61909,-54959
INJ_304,20221014,4200,4200,0,0,41942,-37742
INJ_304,20221015,6950,6950,0,0,64893,-57943
INJ_304,20221017,5900,5900,0,-1,58904,-53004
INJ_304,20221018,8650,8650,0,0,81871,-73221
INJ_304,20221019,9500,9500,0,1,94846,-85346
INJ_304,20221020,1600,1600,0,-1,15974,-14374
INJ_304,20221021,4400,4400,0,2,43933,-39533
INJ_304,20221022,6600,6000,0,1,59895,-53895
INJ_304,20221024,3450,3450,0,-1,29942,-26492
INJ_304,20221025,3200,3200,0,0,31955,-28755
INJ_304,20221026,7100,7100,0,0,70888,-63788
INJ_304,20221027,6700,6400,0,0,63912,-57512
INJ_304,20221028,5100,4500,0,1,44936,-40436
INJ_304,20221029,6200,6200,0,-1,61922,-55722
INJ_304,20221031,10900,10900,0,-2,108821,-97921
INJ_304,20221101,7850,7850,0,1,70873,-63023
INJ_304,20221102,6400,6400,0,-1,63908,-57508
INJ_304,20221103,12700,12700,0,0,120815,-108115
INJ_304,20221104,10400,10400,0,-4,97843,-87443
INJ_304,20221105,8300,8300,0,1,82873,-74573
INJ_304,20221107,4600,4600,0,-1,45931,-41331
INJ_304,20221108,3400,3400,0,1,33946,-30546
INJ_304,20221109,6500,6500,0,3,64897,-58397
INJ_304,20221110,4300,3500,0,-1,34941,-31441
INJ_304,20221111,2500,1900,0,0,18972,-17072
INJ_304,20221112,9400,9400,0,0,93849,-84449
INJ_304,20221114,6000,6000,0,-1,59907,-53907
INJ_304,20221115,11710,11710,0,1,107410,-95700
INJ_304,20221116,5100,4800,0,0,47922,-43122
INJ_304,20221117,6800,6800,0,3,67898,-61098
INJ_304,20221118,10100,8700,0,0,86858,-78158
INJ_304,20221119,5900,5900,0,2,58917,-53017
INJ_304,20221121,8300,8300,0,-1,73890,-65590
INJ_304,20221122,1900,3300,1,421,32704,-29404
INJ_304,20221123,4900,4900,0,2,48921,-44021
INJ_304,20221124,7200,6600,0,-1,57901,-51301
INJ_304,20221125,3500,3500,0,0,34955,-31455
INJ_304,20221126,3100,3100,0,-1,30951,-27851
INJ_304,20221128,7250,7250,0,0,67899,-60649
INJ_304,20221129,6100,6100,0,0,60910,-54810
INJ_304,20221130,9850,9850,0,1,93862,-84012
INJ_304,20221201,5400,5400,0,1,53926,-48526
INJ_304,20221202,4400,4400,0,-1,43795,-39395
INJ_304,20221203,5700,5700,0,-1,56923,-51223
INJ_304,20221205,5100,5100,0,-1,41925,-36825
INJ_304,20221206,8550,8550,0,1,80883,-72333
INJ_304,20221207,8050,8050,0,1,75880,-67830
INJ_304,20221208,4500,4500,0,0,44930,-40430
INJ_304,20221209,3750,3750,0,-2,32954,-29204
INJ_304,20221210,4700,4700,0,2,46933,-42233
INJ_304,20221212,9150,8350,0,-1,72906,-64556
INJ_304,20221213,4800,4800,0,1,47923,-43123
INJ_304,20221214,1400,1400,0,-1,13975,-12575
INJ_304,20221215,5100,5100,0,2,50930,-45830
INJ_304,20221216,4600,4600,0,0,45935,-41335
INJ_304,20221217,3900,3900,0,0,38934,-35034
INJ_304,20221219,8200,5000,0,1,49921,-44921
INJ_304,20221220,2800,2800,0,1,27960,-25160
INJ_304,20221221,6400,6400,0,-1,63906,-57506
INJ_304,20221222,6900,6900,0,0,68892,-61992
INJ_304,20221223,6050,4850,0,0,43929,-39079
INJ_304,20221224,8350,8350,0,1,75892,-67542
INJ_304,20221226,3200,3200,0,0,31957,-28757
INJ_304,20221227,10200,10200,0,-3,95873,-85673
INJ_304,20221228,7800,7500,0,-2,74868,-67368
INJ_304,20221229,6300,6300,0,2,62907,-56607
INJ_304,20221230,7350,7350,0,-1,68889,-61539
INJ_304,20221231,4600,4600,0,0,45945,-41345
INJ_304,20230102,4600,4600,0,0,39937,-35337
INJ_304,20230104,1900,1900,0,1,18999,-17099
INJ_304,20230105,10650,9350,0,1,86001,-76651
INJ_304,20230106,7900,7100,0,-1,71006,-63906
INJ_304,20230107,3200,3200,0,1,32005,-28805
INJ_304,20230109,5800,5200,0,-2,52003,-46803
INJ_304,20230110,5800,5800,0,0,58002,-52202
INJ_304,20230111,1700,1700,0,0,17001,-15301
INJ_304,20230112,3800,3200,0,1,32000,-28800
INJ_304,20230113,7650,7650,0,4,69000,-61350
INJ_304,20230114,8400,8400,0,-1,83996,-75596
INJ_304,20230116,1700,1700,0,6,17001,-15301
INJ_304,20230117,7500,7500,0,-1,66001,-58501
INJ_304,20230118,6800,6800,0,2,62001,-55201
INJ_304,20230119,5100,5100,0,0,51000,-45900
INJ_304,20230120,5200,4700,0,6,46998,-42298
INJ_304,20230121,3300,3300,0,-1,32999,-29699
INJ_304,20230123,4300,4300,0,1,43001,-38701
INJ_304,20230124,7450,7450,0,1,61000,-53550
INJ_304,20230125,6800,5400,0,-1,45005,-39605
INJ_304,20230126,2800,2800,0,0,28005,-25205
INJ_304,20230127,4150,4150,0,0,28004,-23854
INJ_304,20230128,3550,3550,0,0,31002,-27452
INJ_304,20230130,5800,5300,0,0,52995,-47695
INJ_304,20230131,1700,1700,0,1,16998,-15298
INJ_304,20230201,10900,10300,0,0,103003,-92703
INJ_304,20230202,3300,2800,0,0,27794,-24994
INJ_304,20230203,10400,10400,0,0,103987,-93587
INJ_304,20230204,8900,8900,0,-1,74005,-65105
INJ_304,20230206,5900,5900,0,1,47000,-41100
INJ_304,20230207,1600,1600,0,0,16000,-14400
INJ_304,20230208,6300,6300,0,1,57999,-51699
INJ_304,20230209,8600,8600,0,0,76706,-68106
INJ_304,20230210,3550,3550,0,-1,31000,-27450
INJ_304,20230211,9250,8650,0,2,73002,-64352
INJ_304,20230213,3300,3300,0,1,33000,-29700
INJ_304,20230214,13650,3550,0,2,27998,-24448
INJ_304,20230215,1700,1700,0,0,17003,-15303
INJ_304,20230216,10900,10900,0,1,94007,-83107
INJ_304,20230217,3000,3000,0,-1,30000,-27000
INJ_304,20230218,4500,4500,0,-1,45004,-40504
INJ_304,20230220,3000,3000,0,1,30002,-27002
INJ_304,20230221,5100,5100,0,0,51003,-45903
INJ_304,20230222,1600,1600,0,0,16003,-14403
INJ_304,20230223,1600,1600,0,0,16001,-14401
INJ_304,20230224,7200,7200,0,1,71995,-64795
INJ_304,20230225,3600,3600,0,-1,35992,-32392
INJ_304,20230227,6200,3200,0,1,32001,-28801
INJ_304,20230228,3300,3300,0,1,32999,-29699
INJ_304,20230301,8000,8000,0,1,67999,-59999
INJ_304,20230302,8450,8450,0,1,77009,-68559
INJ_304,20230303,7150,6850,0,0,67005,-60155
INJ_304,20230304,7300,6800,0,0,68003,-61203
INJ_304,20230306,10200,10200,0,2,97999,-87799
INJ_304,20230307,4300,3300,0,-1,33001,-29701
INJ_304,20230308,5000,5000,0,-1,50000,-45000
INJ_304,20230309,5100,5100,0,1,51003,-45903
INJ_304,20230310,1700,1700,0,0,17002,-15302
INJ_304,20230311,6100,5300,0,2,53004,-47704
INJ_304,20230313,4250,4250,0,0,34693,-30443
INJ_304,20230314,5500,4700,0,1,46997,-42297
INJ_304,20230315,5400,4800,0,-2,47999,-43199
INJ_304,20230316,5100,5100,0,-1,51002,-45902
INJ_304,20230317,5000,5000,0,0,50001,-45001
INJ_304,20230318,8600,6850,0,-1,45995,-39145
INJ_304,20230320,5900,5900,0,1,32001,-26101
INJ_304,20230324,6950,6950,0,1,44006,-37056
INJ_304,20230325,7300,7300,0,-1,66996,-59696
INJ_304,20230327,5550,5550,0,-1,51002,-45452
INJ_304,20230328,2150,2150,0,0,17001,-14851
INJ_304,20230329,14250,14250,0,2,86997,-72747
INJ_304,20230330,3100,3100,0,1,30998,-27898
INJ_304,20230331,2500,2500,0,0,10000,-7500
INJ_304,20230401,8850,8250,0,1,50994,-42744
INJ_304,20230403,3200,3200,0,0,32000,-28800
INJ_304,20230404,13900,13900,0,-1,90998,-77098
INJ_304,20230405,32100,3200,0,1,52743,-49543
INJ_304,20230406,16500,7900,0,-1,46004,-38104
INJ_304,20230407,10300,8700,0,0,63006,-54306
INJ_304,20230408,4400,4400,0,1,43996,-39596
INJ_304,20230410,15050,13450,0,1,87997,-74547
INJ_304,20230411,8800,8800,0,2,58004,-49204
INJ_304,20230412,4400,4400,0,2,44000,-39600
INJ_304,20230413,7950,7950,0,1,51004,-43054
INJ_304,20230414,13500,13500,0,2,72007,-58507
INJ_304,20230415,11550,11550,0,1,96005,-84455
INJ_304,20230417,10450,10450,0,1,60998,-50548
INJ_304,20230418,1400,1400,0,1,14000,-12600
INJ_304,20230419,7450,6650,0,1,62002,-55352
INJ_304,20230420,5100,4500,0,0,44999,-40499
INJ_304,20230421,2150,2150,0,0,17000,-14850
INJ_304,20230424,7700,5700,0,0,32997,-27297
INJ_304,20230426,7350,7350,0,0,47998,-40648
INJ_304,20230427,4500,4500,0,3,45002,-40502
INJ_304,20230428,12850,12850,0,2,82000,-69150
INJ_304,20230429,17400,17400,0,-1,93001,-75601
INJ_304,20230501,5150,5150,0,0,43996,-38846
INJ_304,20230502,15550,12050,0,1,74004,-61954
INJ_304,20230503,8500,8500,0,0,34003,-25503
INJ_304,20230504,27500,27500,0,0,154987,-127487
INJ_304,20230505,5400,5400,0,0,32996,-27596
INJ_304,20230506,18150,18150,0,-2,98987,-80837
INJ_304,20230508,23950,23950,0,8,150996,-127046
INJ_304,20230509,15260,11510,0,1,85011,-73501
INJ_304,20230510,8450,8450,0,-2,77003,-68553
INJ_304,20230511,14700,12700,0,2,101272,-88572
INJ_304,20230512,9250,9250,0,2,70003,-60753
INJ_304,20230513,15400,15400,0,1,105994,-90594
INJ_304,20230515,11600,11600,0,0,74000,-62400
INJ_304,20230516,3100,3100,0,0,31002,-27902
INJ_304,20230517,3100,3100,0,0,31001,-27901
INJ_304,20230518,15750,15750,0,3,123005,-107255
INJ_304,20230519,15100,14500,0,3,97002,-82502
INJ_304,20230520,7100,7100,0,1,47003,-39903
INJ_304,20230522,12450,10850,0,1,79612,-68762
INJ_304,20230523,23100,21550,0,1,142002,-120452
INJ_304,20230524,22250,22250,0,4,137004,-114754
INJ_304,20230525,6850,6850,0,-1,46005,-39155
INJ_304,20230526,6200,6200,0,-1,35002,-28802
INJ_304,20230527,22200,19700,0,0,122009,-102309
INJ_304,20230529,6900,6900,0,-1,45005,-38105
INJ_304,20230530,9950,7450,0,-1,45997,-38547
INJ_304,20230531,13600,13600,0,2,93993,-80393
INJ_304,20230601,9400,8100,0,1,80986,-72886
INJ_304,20230602,8150,8150,0,827,53001,-44851
INJ_304,20230603,16400,15600,0,1,84002,-68402
INJ_304,20230605,9050,9050,0,0,62001,-52951
INJ_304,20230606,10100,9300,0,1,63006,-53706
INJ_304,20230607,14350,14350,0,2,76013,-61663
INJ_304,20230608,3100,3100,0,-2,31004,-27904
INJ_304,20230609,10900,10900,0,2,61008,-50108
INJ_304,20230610,9300,9300,0,0,62990,-53690
INJ_304,20230612,8900,8900,0,1,64999,-56099
INJ_304,20230613,15550,14250,0,1,96005,-81755
INJ_304,20230614,14100,14100,0,-2,75003,-60903
INJ_304,20230615,8250,7650,0,1,54003,-46353
INJ_304,20230616,7000,6200,0,1,61943,-55743
INJ_304,20230617,8800,8800,0,1,63997,-55197
INJ_304,20230619,15850,15050,0,0,91995,-76945
INJ_304,20230620,12700,12700,0,2,97003,-84303
INJ_304,20230621,14700,14700,0,0,95995,-81295
INJ_304,20230622,8700,8700,0,0,62996,-54296
INJ_304,20230623,15250,14050,0,-1,135996,-121946
INJ_304,20230624,6950,6950,0,2,61999,-55049
INJ_304,20230626,16100,13800,0,2,90002,-76202
INJ_304,20230627,23650,23650,0,4,147984,-124334
INJ_304,20230628,16000,14200,0,0,84991,-70791
INJ_304,20230630,15200,15200,0,2,73988,-58788
INJ_304,20230701,12000,12000,0,-1,77999,-65999
INJ_304,20230703,9850,9850,0,1,63993,-54143
INJ_304,20230704,11750,11750,0,2,79996,-68246
INJ_304,20230705,12000,12000,0,2,74997,-62997
INJ_304,20230706,15750,12050,0,3,89005,-76955
INJ_304,20230707,19050,19050,0,4,147002,-127952
INJ_304,20230708,8600,8600,0,0,61993,-53393
INJ_304,20230710,11050,11050,0,1,90987,-79937
INJ_304,20230711,16900,11350,0,1,78997,-67647
INJ_304,20230712,14900,13100,0,1,109998,-96898
INJ_304,20230713,94450,15850,0,-2,91624,-75774
INJ_304,20230714,60450,6300,0,-1,38999,-32699
INJ_304,20230715,85650,9150,0,1,64959,-55809
INJ_304,20230717,111950,19000,0,4,94015,-75015
INJ_304,20230718,85950,20100,0,2,140996,-120896
INJ_304,20230719,18950,16850,0,4,127999,-111149
INJ_305,20210927,1125,1125,0,0,2997,-1872
INJ_305,20210928,3000,3000,0,0,7997,-4997
INJ_305,20210929,4500,4500,0,0,11994,-7494
INJ_305,20210930,4125,4125,0,0,10995,-6870
INJ_305,20211001,3000,3000,0,1,7997,-4997
INJ_305,20211002,4500,4500,0,1,11993,-7493
INJ_305,20211004,3000,3000,0,0,7996,-4996
INJ_305,20211005,6375,6375,0,64,16996,-10621
INJ_305,20211006,1875,1875,0,0,4997,-3122
INJ_305,20211007,8625,8625,0,0,22979,-14354
INJ_305,20211008,6750,6750,0,0,17985,-11235
INJ_305,20211009,1500,1500,0,0,3998,-2498
INJ_305,20211011,10250,8750,0,1,21980,-13230
INJ_305,20211012,1500,1500,0,0,3999,-2499
INJ_305,20211014,2625,1125,0,1,5709,-4584
INJ_305,20211016,6000,3750,0,-1,9994,-6244
INJ_305,20211019,7500,7500,0,-1,19981,-12481
INJ_305,20211020,3000,3000,0,1,7990,-4990
INJ_305,20211021,6375,6375,0,-1,16996,-10621
INJ_305,20211022,8250,6750,0,0,17991,-11241
INJ_305,20211023,5625,5625,0,-1,14987,-9362
INJ_305,20211025,6750,5625,0,1,14983,-9358
INJ_305,20211026,9000,9000,0,0,23984,-14984
INJ_305,20211027,3000,3000,0,0,7991,-4991
INJ_305,20211028,6750,6750,0,0,17993,-11243
INJ_305,20211029,1875,1875,0,1,4996,-3121
INJ_305,20211030,3375,3375,0,0,8994,-5619
INJ_305,20211101,12000,12000,0,-1,31978,-19978
INJ_305,20211102,8250,6750,0,1,17986,-11236
INJ_305,20211103,7125,7125,0,-1,18986,-11861
INJ_305,20211104,3375,3375,0,0,8990,-5615
INJ_305,20211105,3375,3375,0,0,8994,-5619
INJ_305,20211106,6375,6375,0,-1,16985,-10610
INJ_305,20211108,7875,7875,0,1,20982,-13107
INJ_305,20211109,5250,5250,0,-1,13988,-8738
INJ_305,20211110,1500,1500,0,0,3997,-2497
INJ_305,20211112,4125,4125,0,1,10995,-6870
INJ_305,20211113,4125,4125,0,0,10990,-6865
INJ_305,20211115,2250,2250,0,1,5996,-3746
INJ_305,20211116,3750,3750,0,0,9995,-6245
INJ_305,20211117,3750,3750,0,0,9992,-6242
INJ_305,20211119,4500,4500,0,-1,11989,-7489
INJ_305,20211120,1875,1875,0,0,4998,-3123
INJ_305,20211122,4875,4875,0,0,12990,-8115
INJ_305,20211123,3375,3375,0,0,8992,-5617
INJ_305,20211124,5250,5250,0,-1,13990,-8740
INJ_305,20211125,2250,2250,0,0,5995,-3745
INJ_305,20211126,2250,2250,0,-1,5993,-3743
INJ_305,20211127,1125,1125,0,0,2996,-1871
INJ_305,20211129,4500,4500,0,0,11992,-7492
INJ_305,20211130,1125,1125,0,0,2995,-1870
INJ_305,20211201,3375,3375,0,1,8993,-5618
INJ_305,20211202,1125,1125,0,0,2995,-1870
INJ_305,20211203,1125,1125,0,-1,2996,-1871
INJ_305,20211204,5250,5250,0,0,13980,-8730
INJ_305,20211206,7500,7500,0,0,19977,-12477
INJ_305,20211207,4500,4500,0,0,11989,-7489
INJ_305,20211208,2250,2250,0,0,5995,-3745
INJ_305,20211209,1875,1875,0,-1,4998,-3123
INJ_305,20211210,4875,4875,0,0,12991,-8116
INJ_305,20211211,3375,3375,0,1,8994,-5619
INJ_305,20211213,1875,1875,0,0,4998,-3123
INJ_305,20211214,4125,4125,0,-1,10990,-6865
INJ_305,20211216,2625,2625,0,0,6993,-4368
INJ_305,20211217,7500,7500,0,0,19986,-12486
INJ_305,20211218,9000,7125,0,0,18989,-11864
INJ_305,20211220,7125,7125,0,1,18983,-11858
INJ_305,20211221,1125,1125,0,0,2995,-1870
INJ_305,20211222,1125,1125,0,1,2996,-1871
INJ_305,20211223,3375,3375,0,0,8994,-5619
INJ_305,20211224,4875,4875,0,0,12983,-8108
INJ_305,20211225,4500,4500,0,0,11993,-7493
INJ_305,20211227,1125,1125,0,0,2995,-1870
INJ_305,20211228,1500,1500,0,0,3998,-2498
INJ_305,20211229,1125,1125,0,0,2995,-1870
INJ_305,20211230,4500,4500,0,1,11988,-7488
INJ_305,20211231,2625,2625,0,-1,6993,-4368
INJ_305,20220101,3375,3375,0,0,8992,-5617
INJ_305,20220103,8625,8625,0,0,22977,-14352
INJ_305,20220104,1875,1875,0,0,4996,-3121
INJ_305,20220105,2625,2625,0,0,6995,-4370
INJ_305,20220106,3375,3375,0,0,8995,-5620
INJ_305,20220107,1125,1125,0,1,2997,-1872
INJ_305,20220108,1500,1500,0,0,3996,-2496
INJ_305,20220110,1500,1500,0,-1,3996,-2496
INJ_305,20220112,1500,1500,0,0,3997,-2497
INJ_305,20220113,1500,1500,0,0,3998,-2498
INJ_305,20220114,1125,1125,0,-1,2997,-1872
INJ_305,20220115,2625,2625,0,0,6997,-4372
INJ_305,20220117,3375,3375,0,0,8995,-5620
INJ_305,20220118,5250,3375,0,0,8994,-5619
INJ_305,20220119,3000,3000,0,0,7994,-4994
INJ_305,20220120,7125,4875,0,0,12992,-8117
INJ_305,20220121,1875,1875,0,0,4998,-3123
INJ_305,20220124,5625,5625,0,1,14990,-9365
INJ_305,20220127,3000,3000,0,0,7994,-4994
INJ_305,20220129,1875,1875,0,0,4996,-3121
INJ_305,20220131,11625,10500,0,-1,27976,-17476
INJ_305,20220201,1125,1125,0,0,2997,-1872
INJ_305,20220203,5250,3750,0,0,9991,-6241
INJ_305,20220204,5250,5250,0,0,13988,-8738
INJ_305,20220205,1500,1500,0,0,3995,-2495
INJ_305,20220208,2625,2625,0,0,6995,-4370
INJ_305,20220209,1500,1500,0,0,3996,-2496
INJ_305,20220210,1875,1875,0,0,4996,-3121
INJ_305,20220211,1125,1125,0,0,2998,-1873
INJ_305,20220212,1125,1125,0,0,2996,-1871
INJ_305,20220303,3375,1125,0,0,2997,-1872
INJ_305,20220331,1500,1500,0,0,3998,-2498
INJ_305,20220401,4125,4125,0,0,10993,-6868
INJ_305,20220402,5625,5625,0,0,14991,-9366
INJ_305,20220405,1875,1875,0,0,4998,-3123
INJ_305,20220406,3375,3375,0,-1,8994,-5619
INJ_305,20220407,3000,3000,0,0,7995,-4995
INJ_305,20220408,9750,6750,0,0,17990,-11240
INJ_305,20220409,1125,1125,0,1,2996,-1871
INJ_305,20220411,3000,3000,0,-1,7997,-4997
INJ_305,20220412,3375,3375,0,0,8997,-5622
INJ_305,20220413,4125,4125,0,1,10993,-6868
INJ_305,20220415,3000,3000,0,0,7998,-4998
INJ_305,20220416,3375,3375,0,0,8998,-5623
INJ_305,20220418,10500,10500,0,-2,27990,-17490
INJ_305,20220419,4500,4500,0,1,11992,-7492
INJ_305,20220420,6375,6375,0,1,16995,-10620
INJ_305,20220421,7500,7500,0,0,19988,-12488
INJ_305,20220422,4875,4875,0,1,12993,-8118
INJ_305,20220424,6375,6375,0,1,16992,-10617
INJ_305,20220425,1500,1500,0,1,3998,-2498
INJ_305,20220426,1125,1125,0,-1,2998,-1873
INJ_305,20220427,6750,6750,0,0,17993,-11243
INJ_305,20220428,3375,3375,0,0,8994,-5619
INJ_305,20220429,1125,1125,0,0,2998,-1873
INJ_305,20220503,7125,7125,0,1,18991,-11866
INJ_305,20220504,3750,3750,0,-1,9995,-6245
INJ_305,20220505,3750,3750,0,0,9996,-6246
INJ_305,20220506,6375,6375,0,-1,16993,-10618
INJ_305,20220507,2250,2250,0,0,5996,-3746
INJ_305,20220509,3375,3375,0,0,8995,-5620
INJ_305,20220510,10125,5625,0,0,14992,-9367
INJ_305,20220511,2625,2625,0,0,6996,-4371
INJ_305,20220512,7500,7500,0,1,19991,-12491
INJ_305,20220513,3000,3000,0,0,7998,-4998
INJ_305,20220514,5250,5250,0,0,13997,-8747
INJ_305,20220516,2250,2250,0,1,5996,-3746
INJ_305,20220517,4125,4125,0,0,10994,-6869
INJ_305,20220518,12000,8250,0,0,21991,-13741
INJ_305,20220520,2600,2600,0,0,3998,-1398
INJ_305,20220521,2100,2100,0,-1,6998,-4898
INJ_305,20220523,2100,2100,0,1,6997,-4897
INJ_305,20220524,3900,3900,0,1,12996,-9096
INJ_305,20220526,5400,5400,0,0,17986,-12586
INJ_305,20220527,1500,1500,0,0,4998,-3498
INJ_305,20220528,1200,1200,0,0,3999,-2799
INJ_305,20220530,3300,3300,0,0,10996,-7696
INJ_305,20220531,2700,2700,0,0,8995,-6295
INJ_305,20220601,6900,5700,0,-1,18989,-13289
INJ_305,20220602,900,900,0,0,2998,-2098
INJ_305,20220604,6000,6000,0,0,19989,-13989
INJ_305,20220606,2700,2700,0,-1,8994,-6294
INJ_305,20220607,1200,1200,0,0,3998,-2798
INJ_305,20220608,900,900,0,0,2999,-2099
INJ_305,20220609,8100,8100,0,1,26987,-18887
INJ_305,20220610,4500,4500,0,1,14992,-10492
INJ_305,20220611,3900,3900,0,1,12993,-9093
INJ_305,20220613,3600,3600,0,0,11993,-8393
INJ_305,20220614,4200,4200,0,0,13990,-9790
INJ_305,20220615,2400,2400,0,0,7998,-5598
INJ_305,20220616,1200,1200,0,0,3998,-2798
INJ_305,20220617,9300,7200,0,1,23984,-16784
INJ_305,20220618,3600,3600,0,0,11994,-8394
INJ_305,20220620,4200,4200,0,0,13993,-9793
INJ_305,20220621,11100,11100,0,1,36974,-25874
INJ_305,20220622,1500,1500,0,0,4997,-3497
INJ_305,20220623,900,900,0,1,2998,-2098
INJ_305,20220624,3600,3600,0,-1,11996,-8396
INJ_305,20220625,4200,4200,0,1,13993,-9793
INJ_305,20220627,6000,5100,0,0,16987,-11887
INJ_305,20220628,7200,7200,0,0,23993,-16793
INJ_305,20220629,6000,6000,0,0,19991,-13991
INJ_305,20220630,7200,7200,0,1,23984,-16784
INJ_305,20220701,1200,1200,0,0,3998,-2798
INJ_305,20220702,7200,7200,0,0,23990,-16790
INJ_305,20220704,2400,2400,0,1,7994,-5594
INJ_305,20220705,8100,8100,0,0,26984,-18884
INJ_305,20220706,7200,7200,0,0,23987,-16787
INJ_305,20220707,6000,6000,0,0,19986,-13986
INJ_305,20220708,8100,8100,0,1,26985,-18885
INJ_305,20220709,14700,10800,0,0,35977,-25177
INJ_305,20220711,1500,1500,0,0,4997,-3497
INJ_305,20220712,3300,3300,0,0,10996,-7696
INJ_305,20220713,2100,2100,0,0,6996,-4896
INJ_305,20220715,6900,6900,0,0,22992,-16092
INJ_305,20220716,3000,3000,0,0,9996,-6996
INJ_305,20220718,3900,2700,0,1,8997,-6297
INJ_305,20220719,8100,5700,0,0,18989,-13289
INJ_305,20220720,9150,8250,0,0,23991,-15741
INJ_305,20220722,8400,8400,0,0,27987,-19587
INJ_305,20220723,2700,2700,0,0,8996,-6296
INJ_305,20220725,4500,4500,0,1,14994,-10494
INJ_305,20220726,6000,6000,0,0,19991,-13991
INJ_305,20220727,1200,1200,0,0,3998,-2798
INJ_305,20220728,5100,5100,0,1,16994,-11894
INJ_305,20220729,1200,1200,0,-1,3998,-2798
INJ_305,20220730,2400,2400,0,0,7996,-5596
INJ_305,20220801,3300,3300,0,1,10994,-7694
INJ_305,20220802,4500,4500,0,0,14993,-10493
INJ_305,20220803,7200,7200,0,0,23989,-16789
INJ_305,20220804,4800,4800,0,0,15992,-11192
INJ_305,20220806,3900,3900,0,-1,12995,-9095
INJ_305,20220809,1500,1500,0,0,4997,-3497
INJ_305,20220810,2700,2700,0,0,8995,-6295
INJ_305,20220811,3900,3900,0,0,12989,-9089
INJ_305,20220812,5400,5400,0,0,17992,-12592
INJ_305,20220813,3600,3600,0,0,11995,-8395
INJ_305,20220815,5100,5100,0,-1,16992,-11892
INJ_305,20220816,5100,5100,0,1,16988,-11888
INJ_305,20220817,2400,2400,0,-1,7995,-5595
INJ_305,20220818,2700,2700,0,0,8996,-6296
INJ_305,20220819,3000,3000,0,0,9994,-6994
INJ_305,20220820,4500,4500,0,0,14993,-10493
INJ_305,20220822,5700,5700,0,0,18993,-13293
INJ_305,20220823,4200,3300,0,0,10996,-7696
INJ_305,20220824,1500,1500,0,0,4998,-3498
INJ_305,20220825,2700,2700,0,1,8996,-6296
INJ_305,20220826,6000,6000,0,0,19989,-13989
INJ_305,20220827,900,900,0,0,2998,-2098
INJ_305,20220829,2100,2100,0,0,6994,-4894
INJ_305,20220830,3600,3600,0,-1,11993,-8393
INJ_305,20220831,1800,1800,0,0,5997,-4197
INJ_305,20220901,2700,2700,0,-1,8992,-6292
INJ_305,20220902,6900,6900,0,0,22993,-16093
INJ_305,20220903,1200,1200,0,0,3998,-2798
INJ_305,20220905,6600,6000,0,-1,19983,-13983
INJ_305,20220908,1500,1500,0,0,4998,-3498
INJ_305,20220909,900,900,0,0,2997,-2097
INJ_305,20220910,3900,3900,0,1,12994,-9094
INJ_305,20220912,3600,3600,0,1,11996,-8396
INJ_305,20220913,1200,1200,0,0,3998,-2798
INJ_305,20220914,2700,2700,0,0,8996,-6296
INJ_305,20220916,3150,3150,0,0,6996,-3846
INJ_305,20220917,9600,1200,0,0,3998,-2798
INJ_305,20220919,9600,1200,0,-1,3998,-2798
INJ_305,20220920,43800,5100,0,2,16990,-11890
INJ_305,20220921,6300,900,0,0,2997,-2097
INJ_305,20220922,51000,4500,0,0,14994,-10494
INJ_305,20220923,9600,1200,0,0,3998,-2798
INJ_305,20220924,5400,900,0,0,2998,-2098
INJ_305,20220926,24600,2700,0,0,8997,-6297
INJ_305,20220927,21900,2400,0,0,7997,-5597
INJ_305,20220928,21600,2400,0,0,5279,-2879
INJ_305,20220929,20400,3000,0,0,9996,-6996
INJ_305,20221001,9600,1200,0,0,3999,-2799
INJ_305,20221004,27900,4200,0,0,10228,-6028
INJ_305,20221005,9600,1200,0,0,3998,-2798
INJ_305,20221007,9600,1200,0,0,3998,-2798
INJ_305,20221010,9600,1200,0,0,3998,-2798
INJ_305,20221011,19800,2700,0,0,6884,-4184
INJ_305,20221012,19200,2400,0,0,7996,-5596
INJ_305,20221014,4500,4500,0,0,14995,-10495
INJ_305,20221015,900,900,0,0,2998,-2098
INJ_305,20221018,3600,3600,0,0,11996,-8396
INJ_305,20221019,3000,3000,0,-1,9996,-6996
INJ_305,20221021,1200,1200,0,0,3999,-2799
INJ_305,20221022,1500,1500,0,0,4998,-3498
INJ_305,20221024,1200,1200,0,0,3998,-2798
INJ_305,20221025,1500,1500,0,1,4998,-3498
INJ_305,20221026,1500,1500,0,-1,4998,-3498
INJ_305,20221027,1200,1200,0,0,3998,-2798
INJ_305,20221028,3600,3600,0,0,11997,-8397
INJ_305,20221029,2700,2700,0,0,8996,-6296
INJ_305,20221031,1200,1200,0,0,3998,-2798
INJ_305,20221101,5400,5400,0,-1,17992,-12592
INJ_305,20221102,2700,2700,0,-1,8994,-6294
INJ_305,20221103,2400,2400,0,0,7996,-5596
INJ_305,20221104,8700,8700,0,0,28991,-20291
INJ_305,20221105,1200,1200,0,0,3998,-2798
INJ_305,20221107,3000,3000,0,1,9997,-6997
INJ_305,20221108,2400,2400,0,0,7996,-5596
INJ_305,20221109,2700,2700,0,-1,8996,-6296
INJ_305,20221110,7200,7200,0,0,23990,-16790
INJ_305,20221112,900,900,0,0,2999,-2099
INJ_305,20221114,3300,3300,833,200,10995,-7695
INJ_305,20221115,9600,1200,0,0,3997,-2797
INJ_305,20221116,15000,1500,0,0,4998,-3498
INJ_305,20221118,5400,900,0,0,2998,-2098
INJ_305,20221119,32400,4800,0,0,10560,-5760
INJ_305,20221121,7800,3300,0,0,3589,-289
INJ_305,20221123,20400,2400,0,0,7995,-5595
INJ_305,20221124,15000,1500,0,0,4997,-3497
INJ_305,20221125,10800,1200,0,0,3997,-2797
INJ_305,20221126,1200,1200,0,0,574,626
INJ_305,20221128,1500,1500,0,0,577,923
INJ_305,20221130,20400,2400,0,0,7996,-5596
INJ_305,20221201,34200,3900,0,0,12993,-9093
INJ_305,20221202,21300,2400,0,0,7995,-5595
INJ_305,20221203,33900,3900,0,0,12992,-9092
INJ_305,20221205,24600,2700,0,0,8997,-6297
INJ_305,20221206,10800,2400,0,0,4572,-2172
INJ_305,20221207,9600,1200,0,0,3998,-2798
INJ_305,20221212,35400,4500,0,0,14994,-10494
INJ_305,20221213,9600,1200,0,0,3998,-2798
INJ_305,20221215,42000,4200,0,0,13995,-9795
INJ_305,20221217,15000,1500,0,0,4998,-3498
INJ_305,20221220,19200,2400,0,0,7996,-5596
INJ_305,20221222,28200,4500,0,0,10251,-5751
INJ_305,20221223,15000,1500,0,0,4999,-3499
INJ_305,20221224,39600,4200,0,0,13996,-9796
INJ_305,20221227,4200,4200,0,1,13991,-9791
INJ_305,20221228,4200,4200,0,1,13994,-9794
INJ_305,20221229,3000,3000,0,0,9996,-6996
INJ_305,20221230,4200,4200,0,0,13995,-9795
INJ_305,20221231,1200,1200,0,0,3998,-2798
INJ_305,20230102,3600,3600,0,1,11995,-8395
INJ_305,20230104,5400,5400,0,0,17993,-12593
INJ_305,20230105,2400,2400,0,0,7996,-5596
INJ_305,20230106,5100,5100,0,-1,16994,-11894
INJ_305,20230107,900,900,0,0,2998,-2098
INJ_305,20230109,900,900,0,0,2998,-2098
INJ_305,20230110,3600,3600,0,0,11997,-8397
INJ_305,20230112,1500,1500,0,0,4998,-3498
INJ_305,20230113,2400,2400,0,0,7995,-5595
INJ_305,20230114,5400,5400,0,-1,17993,-12593
INJ_305,20230117,1500,1500,0,0,4996,-3496
INJ_305,20230118,1500,1500,0,0,4998,-3498
INJ_305,20230119,1200,1200,0,0,3998,-2798
INJ_305,20230120,1200,1200,0,0,3998,-2798
INJ_305,20230121,1500,1500,0,0,4997,-3497
INJ_305,20230123,5400,5400,0,1,17992,-12592
INJ_305,20230124,1500,1500,0,0,4998,-3498
INJ_305,20230125,900,900,0,0,2998,-2098
INJ_305,20230202,1200,1200,0,0,3999,-2799
INJ_305,20230203,6900,6900,0,0,22989,-16089
INJ_305,20230204,5700,5700,0,1,18993,-13293
INJ_305,20230206,2100,2100,0,0,6994,-4894
INJ_305,20230207,1200,1200,0,0,3998,-2798
INJ_305,20230208,2100,2100,0,0,6995,-4895
INJ_305,20230209,6000,6000,0,0,19991,-13991
INJ_305,20230210,1500,1500,0,0,4997,-3497
INJ_305,20230211,9900,7500,0,0,24991,-17491
INJ_305,20230216,3000,3000,0,0,9995,-6995
INJ_305,20230217,2700,2700,0,-1,8995,-6295
INJ_305,20230218,1500,1500,0,1,4998,-3498
INJ_305,20230220,1800,1800,0,0,5998,-4198
INJ_305,20230315,3090,2190,0,0,6986,-4796
INJ_305,20230318,930,930,0,0,3029,-2099
INJ_305,20230325,1500,1500,0,0,4997,-3497
INJ_305,20230327,1500,1500,0,-1,4997,-3497
INJ_305,20230328,1200,1200,0,0,3998,-2798
INJ_305,20230330,900,900,0,0,2999,-2099
INJ_305,20230401,900,900,0,448,2902,-2002
INJ_305,20230403,1500,1500,0,-1,4998,-3498
INJ_305,20230404,900,900,1,650,2997,-2097
INJ_305,20230405,15000,1500,0,0,4998,-3498
INJ_305,20230406,2700,2700,0,1,8996,-6296
INJ_305,20230407,1200,1200,0,0,3997,-2797
INJ_305,20230408,2100,2100,0,0,6997,-4897
INJ_305,20230410,6900,4200,1,346,13993,-9793
INJ_305,20230411,2100,2100,0,452,6996,-4896
INJ_305,20230412,3900,3900,0,0,12992,-9092
INJ_305,20230415,4500,4500,0,447,14993,-10493
INJ_305,20230417,1800,1800,1,198,5997,-4197
INJ_305,20230419,1500,1500,0,0,4998,-3498
INJ_305,20230427,1800,1800,0,0,5998,-4198
INJ_305,20230428,1800,1800,3,302,5998,-4198
INJ_305,20230429,3600,3600,1,650,11993,-8393
INJ_305,20230501,2400,2400,0,0,7999,-5599
INJ_305,20230502,2700,2700,1,56,8996,-6296
INJ_305,20230504,4800,4800,3,748,15993,-11193
INJ_305,20230506,1800,1800,0,895,5995,-4195
INJ_305,20230508,1200,1200,2,701,3999,-2799
INJ_305,20230509,4800,2400,0,403,7997,-5597
INJ_305,20230510,4500,4500,0,0,14991,-10491
INJ_305,20230511,5400,5400,0,749,17994,-12594
INJ_305,20230512,3300,3300,1,48,10990,-7690
INJ_305,20230513,7800,7800,1,50,25987,-18187
INJ_305,20230515,3600,3600,0,0,11995,-8395
INJ_305,20230517,2400,2400,0,0,7998,-5598
INJ_305,20230518,5100,5100,0,449,16991,-11891
INJ_305,20230519,2400,2400,1,347,7994,-5594
INJ_305,20230522,2100,2100,0,601,6996,-4896
INJ_305,20230523,7800,6000,0,749,19990,-13990
INJ_305,20230524,2700,2700,2,847,8996,-6296
INJ_305,20230527,3300,3300,2,555,10991,-7691
INJ_305,20230529,1200,1200,0,600,3998,-2798
INJ_305,20230530,2400,2400,0,-1,7996,-5596
INJ_305,20230531,4200,4200,1,50,13993,-9793
INJ_305,20230601,2700,2700,0,0,8994,-6294
INJ_305,20230602,3600,3600,0,597,11993,-8393
INJ_305,20230603,5100,5100,1,651,16994,-11894
INJ_305,20230605,2400,2400,0,748,7996,-5596
INJ_305,20230606,3600,1800,0,1,5998,-4198
INJ_305,20230607,1800,1800,2,102,5998,-4198
INJ_305,20230608,1200,1200,0,0,3999,-2799
INJ_305,20230609,1800,1800,1,497,5998,-4198
INJ_305,20230610,3000,3000,0,751,9997,-6997
INJ_305,20230612,1200,1200,0,1,3997,-2797
INJ_305,20230613,3000,3000,1,347,9996,-6996
INJ_305,20230614,1200,1200,1,799,3998,-2798
INJ_305,20230615,6000,6000,0,598,19993,-13993
INJ_305,20230616,3000,3000,0,-1,9996,-6996
INJ_305,20230617,3600,3600,0,598,11996,-8396
INJ_305,20230619,6000,6000,1,48,19991,-13991
INJ_305,20230620,3900,3900,0,1,12994,-9094
INJ_305,20230621,3600,3600,0,899,11997,-8397
INJ_305,20230622,1200,1200,0,0,3997,-2797
INJ_305,20230623,9600,9600,0,0,31986,-22386
INJ_305,20230624,4200,4200,0,0,13994,-9794
INJ_305,20230626,4800,4800,0,598,15994,-11194
INJ_305,20230627,7200,7200,5,243,23988,-16788
INJ_305,20230628,6300,4800,1,654,15995,-11195
INJ_305,20230630,2100,2100,0,752,6995,-4895
INJ_305,20230701,12300,12300,1,807,40985,-28685
INJ_305,20230703,3300,3300,0,572,10996,-7696
INJ_305,20230704,4200,4200,0,448,13993,-9793
INJ_305,20230705,4200,4200,1,798,13993,-9793
INJ_305,20230706,11900,11000,0,453,31984,-20984
INJ_305,20230707,12900,12900,0,448,42977,-30077
INJ_305,20230708,3000,3000,0,598,9996,-6996
INJ_305,20230710,4500,4500,0,750,14990,-10490
INJ_305,20230711,9600,5700,0,450,18992,-13292
INJ_305,20230712,9000,7800,0,752,25991,-18191
INJ_305,20230713,17400,6600,1,846,21994,-15394
INJ_305,20230714,16500,4500,0,1,14996,-10496
INJ_305,20230715,20400,3600,0,722,11996,-8396
INJ_305,20230717,28800,2700,0,619,8978,-6278
INJ_305,20230718,18000,10500,0,214,34985,-24485
INJ_305,20230719,8950,8950,0,449,23989,-15039
INJ_306,20210927,1200,1200,0,420,37992,-36792
INJ_306,20210928,9100,9100,0,-421,74980,-65880
INJ_306,20210929,7200,7200,0,1,55983,-48783
INJ_306,20210930,8900,8900,0,0,78971,-70071
INJ_306,20211001,4300,4300,0,-1,34986,-30686
INJ_306,20211002,8600,8300,0,2,66981,-58681
INJ_306,20211004,12200,12200,0,2,99968,-87768
INJ_306,20211005,5500,5500,0,0,54978,-49478
INJ_306,20211006,11900,10500,0,0,72981,-62481
INJ_306,20211007,9500,9200,0,2,77973,-68773
INJ_306,20211008,8600,8600,0,-1,85984,-77384
INJ_306,20211009,4300,4300,0,-1,42987,-38687
INJ_306,20211011,10900,9700,0,-1,62983,-53283
INJ_306,20211012,5700,5700,0,1,56984,-51284
INJ_306,20211014,6800,6800,1,8,67972,-61172
INJ_306,20211015,1200,1200,0,0,11997,-10797
INJ_306,20211016,5000,4300,0,0,28994,-24694
INJ_306,20211018,7500,7500,0,0,56972,-49472
INJ_306,20211019,8700,8700,0,2,72968,-64268
INJ_306,20211020,2500,2500,0,-1,24986,-22486
INJ_306,20211021,8400,8400,0,-1,49987,-41587
INJ_306,20211022,11700,11400,0,0,87962,-76562
INJ_306,20211023,9000,9000,0,1,69983,-60983
INJ_306,20211025,11000,9600,0,1,95957,-86357
INJ_306,20211026,10600,10600,0,3,83959,-73359
INJ_306,20211027,5000,5000,0,0,43985,-38985
INJ_306,20211028,11800,11000,0,1,89980,-78980
INJ_306,20211029,11000,9800,0,-2,89966,-80166
INJ_306,20211030,6600,6600,0,-1,55987,-49387
INJ_306,20211101,12300,10500,0,-1,62986,-52486
INJ_306,20211102,4100,3400,0,0,33984,-30584
INJ_306,20211103,12700,12700,0,2,102961,-90261
INJ_306,20211104,8900,8900,0,3,88974,-80074
INJ_306,20211105,3800,3800,0,-1,37990,-34190
INJ_306,20211106,8800,7600,0,-1,67978,-60378
INJ_306,20211108,11800,10400,0,-2,77971,-67571
INJ_306,20211109,9900,9200,0,1,83966,-74766
INJ_306,20211110,4500,3100,0,0,30985,-27885
INJ_306,20211111,13100,13100,0,1,108962,-95862
INJ_306,20211112,5100,5100,0,0,42976,-37876
INJ_306,20211113,11500,11500,0,0,90979,-79479
INJ_306,20211115,4000,4000,0,0,39977,-35977
INJ_306,20211116,7100,6300,0,0,54979,-48679
INJ_306,20211117,7900,7900,0,1,78977,-71077
INJ_306,20211118,9400,9400,0,1,77960,-68560
INJ_306,20211119,6600,6600,0,1,51972,-45372
INJ_306,20211120,10500,10100,0,0,72965,-62865
INJ_306,20211122,8000,8000,0,0,55980,-47980
INJ_306,20211123,6800,6800,0,-2,57977,-51177
INJ_306,20211124,12200,12200,0,0,89967,-77767
INJ_306,20211125,7100,5700,0,0,56978,-51278
INJ_306,20211126,9700,9700,0,3,86982,-77282
INJ_306,20211127,3300,3300,0,1,32992,-29692
INJ_306,20211129,10100,9400,0,0,83970,-74570
INJ_306,20211130,5300,5300,0,1,32986,-27686
INJ_306,20211201,9000,9000,0,1,75973,-66973
INJ_306,20211202,9000,8700,0,-1,86965,-78265
INJ_306,20211203,9600,8100,0,-2,72964,-64864
INJ_306,20211204,11100,10300,0,-2,80978,-70678
INJ_306,20211206,10700,9900,0,0,82969,-73069
INJ_306,20211207,6500,4500,0,-1,36989,-32489
INJ_306,20211208,4400,4400,0,0,43981,-39581
INJ_306,20211209,5800,5800,0,1,49980,-44180
INJ_306,20211210,9000,8200,0,-1,75961,-67761
INJ_306,20211211,3700,3700,0,0,36989,-33289
INJ_306,20211213,6200,6200,0,0,61986,-55786
INJ_306,20211214,7200,7200,0,0,63981,-56781
INJ_306,20211215,1700,1700,0,1,16998,-15298
INJ_306,20211216,8800,8800,0,0,73985,-65185
INJ_306,20211217,14800,12900,0,1,110962,-98062
INJ_306,20211218,10600,10200,0,-2,69988,-59788
INJ_306,20211220,11900,11900,0,1,100977,-89077
INJ_306,20211221,13000,11800,0,1,107958,-96158
INJ_306,20211222,7400,6900,0,-2,60980,-54080
INJ_306,20211223,14000,14000,0,0,121971,-107971
INJ_306,20211224,6000,6000,0,-2,43980,-37980
INJ_306,20211225,11000,11000,0,-1,93969,-82969
INJ_306,20211227,5600,5600,0,-1,55977,-50377
INJ_306,20211228,11400,10600,0,0,100560,-89960
INJ_306,20211229,3200,3200,0,-1,31989,-28789
INJ_306,20211230,6100,6100,0,0,44975,-38875
INJ_306,20211231,8700,8700,0,3,86987,-78287
INJ_306,20220101,6000,6000,0,0,41979,-35979
INJ_306,20220103,16700,16000,0,-1,127953,-111953
INJ_306,20220104,6500,6500,0,-1,56957,-50457
INJ_306,20220105,3800,3800,0,1,27944,-24144
INJ_306,20220106,2200,2200,0,0,21954,-19754
INJ_306,20220114,6700,6700,0,-1,56891,-50191
INJ_306,20220115,2700,2300,0,0,22953,-20653
INJ_306,20220117,5200,4500,0,0,26943,-22443
INJ_306,20220118,9500,9500,0,1,68853,-59353
INJ_306,20220119,7700,7700,0,1,68867,-61167
INJ_306,20220120,10000,10000,0,-2,83816,-73816
INJ_306,20220121,6400,6400,0,0,57881,-51481
INJ_306,20220124,8900,8900,0,-1,68868,-59968
INJ_306,20220127,3800,3800,0,-1,37923,-34123
INJ_306,20220128,4000,3300,0,2,32935,-29635
INJ_306,20220129,4300,4300,0,1,42911,-38611
INJ_306,20220131,4200,3500,0,0,34939,-31439
INJ_306,20220201,4100,4100,0,0,40919,-36819
INJ_306,20220202,2600,2600,0,0,15967,-13367
INJ_306,20220203,7400,7100,0,1,54895,-47795
INJ_306,20220204,7400,7400,0,-2,55872,-48472
INJ_306,20220205,6000,5600,0,-1,49894,-44294
INJ_306,20220207,2600,2600,0,-1,25936,-23336
INJ_306,20220208,4200,4200,0,1,23945,-19745
INJ_306,20220209,2700,2700,0,0,26947,-24247
INJ_306,20220210,3300,3300,0,0,32929,-29629
INJ_306,20220211,4400,3700,0,-2,36921,-33221
INJ_306,20220212,4200,3500,0,1,34939,-31439
INJ_306,20220214,8600,8600,0,0,85816,-77216
INJ_306,20220215,5000,5000,0,0,43895,-38895
INJ_306,20220216,7000,6000,0,0,59852,-53852
INJ_306,20220217,1400,1400,0,0,13965,-12565
INJ_306,20220218,3400,3000,0,-1,29926,-26926
INJ_306,20220219,2500,2500,0,1,24939,-22439
INJ_306,20220221,1900,1900,0,0,18969,-17069
INJ_306,20220222,5700,3300,0,1,24946,-21646
INJ_306,20220223,2200,2200,0,0,21958,-19758
INJ_306,20220224,5000,5000,0,-1,41910,-36910
INJ_306,20220225,2600,2600,0,-1,25942,-23342
INJ_306,20220226,5100,5100,0,2,50881,-45781
INJ_306,20220228,2500,2500,0,-1,18953,-16453
INJ_306,20220301,5700,5700,0,0,50925,-45225
INJ_306,20220302,1400,1400,0,0,13994,-12594
INJ_306,20220303,9500,9500,0,-1,94963,-85463
INJ_306,20220304,1400,1400,0,0,13987,-12587
INJ_306,20220305,5200,5200,0,1,62947,-57747
INJ_306,20220307,6700,6100,0,1,46967,-40867
INJ_306,20220308,3200,3200,0,-1,31955,-28755
INJ_306,20220309,9700,9700,0,0,64962,-55262
INJ_306,20220310,9500,9500,0,-1,86925,-77425
INJ_306,20220311,2700,2700,0,-1,26987,-24287
INJ_306,20220312,10000,9600,0,2,81932,-72332
INJ_306,20220314,3200,3200,0,0,25966,-22766
INJ_306,20220315,7400,7400,0,1,73944,-66544
INJ_306,20220316,6300,6300,0,1,48980,-42680
INJ_306,20220317,4100,4100,0,-2,40969,-36869
INJ_306,20220318,6900,6400,0,2,63970,-57570
INJ_306,20220319,4100,4100,0,-1,30979,-26879
INJ_306,20220321,3300,3300,0,0,32977,-29677
INJ_306,20220322,10900,10900,0,3,102923,-92023
INJ_306,20220323,9200,8700,0,0,86939,-78239
INJ_306,20220324,9000,9000,0,1,89759,-80759
INJ_306,20220325,6800,6800,0,-2,67965,-61165
INJ_306,20220326,3700,3300,0,0,32976,-29676
INJ_306,20220328,9900,9500,0,2,84782,-75282
INJ_306,20220329,9500,9100,0,-1,84931,-75831
INJ_306,20220330,10800,10800,0,-1,97926,-87126
INJ_306,20220331,14300,14300,0,3,112905,-98605
INJ_306,20220401,7800,7800,0,-1,77945,-70145
INJ_306,20220402,13200,13200,0,-2,117822,-104622
INJ_306,20220404,8600,7800,0,1,77953,-70153
INJ_306,20220405,11600,10800,0,-2,93933,-83133
INJ_306,20220406,5500,4700,0,0,54969,-50269
INJ_306,20220407,4900,4900,0,0,48949,-44049
INJ_306,20220408,14500,12800,0,2,119897,-107097
INJ_306,20220409,6700,6300,0,0,54956,-48656
INJ_306,20220411,9400,9000,0,0,65949,-56949
INJ_306,20220412,5400,5400,0,0,39968,-34568
INJ_306,20220413,5400,5400,0,2,53952,-48552
INJ_306,20220414,1900,1900,0,1,18985,-17085
INJ_306,20220415,6200,6200,0,0,61948,-55748
INJ_306,20220416,6000,6000,0,1,43965,-37965
INJ_306,20220418,12800,12800,0,-1,105913,-93113
INJ_306,20220419,13800,11900,0,0,104861,-92961
INJ_306,20220420,3700,3700,0,-1,36966,-33266
INJ_306,20220421,17700,17700,0,1,162885,-145185
INJ_306,20220422,9200,9200,0,1,77933,-68733
INJ_306,20220424,6000,6000,0,1,59952,-53952
INJ_306,20220425,10300,10300,0,-3,78946,-68646
INJ_306,20220426,5400,5400,0,-1,53973,-48573
INJ_306,20220427,5800,5800,0,0,57956,-52156
INJ_306,20220428,7000,7000,0,1,41968,-34968
INJ_306,20220429,5900,5900,0,0,58954,-53054
INJ_306,20220503,10800,9600,0,2,79940,-70340
INJ_306,20220504,4300,4300,0,0,42967,-38667
INJ_306,20220505,5100,4800,0,-1,47968,-43168
INJ_306,20220506,7300,7300,0,0,72942,-65642
INJ_306,20220507,4200,4200,0,0,41971,-37771
INJ_306,20220509,12200,12200,0,1,91951,-79751
INJ_306,20220510,9100,8300,0,1,74943,-66643
INJ_306,20220511,9700,9200,0,0,75236,-66036
INJ_306,20220512,8500,8500,0,0,76935,-68435
INJ_306,20220513,5400,5400,0,-1,41963,-36563
INJ_306,20220514,4600,4600,0,-2,45963,-41363
INJ_306,20220516,9300,9300,0,0,84950,-75650
INJ_306,20220517,9300,9300,0,0,86910,-77610
INJ_306,20220518,10400,9000,0,-1,75932,-66932
INJ_306,20220519,6800,6000,0,0,59942,-53942
INJ_306,20220520,5100,3700,0,0,30972,-27272
INJ_306,20220521,8600,7900,0,2,66942,-59042
INJ_306,20220523,8250,6150,0,0,56944,-50794
INJ_306,20220524,7850,7050,0,0,65942,-58892
INJ_306,20220525,3100,3100,0,0,30975,-27875
INJ_306,20220526,10400,10400,0,1,97935,-87535
INJ_306,20220527,7400,7400,0,2,73949,-66549
INJ_306,20220528,3100,3100,0,0,30980,-27880
INJ_306,20220530,7600,7600,0,0,75942,-68342
INJ_306,20220531,2600,2600,0,2,25985,-23385
INJ_306,20220601,6600,5900,0,1,58946,-53046
INJ_306,20220602,3900,3900,0,0,32784,-28884
INJ_306,20220603,9100,9100,0,1,90929,-81829
INJ_306,20220604,13050,13050,0,-1,116916,-103866
INJ_306,20220606,7100,7100,0,-1,58953,-51853
INJ_306,20220607,7900,6700,0,-1,66962,-60262
INJ_306,20220608,2800,2800,0,0,27980,-25180
INJ_306,20220609,17300,17300,0,-1,151873,-134573
INJ_306,20220610,12500,11600,0,0,109838,-98238
INJ_306,20220611,9100,9100,0,-2,90916,-81816
INJ_306,20220613,12850,12850,0,-1,123913,-111063
INJ_306,20220614,8700,8700,0,0,80779,-72079
INJ_306,20220615,10800,10800,0,-1,101928,-91128
INJ_306,20220616,14400,13400,0,0,108921,-95521
INJ_306,20220617,4800,4300,0,-1,42972,-38672
INJ_306,20220618,8600,7300,0,-1,72932,-65632
INJ_306,20220620,8200,6950,0,-1,61948,-54998
INJ_306,20220621,9000,9000,0,-1,89913,-80913
INJ_306,20220622,6750,6750,0,1,62940,-56190
INJ_306,20220623,11500,11500,0,0,96928,-85428
INJ_306,20220624,9350,9350,0,-2,88921,-79571
INJ_306,20220625,6950,6250,0,0,57953,-51703
INJ_306,20220627,5800,5100,0,0,50968,-45868
INJ_306,20220628,8000,8000,0,1,55955,-47955
INJ_306,20220629,12600,12600,0,0,110911,-98311
INJ_306,20220630,9300,9300,0,0,92938,-83638
INJ_306,20220701,12100,11600,0,0,115934,-104334
INJ_306,20220702,9400,8700,0,-1,80920,-72220
INJ_306,20220704,6850,6850,0,0,60948,-54098
INJ_306,20220705,12900,12900,0,2,122878,-109978
INJ_306,20220706,7850,7850,0,0,61954,-54104
INJ_306,20220707,11000,10200,0,-1,86921,-76721
INJ_306,20220708,10700,10700,0,1,88908,-78208
INJ_306,20220709,9000,9000,0,0,89916,-80916
INJ_306,20220711,1400,1400,0,-1,13987,-12587
INJ_306,20220712,5150,5150,0,-1,43952,-38802
INJ_306,20220713,4300,4300,0,-1,42969,-38669
INJ_306,20220714,3300,3300,0,1,32972,-29672
INJ_306,20220715,8650,8650,0,0,75946,-67296
INJ_306,20220716,4900,4900,0,0,48960,-44060
INJ_306,20220718,5100,5100,0,2,44969,-39869
INJ_306,20220719,12700,12700,0,1,124905,-112205
INJ_306,20220720,8200,8200,0,4,69954,-61754
INJ_306,20220721,1600,1600,0,0,15992,-14392
INJ_306,20220722,13300,13300,0,1,120890,-107590
INJ_306,20220723,6400,6400,0,-1,45954,-39554
INJ_306,20220725,8150,7650,0,1,71935,-64285
INJ_306,20220726,8900,8900,0,2,79942,-71042
INJ_306,20220727,5300,5300,0,0,52963,-47663
INJ_306,20220728,16900,16900,0,3,138915,-122015
INJ_306,20220729,5350,5350,0,-2,45963,-40613
INJ_306,20220730,9600,9600,0,2,71947,-62347
INJ_306,20220801,5350,5350,0,0,42986,-37636
INJ_306,20220802,12050,11350,0,0,90914,-79564
INJ_306,20220803,7350,7350,0,-1,53953,-46603
INJ_306,20220804,7300,7300,0,1,72955,-65655
INJ_306,20220806,13400,13400,0,-2,118935,-105535
INJ_306,20220808,4900,3400,0,1,32983,-29583
INJ_306,20220809,9100,9100,0,2,60953,-51853
INJ_306,20220810,10050,10050,0,1,89937,-79887
INJ_306,20220811,11100,11100,0,2,98923,-87823
INJ_306,20220812,21300,20700,0,1,179867,-159167
INJ_306,20220813,10300,8300,0,1,86936,-78636
INJ_306,20220815,18000,17000,0,1,127903,-110903
INJ_306,20220816,6950,6950,0,2,86937,-79987
INJ_306,20220817,23300,22700,0,0,189877,-167177
INJ_306,20220818,9500,9000,0,0,89945,-80945
INJ_306,20220819,9500,9500,0,0,88813,-79313
INJ_306,20220820,9750,8950,0,0,83930,-74980
INJ_306,20220822,20700,19700,0,0,178841,-159141
INJ_306,20220823,11900,9400,0,1,87921,-78521
INJ_306,20220824,7400,6700,0,0,60958,-54258
INJ_306,20220825,20450,19950,0,1,188864,-168914
INJ_306,20220826,19932,19432,0,2,189687,-170255
INJ_306,20220827,11100,11100,0,0,95919,-84819
INJ_306,20220829,10500,9200,0,2,91950,-82750
INJ_306,20220830,13200,12450,0,-1,119916,-107466
INJ_306,20220831,7100,6600,0,2,59441,-52841
INJ_306,20220901,10850,10350,0,0,89930,-79580
INJ_306,20220902,3750,3750,0,0,32977,-29227
INJ_306,20220908,2800,2800,0,0,27983,-25183
INJ_306,20220909,3000,3000,0,0,29985,-26985
INJ_306,20220910,14900,13300,0,3,151891,-138591
INJ_306,20220912,5400,5400,0,0,53963,-48563
INJ_306,20220913,9950,9950,0,1,94937,-84987
INJ_306,20220914,11250,10650,0,1,89931,-79281
INJ_306,20220915,9900,9900,0,-1,98918,-89018
INJ_306,20220916,5900,5900,0,-1,58956,-53056
INJ_306,20220917,6650,6650,0,-2,61950,-55300
INJ_306,20220919,13250,13250,0,0,127910,-114660
INJ_306,20220920,16300,16300,0,1,147908,-131608
INJ_306,20220921,3000,2600,0,0,29982,-27382
INJ_306,20220922,13500,12900,0,0,116926,-104026
INJ_306,20220923,10900,10900,0,-2,108907,-98007
INJ_306,20220924,12400,12400,0,-2,117910,-105510
INJ_306,20220926,2900,2900,0,1,28979,-26079
INJ_306,20220927,5600,4300,0,1,42973,-38673
INJ_306,20220928,4100,4100,0,-1,40978,-36878
INJ_306,20220929,9050,8250,0,1,68951,-60701
INJ_306,20220930,6400,6400,0,1,63957,-57557
INJ_306,20221001,1950,1950,0,0,14989,-13039
INJ_306,20221004,12150,12150,5,279,110934,-98784
INJ_306,20221005,8850,8850,0,2,83947,-75097
INJ_306,20221006,6850,6850,0,2,57950,-51100
INJ_306,20221007,6700,6700,1,797,63946,-57246
INJ_306,20221008,13750,13350,0,-2,113918,-100568
INJ_306,20221010,5700,5700,0,1,50964,-45264
INJ_306,20221011,4100,4100,0,0,34975,-30875
INJ_306,20221012,4750,4350,0,1,38976,-34626
INJ_306,20221013,6650,6650,0,0,61962,-55312
INJ_306,20221014,4800,4800,0,1,41982,-37182
INJ_306,20221015,6400,6400,0,-1,63948,-57548
INJ_306,20221017,7050,7050,0,2,65937,-58887
INJ_306,20221018,10300,10300,0,0,96922,-86622
INJ_306,20221019,10050,10050,0,-3,92927,-82877
INJ_306,20221020,2300,2300,0,-1,16988,-14688
INJ_306,20221021,5100,5100,0,1,50969,-45869
INJ_306,20221022,7400,6700,0,0,66944,-60244
INJ_306,20221024,3200,3200,0,0,31975,-28775
INJ_306,20221025,2900,2900,0,0,28976,-26076
INJ_306,20221026,5600,5600,0,-1,55952,-50352
INJ_306,20221027,6800,6400,0,2,63957,-57557
INJ_306,20221028,4700,4200,0,-1,41966,-37766
INJ_306,20221029,7900,7900,0,0,60965,-53065
INJ_306,20221031,12250,12250,0,1,117933,-105683
INJ_306,20221101,7600,7600,0,0,75940,-68340
INJ_306,20221102,5900,5900,0,1,58948,-53048
INJ_306,20221103,10650,10650,0,0,101920,-91270
INJ_306,20221104,10850,10850,0,-3,103931,-93081
INJ_306,20221105,8550,8550,0,-1,77943,-69393
INJ_306,20221107,4300,4300,0,1,42971,-38671
INJ_306,20221108,2400,2400,0,0,23990,-21590
INJ_306,20221109,5800,5800,0,0,57957,-52157
INJ_306,20221110,4700,4000,0,-2,39965,-35965
INJ_306,20221111,2100,1400,0,-1,13986,-12586
INJ_306,20221112,10100,10100,0,-1,100920,-90820
INJ_306,20221114,6100,6100,0,-2,60940,-54840
INJ_306,20221115,9044,8644,0,-1,86354,-77710
INJ_306,20221116,4600,4600,0,-1,45959,-41359
INJ_306,20221117,6400,6400,0,2,63945,-57545
INJ_306,20221118,9450,8250,0,-2,74935,-66685
INJ_306,20221119,4600,4600,0,-1,45968,-41368
INJ_306,20221121,7300,7300,0,1,72949,-65649
INJ_306,20221122,1400,3300,1,943,32976,-29676
INJ_306,20221123,6400,6400,0,-1,63963,-57563
INJ_306,20221124,7600,6900,0,0,68949,-62049
INJ_306,20221125,3450,3450,0,1,26976,-23526
INJ_306,20221126,3850,3850,0,1,30978,-27128
INJ_306,20221128,6300,6300,0,1,62959,-56659
INJ_306,20221129,7150,7150,0,1,66958,-59808
INJ_306,20221130,10800,10800,0,3,95944,-85144
INJ_306,20221201,7550,7550,0,-1,64968,-57418
INJ_306,20221202,6700,5900,0,2,46967,-41067
INJ_306,20221203,7400,7400,0,1,61959,-54559
INJ_306,20221205,5400,5400,0,1,47972,-42572
INJ_306,20221206,7600,7600,0,1,75955,-68355
INJ_306,20221207,8200,8200,0,0,81955,-73755
INJ_306,20221208,5000,5000,0,-1,49972,-44972
INJ_306,20221209,3300,3300,0,1,32985,-29685
INJ_306,20221210,5200,5200,0,0,51979,-46779
INJ_306,20221212,9350,9350,0,1,76972,-67622
INJ_306,20221213,5150,5150,0,1,46962,-41812
INJ_306,20221214,1900,1900,0,0,18990,-17090
INJ_306,20221215,7050,7050,0,0,59955,-52905
INJ_306,20221216,5400,5400,0,2,47970,-42570
INJ_306,20221217,6100,6100,0,-1,54966,-48866
INJ_306,20221219,6450,5650,0,1,48965,-43315
INJ_306,20221220,3900,3900,0,0,29980,-26080
INJ_306,20221221,7600,7600,0,-2,63959,-56359
INJ_306,20221222,7100,7100,0,2,64962,-57862
INJ_306,20221223,5800,5000,0,-1,49975,-44975
INJ_306,20221224,9000,9000,0,0,74957,-65957
INJ_306,20221226,2800,2800,0,1,27988,-25188
INJ_306,20221227,8800,8800,0,0,87968,-79168
INJ_306,20221228,8850,8050,0,0,75954,-67904
INJ_306,20221229,5900,5900,0,-1,58962,-53062
INJ_306,20221230,9400,8650,0,-2,81930,-73280
INJ_306,20221231,5650,5650,0,1,48957,-43307
INJ_306,20230102,7100,7100,0,5,46973,-39873
INJ_306,20230104,3650,3650,0,-1,29002,-25352
INJ_306,20230105,9600,8300,0,1,71007,-62707
INJ_306,20230106,8150,8150,0,-1,77020,-68870
INJ_306,20230107,3700,3700,0,1,31009,-27309
INJ_306,20230109,6050,6050,0,-1,44013,-37963
INJ_306,20230110,6950,6950,0,0,62015,-55065
INJ_306,20230111,1600,1600,0,0,16006,-14406
INJ_306,20230112,3500,3500,0,2,29010,-25510
INJ_306,20230113,6100,6100,0,1,55005,-48905
INJ_306,20230114,9600,9600,0,2,95986,-86386
INJ_306,20230116,2350,2350,0,0,16000,-13650
INJ_306,20230117,6100,6100,0,0,61009,-54909
INJ_306,20230118,6500,6500,0,1,65010,-58510
INJ_306,20230119,4400,4400,0,0,43997,-39597
INJ_306,20230120,5200,4800,0,0,48000,-43200
INJ_306,20230121,3250,3250,0,-1,27997,-24747
INJ_306,20230123,5000,5000,0,1,37999,-32999
INJ_306,20230124,7950,7950,0,-1,65999,-58049
INJ_306,20230125,7200,5700,0,0,51001,-45301
INJ_306,20230126,4400,4400,0,1,38002,-33602
INJ_306,20230127,3800,3800,0,0,38004,-34204
INJ_306,20230128,3500,3500,0,1,35006,-31506
INJ_306,20230130,5200,5200,0,-1,45997,-40797
INJ_306,20230131,1600,1600,0,0,15996,-14396
INJ_306,20230201,11150,11150,0,1,94993,-83843
INJ_306,20230202,6100,4000,0,0,34000,-30000
INJ_306,20230203,11450,11450,0,0,103985,-92535
INJ_306,20230204,7200,7200,0,0,71990,-64790
INJ_306,20230206,4500,4500,0,1,45001,-40501
INJ_306,20230207,2200,2200,0,-1,13003,-10803
INJ_306,20230208,7850,7850,0,0,56001,-48151
INJ_306,20230209,6800,6800,0,0,67992,-61192
INJ_306,20230210,3000,3000,0,-1,29997,-26997
INJ_306,20230211,7600,7300,0,1,66989,-59689
INJ_306,20230213,3300,3300,0,-1,32994,-29694
INJ_306,20230214,22800,3800,0,2,37996,-34196
INJ_306,20230215,1600,1600,0,0,16001,-14401
INJ_306,20230216,10000,10000,0,2,94005,-84005
INJ_306,20230217,2700,2700,0,0,27003,-24303
INJ_306,20230218,4900,4900,0,0,48999,-44099
INJ_306,20230220,3000,3000,0,0,30002,-27002
INJ_306,20230221,4800,4800,0,-1,48006,-43206
INJ_306,20230222,1700,1700,0,0,17001,-15301
INJ_306,20230223,1700,1700,0,0,17003,-15303
INJ_306,20230224,6000,6000,0,0,59986,-53986
INJ_306,20230225,3000,3000,0,0,29998,-26998
INJ_306,20230227,4600,3400,0,0,34006,-30606
INJ_306,20230228,3300,3300,0,0,33004,-29704
INJ_306,20230301,6000,6000,0,0,59995,-53995
INJ_306,20230302,9850,9850,0,0,85005,-75155
INJ_306,20230303,8000,8000,0,1,65002,-57002
INJ_306,20230304,6400,6400,0,0,64011,-57611
INJ_306,20230306,10750,10350,0,1,100000,-89650
INJ_306,20230307,4100,3300,0,1,33004,-29704
INJ_306,20230308,5650,5650,0,1,49006,-43356
INJ_306,20230309,4800,4800,0,-2,48008,-43208
INJ_306,20230310,1600,1600,0,1,15998,-14398
INJ_306,20230311,5750,5050,0,-1,46010,-40960
INJ_306,20230313,3800,3100,0,0,30999,-27899
INJ_306,20230314,5900,5200,0,0,51995,-46795
INJ_306,20230315,4800,4400,0,-3,44000,-39600
INJ_306,20230316,6000,6000,0,0,48004,-42004
INJ_306,20230317,4900,4900,0,1,49007,-44107
INJ_306,20230318,10300,8300,0,2,49989,-41689
INJ_306,20230320,5650,5650,0,2,34001,-28351
INJ_306,20230324,7700,7700,0,-1,50007,-42307
INJ_306,20230325,6000,6000,0,0,59989,-53989
INJ_306,20230327,4300,4300,0,1,42998,-38698
INJ_306,20230328,1200,1200,0,-1,12002,-10802
INJ_306,20230329,12150,12150,0,0,77995,-65845
INJ_306,20230330,3950,3950,0,-1,31995,-28045
INJ_306,20230331,2750,2750,0,2,10999,-8249
INJ_306,20230401,6650,6150,0,-2,41994,-35844
INJ_306,20230403,4100,4100,0,0,28997,-24897
INJ_306,20230404,13350,13350,0,3,93003,-79653
INJ_306,20230405,34900,3500,0,1,40637,-37137
INJ_306,20230406,16900,6500,0,1,44007,-37507
INJ_306,20230407,10150,9650,0,0,65006,-55356
INJ_306,20230408,4800,4800,0,0,48001,-43201
INJ_306,20230410,13300,12600,0,2,86939,-74339
INJ_306,20230411,8950,8950,0,2,64000,-55050
INJ_306,20230412,5400,5400,0,1,42002,-36602
INJ_306,20230413,6350,6350,0,-1,44004,-37654
INJ_306,20230414,13600,13600,0,2,76011,-62411
INJ_306,20230415,10950,10950,0,0,83986,-73036
INJ_306,20230417,10050,10050,0,1,56992,-46942
INJ_306,20230418,1900,1900,0,0,19000,-17100
INJ_306,20230419,7200,6500,0,1,65004,-58504
INJ_306,20230420,6650,6150,0,-1,51004,-44854
INJ_306,20230421,1600,1600,0,0,15998,-14398
INJ_306,20230424,8050,5850,0,2,32999,-27149
INJ_306,20230426,6500,6500,0,-1,47001,-40501
INJ_306,20230427,5850,5850,0,1,48000,-42150
INJ_306,20230428,7450,7450,0,1,54993,-47543
INJ_306,20230429,14200,14200,0,1,82003,-67803
INJ_306,20230501,4700,4700,0,1,47003,-42303
INJ_306,20230502,16150,12650,0,0,79996,-67346
INJ_306,20230503,6500,6500,0,0,26002,-19502
INJ_306,20230504,24200,24200,0,0,133978,-109778
INJ_306,20230505,4650,4650,0,0,26998,-22348
INJ_306,20230506,15000,15000,0,0,86987,-71987
INJ_306,20230508,25000,25000,0,6,156981,-131981
INJ_306,20230509,12950,9600,0,-2,69000,-59400
INJ_306,20230510,9100,9100,0,3,73008,-63908
INJ_306,20230511,14250,12750,0,-1,106757,-94007
INJ_306,20230512,9800,9800,0,-2,77019,-67219
INJ_306,20230513,13850,13850,0,1,91987,-78137
INJ_306,20230515,10150,10150,0,-1,78992,-68842
INJ_306,20230516,3950,3950,0,-1,35001,-31051
INJ_306,20230517,3400,2700,0,1,27006,-24306
INJ_306,20230518,14650,14650,0,2,121022,-106372
INJ_306,20230519,14400,12600,0,0,84019,-71419
INJ_306,20230520,6750,6750,0,-1,47992,-41242
INJ_306,20230522,13050,10550,0,2,74004,-63454
INJ_306,20230523,21500,20800,0,0,129992,-109192
INJ_306,20230524,22650,22650,0,0,132016,-109366
INJ_306,20230525,8000,8000,0,2,53002,-45002
INJ_306,20230526,5350,5350,0,2,31000,-25650
INJ_306,20230527,19850,17850,0,0,114008,-96158
INJ_306,20230529,7000,7000,0,-1,46006,-39006
INJ_306,20230530,8050,7050,0,2,44995,-37945
INJ_306,20230531,13700,13700,0,0,82999,-69299
INJ_306,20230601,8250,8250,0,0,74997,-66747
INJ_306,20230602,7200,7200,0,722,48007,-40807
INJ_306,20230603,15650,15050,0,0,86003,-70953
INJ_306,20230605,8250,8250,0,2,57008,-48758
INJ_306,20230606,9850,9150,0,1,63008,-53858
INJ_306,20230607,13500,13500,0,1,69021,-55521
INJ_306,20230608,4600,4600,0,1,31006,-26406
INJ_306,20230609,10000,9700,0,1,55015,-45315
INJ_306,20230610,7500,7500,0,-2,53998,-46498
INJ_306,20230612,9450,9450,0,3,62991,-53541
INJ_306,20230613,14350,13250,0,2,83000,-69750
INJ_306,20230614,13850,13850,0,2,74008,-60158
INJ_306,20230615,8100,8100,0,1,54007,-45907
INJ_306,20230616,6450,6450,0,-2,60014,-53564
INJ_306,20230617,7900,7900,0,0,52001,-44101
INJ_306,20230619,12400,12400,0,-3,78886,-66486
INJ_306,20230620,12100,12100,0,0,87997,-75897
INJ_306,20230621,12900,12900,0,2,84005,-71105
INJ_306,20230622,9050,9050,0,2,65002,-55952
INJ_306,20230623,16800,15300,0,1,129001,-113701
INJ_306,20230624,8350,7550,0,0,56006,-48456
INJ_306,20230626,18950,13150,0,3,88016,-74866
INJ_306,20230627,19200,19200,0,5,122985,-103785
INJ_306,20230628,14850,13050,0,1,80991,-67941
INJ_306,20230630,16400,15700,0,1,78999,-63299
INJ_306,20230701,11200,11200,0,3,67001,-55801
INJ_306,20230703,8000,8000,0,-1,53004,-45004
INJ_306,20230704,9200,9200,0,2,68006,-58806
INJ_306,20230705,11650,11650,0,-1,64003,-52353
INJ_306,20230706,11700,9950,0,1,74013,-64063
INJ_306,20230707,16550,16550,0,-2,137027,-120477
INJ_306,20230708,9050,9050,0,1,55990,-46940
INJ_306,20230710,13800,13800,0,3,86994,-73194
INJ_306,20230711,14550,10750,0,3,63834,-53084
INJ_306,20230712,13000,11700,0,-1,89992,-78292
INJ_306,20230713,95250,12150,0,-1,81192,-69042
INJ_306,20230714,64550,6050,0,0,41001,-34951
INJ_306,20230715,74000,7750,0,0,47868,-40118
INJ_306,20230717,95950,15300,0,4,87041,-71741
INJ_306,20230718,85700,16400,0,2,110014,-93614
INJ_306,20230719,16350,14050,0,1,109020,-94970
INJ_307,20210928,8250,8250,0,0,32995,-24745
INJ_307,20210930,14750,12250,0,3,48988,-36738
INJ_307,20211001,15000,13000,0,0,51981,-38981
INJ_307,20211004,4000,4000,0,1,15997,-11997
INJ_307,20211006,3000,3000,0,0,0,3000
INJ_307,20211007,8500,8500,0,0,33995,-25495
INJ_307,20211008,7500,7500,0,1,29999,-22499
INJ_307,20211009,3750,3750,0,1,14995,-11245
INJ_307,20211011,8500,8500,0,1,33990,-25490
INJ_307,20211015,8250,8250,0,1,32993,-24743
INJ_307,20211018,12250,12250,0,-1,48995,-36745
INJ_307,20211020,3500,3500,0,0,13998,-10498
INJ_307,20211021,11500,11500,0,2,45992,-34492
INJ_307,20211022,8500,8500,0,0,33995,-25495
INJ_307,20211025,9000,9000,0,0,35994,-26994
INJ_307,20211026,8000,8000,0,1,31991,-23991
INJ_307,20211027,12500,12500,0,3,49991,-37491
INJ_307,20211028,7750,7750,0,0,30995,-23245
INJ_307,20211030,8250,8250,0,0,32997,-24747
INJ_307,20211101,15750,12750,0,0,50986,-38236
INJ_307,20211102,8000,8000,0,2,31994,-23994
INJ_307,20211103,3750,3750,0,1,14999,-11249
INJ_307,20211104,4000,4000,0,-1,15998,-11998
INJ_307,20211105,13750,12000,0,1,47996,-35996
INJ_307,20211106,3750,3750,0,0,14995,-11245
INJ_307,20211109,4250,4250,0,1,16996,-12746
INJ_307,20211110,8750,8750,0,1,34997,-26247
INJ_307,20211111,9750,8250,0,2,32992,-24742
INJ_307,20211112,15250,15250,0,-1,60987,-45737
INJ_307,20211113,4000,4000,0,0,10000,-6000
INJ_307,20211115,4250,4250,0,0,16996,-12746
INJ_307,20211116,15250,15250,0,-1,60988,-45738
INJ_307,20211117,16250,16250,0,3,64986,-48736
INJ_307,20211119,8000,8000,0,1,31994,-23994
INJ_307,20211120,10750,10750,0,1,42988,-32238
INJ_307,20211122,3750,3750,0,-1,14995,-11245
INJ_307,20211123,3250,3250,0,1,12999,-9749
INJ_307,20211124,9000,8250,0,-1,32995,-24745
INJ_307,20211125,9000,9000,0,0,35996,-26996
INJ_307,20211126,12000,12000,0,0,47994,-35994
INJ_307,20211127,3750,3750,0,0,14997,-11247
INJ_307,20211129,3750,3750,0,0,14994,-11244
INJ_307,20211130,8500,8500,0,-1,33987,-25487
INJ_307,20211201,7750,7750,0,2,30992,-23242
INJ_307,20211202,4000,4000,0,1,15997,-11997
INJ_307,20211203,4000,4000,0,-1,15998,-11998
INJ_307,20211204,8500,8500,0,1,33995,-25495
INJ_307,20211206,3750,3750,0,0,14996,-11246
INJ_307,20211207,4500,4500,0,0,17999,-13499
INJ_307,20211208,4250,4250,0,1,16998,-12748
INJ_307,20211209,5750,4000,0,0,15997,-11997
INJ_307,20211210,14500,14500,0,1,57985,-43485
INJ_307,20211214,3750,3750,0,0,14999,-11249
INJ_307,20211215,8750,8750,0,1,34993,-26243
INJ_307,20211217,6750,6750,0,2,26998,-20248
INJ_307,20211220,3750,3750,0,0,14997,-11247
INJ_307,20211221,4250,4250,0,0,16994,-12744
INJ_307,20211222,13250,13250,0,2,52987,-39737
INJ_307,20211223,3750,3750,0,0,14995,-11245
INJ_307,20211224,15250,15250,0,2,60981,-45731
INJ_307,20211225,3250,3250,0,0,12995,-9745
INJ_307,20211227,14250,13250,0,-1,52990,-39740
INJ_307,20211228,11500,11500,0,1,45991,-34491
INJ_307,20211229,13500,13500,0,2,53994,-40494
INJ_307,20211230,6750,6750,0,-1,26999,-20249
INJ_307,20211231,8250,8250,0,1,32994,-24744
INJ_307,20220101,6000,6000,0,0,23999,-17999
INJ_307,20220103,4000,4000,0,0,15998,-11998
INJ_307,20220105,8500,8500,2,517,33946,-25446
INJ_307,20220106,3750,3750,0,0,14973,-11223
INJ_307,20220107,17250,15750,0,1,62899,-47149
INJ_307,20220114,7250,7250,0,0,28953,-21703
INJ_307,20220115,4000,4000,0,0,15973,-11973
INJ_307,20220117,3500,3500,0,0,13974,-10474
INJ_307,20220119,3750,3750,0,0,14977,-11227
INJ_307,20220120,5750,5750,0,2,22973,-17223
INJ_307,20220121,9000,9000,0,0,35946,-26946
INJ_307,20220124,4000,4000,0,0,15970,-11970
INJ_307,20220125,10000,10000,0,1,39949,-29949
INJ_307,20220126,4000,4000,0,-1,15976,-11976
INJ_307,20220128,4500,4500,0,0,17982,-13482
INJ_307,20220131,4750,3250,0,0,12974,-9724
INJ_307,20220201,5500,5500,0,0,21965,-16465
INJ_307,20220202,7250,7250,0,-1,28952,-21702
INJ_307,20220203,4750,4750,0,2,18974,-14224
INJ_307,20220204,3750,3750,0,0,14981,-11231
INJ_307,20220208,3750,3750,0,1,14984,-11234
INJ_307,20220209,3750,3750,0,0,14981,-11231
INJ_307,20220210,4750,4750,0,0,18975,-14225
INJ_307,20220211,4250,4250,0,0,16976,-12726
INJ_307,20220212,11000,9500,0,2,37949,-28449
INJ_307,20220214,10500,10500,0,2,41942,-31442
INJ_307,20220219,4250,4250,0,1,16973,-12723
INJ_307,20220221,3750,3750,0,0,14972,-11222
INJ_307,20220225,3750,3750,0,1,14968,-11218
INJ_307,20220228,5750,5750,0,1,22973,-17223
INJ_307,20220301,3250,3250,0,-1,12983,-9733
INJ_307,20220303,8000,8000,0,1,31946,-23946
INJ_307,20220304,3750,3750,0,1,14976,-11226
INJ_307,20220305,3750,3750,0,-1,14983,-11233
INJ_307,20220307,3250,3250,0,0,12973,-9723
INJ_307,20220308,9250,9250,0,0,36942,-27692
INJ_307,20220311,4000,4000,0,-1,15972,-11972
INJ_307,20220312,4000,4000,0,1,15974,-11974
INJ_307,20220314,4000,4000,0,0,15973,-11973
INJ_307,20220316,3250,3250,0,-1,12984,-9734
INJ_307,20220317,4750,4750,0,1,18974,-14224
INJ_307,20220318,3250,3250,0,0,12975,-9725
INJ_307,20220319,11000,11000,0,-2,43917,-32917
INJ_307,20220323,3500,3500,0,-1,13975,-10475
INJ_307,20220325,3750,3750,0,0,14976,-11226
INJ_307,20220328,3750,3750,0,0,14973,-11223
INJ_307,20220329,3750,3750,0,-1,14972,-11222
INJ_307,20220404,3250,3250,0,0,12974,-9724
INJ_307,20220407,6250,6250,0,-1,24954,-18704
INJ_307,20220412,1250,1250,0,0,4981,-3731
INJ_307,20220413,3750,3750,0,1,14975,-11225
INJ_307,20220416,7750,7750,0,0,30935,-23185
INJ_307,20220420,6250,6250,0,0,24965,-18715
INJ_307,20220421,3250,3250,0,1,12972,-9722
INJ_307,20220422,2500,2500,0,1,9980,-7480
INJ_307,20220424,2500,2500,0,0,9982,-7482
INJ_307,20220425,2500,2500,0,-1,9983,-7483
INJ_307,20220427,3750,3750,0,1,14974,-11224
INJ_307,20220428,9500,9500,0,0,37931,-28431
INJ_307,20220429,3000,3000,0,1,11981,-8981
INJ_307,20220504,2500,2500,0,0,9984,-7484
INJ_307,20220505,2750,2750,0,-1,10983,-8233
INJ_307,20220506,3750,3750,0,0,14972,-11222
INJ_307,20220507,2500,2500,0,-1,9984,-7484
INJ_307,20220509,3250,3250,0,0,12973,-9723
INJ_307,20220510,4500,4500,0,-1,17963,-13463
INJ_307,20220512,3250,3250,0,1,12972,-9722
INJ_307,20220513,6250,6250,0,0,24954,-18704
INJ_307,20220514,8750,5250,0,0,20963,-15713
INJ_307,20220517,11750,10250,0,2,42091,-31841
INJ_307,20220518,7500,7500,0,1,29953,-22453
INJ_307,20220519,3750,3750,0,1,14974,-11224
INJ_307,20220520,3750,3750,0,-1,14971,-11221
INJ_307,20220521,2500,2500,0,0,9980,-7480
INJ_307,20220523,3250,3250,0,0,12979,-9729
INJ_307,20220524,3750,3750,0,0,14973,-11223
INJ_307,20220525,1750,1750,0,-1,6990,-5240
INJ_307,20220526,2500,2500,0,1,9954,-7454
INJ_307,20220527,14500,12750,0,-1,50921,-38171
INJ_307,20220528,7500,7500,0,1,29956,-22456
INJ_307,20220531,7500,7500,0,0,29951,-22451
INJ_307,20220601,4000,4000,0,0,15972,-11972
INJ_307,20220602,3500,3500,0,1,13981,-10481
INJ_307,20220603,3750,3750,0,0,14973,-11223
INJ_307,20220604,7250,7250,0,-2,28945,-21695
INJ_307,20220608,9250,9250,0,0,36936,-27686
INJ_307,20220610,6250,6250,0,0,24965,-18715
INJ_307,20220611,8750,8750,0,0,34946,-26196
INJ_307,20220613,4250,2500,0,0,9982,-7482
INJ_307,20220614,7500,7500,0,1,29954,-22454
INJ_307,20220615,3000,3000,0,-1,11982,-8982
INJ_307,20220616,8000,6250,0,0,24965,-18715
INJ_307,20220617,4250,4250,0,1,16976,-12726
INJ_307,20220618,3250,3250,0,0,12983,-9733
INJ_307,20220620,5000,5000,0,0,19966,-14966
INJ_307,20220621,6500,6500,0,0,25952,-19452
INJ_307,20220622,3250,3250,0,1,12979,-9729
INJ_307,20220623,3500,3500,0,0,13970,-10470
INJ_307,20220624,13750,13750,0,2,54897,-41147
INJ_307,20220627,3250,3250,0,-1,12980,-9730
INJ_307,20220628,16000,16000,0,-3,63887,-47887
INJ_307,20220629,9250,6750,0,2,26954,-20204
INJ_307,20220630,15250,13750,0,0,60901,-47151
INJ_307,20220701,12250,12250,0,2,48925,-36675
INJ_307,20220702,6500,6500,0,-1,25966,-19466
INJ_307,20220704,3750,3750,0,0,14976,-11226
INJ_307,20220705,3000,3000,0,0,11979,-8979
INJ_307,20220706,6750,6750,0,1,26944,-20194
INJ_307,20220707,10500,10500,0,1,41932,-31432
INJ_307,20220708,10500,10500,0,2,41925,-31425
INJ_307,20220712,3500,3500,0,0,13972,-10472
INJ_307,20220713,4000,4000,0,-1,15970,-11970
INJ_307,20220714,3250,3250,0,1,12974,-9724
INJ_307,20220716,3250,3250,0,-1,12982,-9732
INJ_307,20220718,8250,8250,0,1,32951,-24701
INJ_307,20220719,8000,8000,0,1,31954,-23954
INJ_307,20220720,3250,3250,0,0,12984,-9734
INJ_307,20220721,9250,9250,0,0,36947,-27697
INJ_307,20220723,3250,3250,0,1,12972,-9722
INJ_307,20220725,7500,7500,0,0,29955,-22455
INJ_307,20220726,3250,3250,0,0,12982,-9732
INJ_307,20220727,3750,3750,0,1,14981,-11231
INJ_307,20220730,4250,4250,0,1,16972,-12722
INJ_307,20220801,4000,4000,0,1,15974,-11974
INJ_307,20220802,7250,7250,0,1,28943,-21693
INJ_307,20220804,4000,4000,0,0,15973,-11973
INJ_307,20220805,18000,5750,0,0,15974,-10224
INJ_307,20220922,1750,1750,0,0,0,1750
INJ_307,20220923,3750,3750,0,1,14973,-11223
INJ_307,20220927,2500,2500,0,0,9984,-7484
INJ_307,20220928,2750,2750,0,1,10983,-8233
INJ_307,20220929,2500,2500,0,0,9981,-7481
INJ_307,20220930,3000,3000,0,1,11982,-8982
INJ_307,20221001,2500,2500,0,0,9982,-7482
INJ_307,20221004,3750,3750,3,987,14983,-11233
INJ_307,20221005,2750,2750,0,1,10983,-8233
INJ_307,20221006,6000,6000,0,0,23964,-17964
INJ_307,20221008,3750,3750,0,0,3847,-97
INJ_307,20221011,3750,3750,0,-1,14974,-11224
INJ_307,20221012,4750,4750,0,1,18973,-14223
INJ_307,20221013,10500,8750,0,2,34939,-26189
INJ_307,20221014,2500,2500,0,-1,9982,-7482
INJ_307,20221015,14000,14000,0,1,55912,-41912
INJ_307,20221018,3750,3750,0,1,14980,-11230
INJ_307,20221021,11500,10500,0,3,41916,-31416
INJ_307,20221024,3750,3750,0,0,14968,-11218
INJ_307,20221026,10000,10000,0,2,39934,-29934
INJ_307,20221027,3250,3250,0,0,12981,-9731
INJ_307,20221031,9250,7500,0,0,29967,-22467
INJ_307,20221101,2750,2750,0,0,10980,-8230
INJ_307,20221104,4500,4500,0,1,17973,-13473
INJ_307,20221105,2500,2500,0,-1,9983,-7483
INJ_307,20221107,4000,4000,0,0,15982,-11982
INJ_307,20221110,3000,3000,0,0,11983,-8983
INJ_307,20221112,3750,3750,0,0,14974,-11224
INJ_307,20221114,3750,3750,0,0,14980,-11230
INJ_307,20221116,3500,3500,0,0,13970,-10470
INJ_307,20221117,4000,4000,0,1,15973,-11973
INJ_307,20221118,6500,6500,0,0,25970,-19470
INJ_307,20221121,3250,3250,0,0,12983,-9733
INJ_307,20221122,2500,2500,0,1,9983,-7483
INJ_307,20221123,7250,7250,0,0,28958,-21708
INJ_307,20221125,7000,7000,0,0,27963,-20963
INJ_307,20221128,6750,6750,0,0,26963,-20213
INJ_307,20221130,6250,3750,0,1,14973,-11223
INJ_307,20221203,3750,3750,0,0,14982,-11232
INJ_307,20221205,3250,3250,0,-1,12973,-9723
INJ_307,20221206,5750,5750,0,1,22965,-17215
INJ_307,20221207,13250,7500,0,1,29967,-22467
INJ_307,20221208,5750,4000,0,0,15975,-11975
INJ_307,20221209,5500,5500,0,-1,21966,-16466
INJ_307,20221210,2750,2750,0,1,10984,-8234
INJ_307,20221216,6750,6750,0,1,26959,-20209
INJ_307,20221217,5750,5750,0,0,22964,-17214
INJ_307,20221219,2500,2500,0,0,9982,-7482
INJ_307,20221221,6250,5250,0,0,20965,-15715
INJ_307,20221222,6750,6750,0,0,26954,-20204
INJ_307,20221223,6250,6250,0,1,24964,-18714
INJ_307,20221224,3250,3250,0,1,12974,-9724
INJ_307,20221226,3250,3250,0,-1,12982,-9732
INJ_307,20221227,6250,4750,0,0,23813,-19063
INJ_307,20221228,5750,3750,0,0,14980,-11230
INJ_307,20221229,9750,8000,0,0,31945,-23945
INJ_307,20221231,3250,3250,0,0,12983,-9733
INJ_307,20230101,3250,3250,0,2,12972,-9722
INJ_307,20230102,6750,6750,0,0,26942,-20192
INJ_307,20230103,3583,3583,0,1,14301,-10718
INJ_307,20230104,3750,3750,0,0,14999,-11249
INJ_307,20230105,3750,3750,0,0,15002,-11252
INJ_307,20230107,2750,2750,0,1,11001,-8251
INJ_307,20230109,4000,4000,0,-1,16000,-12000
INJ_307,20230110,4000,4000,0,0,16001,-12001
INJ_307,20230112,6250,6250,0,0,25002,-18752
INJ_307,20230113,2500,2500,0,1,10000,-7500
INJ_307,20230116,8500,8500,0,1,33999,-25499
INJ_307,20230117,5000,5000,0,0,20003,-15003
INJ_307,20230118,7500,7500,0,1,30003,-22503
INJ_307,20230119,3500,3500,0,0,13998,-10498
INJ_307,20230120,5750,5000,0,0,19998,-14998
INJ_307,20230123,4000,4000,0,1,16000,-12000
INJ_307,20230301,3500,0,0,5,1128,-1128
INJ_307,20230313,12750,750,0,0,4112,-3362
INJ_308,20210928,1050,1050,0,0,6995,-5945
INJ_308,20210930,1200,1200,0,0,7995,-6795
INJ_308,20211001,1950,1500,0,1,9995,-8495
INJ_308,20211004,600,600,0,0,3998,-3398
INJ_308,20211006,6600,1200,0,0,0,1200
INJ_308,20211007,600,600,0,0,3997,-3397
INJ_308,20211008,1800,1800,0,1,11993,-10193
INJ_308,20211011,1200,1200,0,0,7993,-6793
INJ_308,20211018,1350,1350,0,-1,8996,-7646
INJ_308,20211020,600,600,0,0,3998,-3398
INJ_308,20211021,1650,1650,0,-1,10992,-9342
INJ_308,20211022,1200,1200,0,0,7993,-6793
INJ_308,20211025,1050,1050,0,0,6997,-5947
INJ_308,20211026,1500,1500,0,0,9991,-8491
INJ_308,20211027,1500,1500,0,0,9995,-8495
INJ_308,20211028,2250,2250,0,0,14992,-12742
INJ_308,20211030,450,450,0,0,2998,-2548
INJ_308,20211101,3600,2100,0,0,13987,-11887
INJ_308,20211102,1050,1050,0,0,6994,-5944
INJ_308,20211103,450,450,0,0,2996,-2546
INJ_308,20211104,600,600,0,0,3995,-3395
INJ_308,20211105,2850,2400,0,-1,15984,-13584
INJ_308,20211106,600,600,0,0,3998,-3398
INJ_308,20211110,750,750,0,0,4992,-4242
INJ_308,20211111,450,450,0,0,2997,-2547
INJ_308,20211112,1650,1650,0,0,10992,-9342
INJ_308,20211113,600,600,0,0,3996,-3396
INJ_308,20211115,750,750,0,-1,4998,-4248
INJ_308,20211116,1800,1800,0,0,11991,-10191
INJ_308,20211117,1350,1350,0,0,8992,-7642
INJ_308,20211119,750,750,0,0,4992,-4242
INJ_308,20211120,1950,1950,0,0,12991,-11041
INJ_308,20211122,600,600,0,0,3997,-3397
INJ_308,20211123,750,750,0,0,4996,-4246
INJ_308,20211124,600,600,0,-1,3998,-3398
INJ_308,20211126,1200,1200,0,0,7994,-6794
INJ_308,20211130,900,900,0,0,5991,-5091
INJ_308,20211201,1200,1200,0,0,7995,-6795
INJ_308,20211208,450,450,0,0,2996,-2546
INJ_308,20211209,600,600,0,0,3997,-3397
INJ_308,20211210,3450,3450,0,0,22981,-19531
INJ_308,20211214,450,450,0,0,2998,-2548
INJ_308,20211215,450,450,0,0,2995,-2545
INJ_308,20211217,3150,1650,0,0,10987,-9337
INJ_308,20211221,750,750,0,0,4995,-4245
INJ_308,20211222,3600,3600,0,0,23987,-20387
INJ_308,20211223,1650,1050,0,0,6993,-5943
INJ_308,20211224,2550,2550,0,-1,16982,-14432
INJ_308,20211225,750,750,0,0,4996,-4246
INJ_308,20211227,1350,1350,0,0,8991,-7641
INJ_308,20211228,2400,2400,0,0,15985,-13585
INJ_308,20211229,1050,1050,0,0,6990,-5940
INJ_308,20211230,1650,1650,0,0,10989,-9339
INJ_308,20211231,1050,1050,0,-1,6992,-5942
INJ_308,20220101,3600,2250,0,1,14984,-12734
INJ_308,20220103,600,600,0,0,3997,-3397
INJ_308,20220106,1200,600,0,-1,3998,-3398
INJ_308,20220107,450,450,0,1,2998,-2548
INJ_308,20220114,600,600,0,0,3998,-3398
INJ_308,20220115,600,600,0,0,3998,-3398
INJ_308,20220117,900,900,0,1,5996,-5096
INJ_308,20220124,600,600,0,0,3996,-3396
INJ_308,20220125,900,900,0,0,5994,-5094
INJ_308,20220126,600,600,0,0,3996,-3396
INJ_308,20220128,1200,1200,0,0,7995,-6795
INJ_308,20220131,750,750,0,0,4995,-4245
INJ_308,20220202,1050,1050,0,0,6992,-5942
INJ_308,20220203,450,450,0,1,2997,-2547
INJ_308,20220204,750,750,0,0,4995,-4245
INJ_308,20220208,1050,1050,0,0,6994,-5944
INJ_308,20220209,750,750,0,-1,4994,-4244
INJ_308,20220210,450,450,0,0,2996,-2546
INJ_308,20220212,2100,1050,0,0,6995,-5945
INJ_308,20220214,600,600,0,0,3996,-3396
INJ_308,20220225,2400,1200,0,1,2550,-1350
INJ_308,20220301,3000,750,0,1,4997,-4247
INJ_308,20220412,750,750,0,0,4998,-4248
INJ_308,20220420,1050,1050,0,-1,6995,-5945
INJ_308,20220422,450,450,0,0,2998,-2548
INJ_308,20220424,600,600,0,0,3998,-3398
INJ_308,20220427,450,450,0,0,2998,-2548
INJ_308,20220428,2550,2550,0,0,16994,-14444
INJ_308,20220429,1650,1200,0,1,7995,-6795
INJ_308,20220505,1050,1050,0,1,6996,-5946
INJ_308,20220506,750,750,0,0,4998,-4248
INJ_308,20220507,750,750,0,-1,4998,-4248
INJ_308,20220509,750,750,0,0,4998,-4248
INJ_308,20220513,1050,1050,0,1,6995,-5945
INJ_308,20220514,3300,2400,0,1,15991,-13591
INJ_308,20220517,900,900,0,-1,5996,-5096
INJ_308,20220518,450,450,0,0,2998,-2548
INJ_308,20220519,600,600,0,0,3998,-3398
INJ_308,20220523,600,600,0,0,3997,-3397
INJ_308,20220524,1200,1200,0,0,7998,-6798
INJ_308,20220525,1950,1950,0,0,12995,-11045
INJ_308,20220526,600,600,0,-1,3997,-3397
INJ_308,20220527,3300,2550,0,1,16988,-14438
INJ_308,20220528,900,900,0,0,5995,-5095
INJ_308,20220531,1950,1950,0,0,12995,-11045
INJ_308,20220602,450,450,0,0,2997,-2547
INJ_308,20220604,750,750,0,0,4995,-4245
INJ_308,20220608,6000,6000,0,0,39979,-33979
INJ_308,20220610,1200,1200,0,0,7995,-6795
INJ_308,20220611,3000,3000,0,0,19989,-16989
INJ_308,20220613,2400,1500,0,-1,9998,-8498
INJ_308,20220614,4050,4050,0,-1,26989,-22939
INJ_308,20220615,1650,1650,0,0,10996,-9346
INJ_308,20220616,900,900,0,-1,5995,-5095
INJ_308,20220618,450,450,0,1,2998,-2548
INJ_308,20220620,450,450,0,0,2998,-2548
INJ_308,20220621,2250,2250,0,-1,14992,-12742
INJ_308,20220622,300,300,0,1,1997,-1697
INJ_308,20220624,2250,2250,0,0,14992,-12742
INJ_308,20220629,3600,3600,0,1,23990,-20390
INJ_308,20220630,2250,2250,0,0,14995,-12745
INJ_308,20220701,1500,1500,0,0,9993,-8493
INJ_308,20220702,750,750,0,1,4994,-4244
INJ_308,20220704,600,600,0,0,3998,-3398
INJ_308,20220705,450,450,0,0,2999,-2549
INJ_308,20220706,450,450,0,1,2998,-2548
INJ_308,20220707,2400,2400,0,-1,15992,-13592
INJ_308,20220708,1800,1800,0,1,11993,-10193
INJ_308,20220712,600,600,0,0,3997,-3397
INJ_308,20220714,750,750,0,0,4997,-4247
INJ_308,20220716,600,600,0,0,3997,-3397
INJ_308,20220718,750,750,0,0,4997,-4247
INJ_308,20220719,1350,1350,0,0,8994,-7644
INJ_308,20220720,1050,1050,0,0,6998,-5948
INJ_308,20220721,2400,2400,0,-1,15992,-13592
INJ_308,20220723,750,750,0,0,4999,-4249
INJ_308,20220725,1050,1050,0,1,6996,-5946
INJ_308,20220726,750,750,0,0,4998,-4248
INJ_308,20220727,450,450,0,0,2998,-2548
INJ_308,20220806,750,750,0,0,4999,-4249
INJ_308,20220808,2700,2700,0,-1,17992,-15292
INJ_308,20220810,1050,1050,0,0,6996,-5946
INJ_308,20220811,600,600,0,0,3998,-3398
INJ_308,20220813,750,750,0,0,4998,-4248
INJ_308,20220816,1800,1800,0,1,11993,-10193
INJ_308,20220817,450,450,0,0,2999,-2549
INJ_308,20220818,1050,1050,0,0,6995,-5945
INJ_308,20220819,600,600,0,0,3997,-3397
INJ_308,20220822,450,450,0,0,2998,-2548
INJ_308,20220824,1800,1800,0,0,11994,-10194
INJ_308,20220825,600,600,0,0,3998,-3398
INJ_308,20220826,1500,1500,0,1,9993,-8493
INJ_308,20220827,900,900,0,0,5995,-5095
INJ_308,20220829,1800,1800,0,0,11995,-10195
INJ_308,20220831,1650,1650,0,0,10989,-9339
INJ_308,20220902,450,450,0,-1,2996,-2546
INJ_308,20220909,600,600,0,1,3998,-3398
INJ_308,20220910,750,750,0,-1,4998,-4248
INJ_308,20220912,1350,1350,0,-1,8995,-7645
INJ_308,20220914,1200,600,0,1,3997,-3397
INJ_308,20220915,450,450,0,0,2998,-2548
INJ_308,20220916,1650,1650,0,-1,10995,-9345
INJ_308,20220920,600,600,0,1,3998,-3398
INJ_308,20220921,450,450,0,-1,2998,-2548
INJ_308,20220922,600,600,0,1,3998,-3398
INJ_308,20220923,1500,1500,0,0,9992,-8492
INJ_308,20220927,750,750,0,0,4998,-4248
INJ_308,20220928,450,450,0,0,2998,-2548
INJ_308,20220929,750,750,0,0,4998,-4248
INJ_308,20220930,450,450,0,0,2998,-2548
INJ_308,20221001,600,600,0,0,3998,-3398
INJ_308,20221011,600,600,0,819,3998,-3398
INJ_308,20221013,5400,1200,903,191,7996,-6796
INJ_308,20221014,6000,750,0,0,4997,-4247
INJ_308,20221015,15450,2250,0,0,14993,-12743
INJ_308,20221026,19050,2100,0,0,13994,-11894
INJ_308,20221027,2250,450,0,0,2998,-2548
INJ_308,20221031,2250,450,0,0,2997,-2547
INJ_308,20221104,4200,600,0,0,3998,-3398
INJ_308,20221110,2250,450,0,0,2998,-2548
INJ_308,20221112,4200,600,0,0,3998,-3398
INJ_308,20221116,600,600,0,0,3998,-3398
INJ_308,20221118,1350,1350,0,0,8996,-7646
INJ_308,20221121,750,750,0,0,4998,-4248
INJ_308,20221123,750,750,0,0,4999,-4249
INJ_308,20221128,750,750,0,0,4998,-4248
INJ_308,20221130,450,450,0,0,2998,-2548
INJ_308,20221217,1050,1050,0,0,6997,-5947
INJ_308,20221222,750,750,0,0,4998,-4248
INJ_308,20221228,4200,600,0,0,3997,-3397
INJ_308,20221229,13200,1500,0,0,9997,-8497
INJ_308,20221231,4200,600,0,0,3997,-3397
INJ_308,20230101,11550,1050,0,0,6858,-5808
INJ_308,20230102,12600,1050,0,0,6998,-5948
INJ_308,20230104,4200,600,0,0,3998,-3398
INJ_308,20230105,9000,900,0,0,5998,-5098
INJ_308,20230107,11250,1350,0,0,8996,-7646
INJ_308,20230109,4200,600,0,0,3997,-3397
INJ_308,20230110,4200,600,0,0,3998,-3398
INJ_308,20230112,6450,1050,0,0,6997,-5947
INJ_308,20230113,9000,900,0,0,5998,-5098
INJ_308,20230116,4200,600,0,0,3998,-3398
INJ_308,20230117,13500,1500,0,0,9996,-8496
INJ_308,20230118,9450,1200,0,0,7996,-6796
INJ_308,20230119,4200,600,0,0,3998,-3398
INJ_308,20230120,16500,1650,0,0,10996,-9346
INJ_308,20230331,1800,1800,0,0,11995,-10195
INJ_308,20230401,450,450,0,901,2998,-2548
INJ_308,20230404,1650,1650,0,900,10993,-9343
INJ_308,20230410,1350,1350,4,199,8996,-7646
INJ_308,20230411,450,450,2,102,2998,-2548
INJ_308,20230413,600,600,0,0,3998,-3398
INJ_308,20230414,2550,2550,0,0,16989,-14439
INJ_308,20230415,450,450,4,501,2998,-2548
INJ_308,20230417,1200,1200,1,798,7996,-6796
INJ_308,20230426,600,600,0,0,3998,-3398
INJ_308,20230428,3300,3300,1,799,21987,-18687
INJ_308,20230429,1650,1650,3,599,10994,-9344
INJ_308,20230502,1650,1050,2,703,6997,-5947
INJ_308,20230503,900,900,0,1,5996,-5096
INJ_308,20230504,3750,3750,4,798,24988,-21238
INJ_308,20230505,900,900,0,0,5998,-5098
INJ_308,20230506,900,900,1,800,5996,-5096
INJ_308,20230508,2700,2700,1,200,17992,-15292
INJ_308,20230509,900,450,2,404,2998,-2548
INJ_308,20230511,750,750,5,397,4998,-4248
INJ_308,20230512,1050,1050,3,301,6998,-5948
INJ_308,20230513,1050,1050,7,794,6996,-5946
INJ_308,20230518,450,450,5,107,2998,-2548
INJ_308,20230519,1350,1350,2,396,8993,-7643
INJ_308,20230520,600,600,0,0,3998,-3398
INJ_308,20230522,600,600,2,101,3997,-3397
INJ_308,20230523,750,750,6,2,4998,-4248
INJ_308,20230524,2850,2850,1,202,18991,-16141
INJ_308,20230527,3300,2550,3,304,16991,-14441
INJ_308,20230529,600,600,1,195,3998,-3398
INJ_308,20230531,1050,1050,4,197,6994,-5944
INJ_308,20230602,600,600,3,606,3997,-3397
INJ_308,20230603,1650,1650,5,106,10994,-9344
INJ_308,20230605,750,750,2,397,4998,-4248
INJ_308,20230607,2100,2100,1,799,13995,-11895
INJ_308,20230609,1500,1500,1,799,9995,-8495
INJ_308,20230610,750,750,3,3,4998,-4248
INJ_308,20230613,1350,1350,2,998,8996,-7646
INJ_308,20230614,2400,1800,1,200,11994,-10194
INJ_308,20230615,600,600,5,999,3998,-3398
INJ_308,20230617,600,600,3,598,3998,-3398
INJ_308,20230619,1050,1050,5,997,6995,-5945
INJ_308,20230621,900,900,3,605,5996,-5096
INJ_308,20230626,600,600,4,797,3997,-3397
INJ_308,20230627,5250,5250,7,198,34981,-29731
INJ_308,20230628,1650,1650,4,801,10996,-9346
INJ_308,20230630,750,750,2,105,4997,-4247
INJ_308,20230701,1800,1800,12,300,11995,-10195
INJ_308,20230703,600,600,3,296,3997,-3397
INJ_308,20230704,450,450,4,199,2997,-2547
INJ_308,20230705,1800,1800,4,204,11991,-10191
INJ_308,20230706,900,450,11,8,2998,-2548
INJ_308,20230707,450,450,12,892,2998,-2548
INJ_308,20230708,600,600,2,998,3997,-3397
INJ_308,20230710,750,750,4,501,4998,-4248
INJ_308,20230711,450,450,5,702,2996,-2546
INJ_308,20230712,750,750,7,809,4998,-4248
INJ_308,20230713,2550,1800,6,649,11995,-10195
INJ_308,20230714,4200,600,3,930,3998,-3398
INJ_308,20230715,3000,750,2,893,4998,-4248
INJ_308,20230717,4800,1200,0,0,7994,-6794
INJ_308,20230718,15600,1650,10,165,10995,-9345
INJ_308,20230719,450,450,8,954,2998,-2548
INJ_309,20210928,6500,6500,0,-1,25992,-19492
INJ_309,20210930,12500,10500,0,3,41985,-31485
INJ_309,20211001,10500,9250,0,1,36989,-27739
INJ_309,20211004,3250,3250,0,0,12999,-9749
INJ_309,20211006,3250,3250,0,0,0,3250
INJ_309,20211007,7000,7000,0,-1,27994,-20994
INJ_309,20211008,8000,6000,0,2,23993,-17993
INJ_309,20211009,4500,4500,0,-1,17995,-13495
INJ_309,20211011,6000,6000,0,2,23995,-17995
INJ_309,20211018,10250,10250,0,-1,40991,-30741
INJ_309,20211020,3750,3750,0,1,14996,-11246
INJ_309,20211021,10500,10500,0,0,41986,-31486
INJ_309,20211022,6000,6000,0,0,23993,-17993
INJ_309,20211025,5750,5750,0,1,22994,-17244
INJ_309,20211026,6000,6000,0,2,23990,-17990
INJ_309,20211027,9750,9750,0,1,38991,-29241
INJ_309,20211028,5000,5000,0,1,19993,-14993
INJ_309,20211030,7500,7500,0,2,29987,-22487
INJ_309,20211101,12500,8500,0,2,33986,-25486
INJ_309,20211102,6750,6750,0,0,26993,-20243
INJ_309,20211103,3750,3750,0,0,14999,-11249
INJ_309,20211104,3250,3250,0,0,12996,-9746
INJ_309,20211105,10500,8750,0,0,34991,-26241
INJ_309,20211106,3500,3500,0,0,13997,-10497
INJ_309,20211109,4000,4000,0,1,15994,-11994
INJ_309,20211110,7000,7000,0,2,27996,-20996
INJ_309,20211111,9000,7500,0,1,29991,-22491
INJ_309,20211112,17000,15000,0,2,59969,-44969
INJ_309,20211113,7750,3250,0,625,10320,-7070
INJ_309,20211115,2750,2750,0,0,10997,-8247
INJ_309,20211116,14750,14750,0,1,58989,-44239
INJ_309,20211117,14500,14500,0,2,57981,-43481
INJ_309,20211119,7750,7750,0,-1,30992,-23242
INJ_309,20211120,10750,10750,0,2,42991,-32241
INJ_309,20211122,3500,3500,0,0,13997,-10497
INJ_309,20211123,3750,3750,0,0,14995,-11245
INJ_309,20211124,7750,7750,0,-1,30993,-23243
INJ_309,20211125,7500,7500,0,-1,29990,-22490
INJ_309,20211126,11250,11250,0,2,44993,-33743
INJ_309,20211127,4500,4500,0,0,17999,-13499
INJ_309,20211129,5000,5000,0,0,19993,-14993
INJ_309,20211130,6500,6500,0,1,25989,-19489
INJ_309,20211201,6750,6750,0,-1,26990,-20240
INJ_309,20211202,4250,4250,0,0,16993,-12743
INJ_309,20211203,3250,3250,0,0,12999,-9749
INJ_309,20211204,8000,8000,0,2,31988,-23988
INJ_309,20211206,4500,4500,0,0,17998,-13498
INJ_309,20211207,3750,3750,0,0,14998,-11248
INJ_309,20211208,3250,3250,0,0,12996,-9746
INJ_309,20211209,3250,3250,0,0,12994,-9744
INJ_309,20211210,12750,12750,0,1,50989,-38239
INJ_309,20211214,3750,3750,0,1,14997,-11247
INJ_309,20211215,7000,7000,0,1,27991,-20991
INJ_309,20211217,8750,7000,0,0,27984,-20984
INJ_309,20211220,7000,7000,0,1,27996,-20996
INJ_309,20211221,2750,2750,0,0,11001,-8251
INJ_309,20211222,13750,13750,0,2,54982,-41232
INJ_309,20211223,2750,2750,0,1,10994,-8244
INJ_309,20211224,13500,13500,0,2,53986,-40486
INJ_309,20211225,3750,3750,0,0,15000,-11250
INJ_309,20211227,9250,9250,0,1,36981,-27731
INJ_309,20211228,9750,9750,0,1,38988,-29238
INJ_309,20211229,9500,9500,0,1,37984,-28484
INJ_309,20211230,7000,7000,0,1,27992,-20992
INJ_309,20211231,6500,6500,0,1,25993,-19493
INJ_309,20220101,6750,6750,0,0,26990,-20240
INJ_309,20220103,3250,3250,0,2,12994,-9744
INJ_309,20220105,8000,8000,1,267,31941,-23941
INJ_309,20220106,3500,3500,0,2,13980,-10480
INJ_309,20220115,3250,3250,0,-1,12982,-9732
INJ_309,20220117,3250,3250,0,1,12981,-9731
INJ_309,20220119,4500,4500,0,1,17966,-13466
INJ_309,20220120,2500,2500,0,0,9971,-7471
INJ_309,20220121,4750,4750,0,0,18958,-14208
INJ_309,20220124,3250,3250,0,0,12979,-9729
INJ_309,20220125,5000,5000,0,0,19953,-14953
INJ_309,20220126,3250,3250,0,0,12980,-9730
INJ_309,20220128,1750,1750,0,1,6977,-5227
INJ_309,20220131,7750,3750,0,0,14981,-11231
INJ_309,20220201,2750,2750,0,-1,10979,-8229
INJ_309,20220202,8000,8000,0,0,31954,-23954
INJ_309,20220203,2750,2750,0,0,10978,-8228
INJ_309,20220204,3750,3750,0,0,14988,-11238
INJ_309,20220208,2750,2750,0,-1,10981,-8231
INJ_309,20220209,3750,3750,0,0,14988,-11238
INJ_309,20220210,2750,2750,0,0,10978,-8228
INJ_309,20220211,4000,4000,0,0,15968,-11968
INJ_309,20220212,6500,5250,0,1,20946,-15696
INJ_309,20220214,5000,5000,0,1,19950,-14950
INJ_309,20220219,4000,4000,0,0,15968,-11968
INJ_309,20220221,5000,5000,0,-1,19976,-14976
INJ_309,20220225,2500,2500,0,-1,9980,-7480
INJ_309,20220228,2500,2500,0,1,9963,-7463
INJ_309,20220301,3750,3750,0,1,14965,-11215
INJ_309,20220303,9000,9000,0,1,35988,-26988
INJ_309,20220304,5000,5000,0,0,19994,-14994
INJ_309,20220305,3500,3500,0,0,13986,-10486
INJ_309,20220307,5000,5000,0,0,19985,-14985
INJ_309,20220308,7250,7250,0,0,28977,-21727
INJ_309,20220311,4250,4250,0,0,16990,-12740
INJ_309,20220312,4250,4250,0,0,16984,-12734
INJ_309,20220314,4250,4250,0,1,16983,-12733
INJ_309,20220316,4000,4000,0,-1,15989,-11989
INJ_309,20220317,3500,3500,0,-1,13991,-10491
INJ_309,20220318,5000,5000,0,0,19989,-14989
INJ_309,20220319,14250,14250,0,0,56965,-42715
INJ_309,20220323,4750,4750,0,0,18988,-14238
INJ_309,20220325,4500,4500,0,1,17989,-13489
INJ_309,20220328,4500,4500,0,0,17985,-13485
INJ_309,20220329,4500,4500,0,1,17984,-13484
INJ_309,20220404,5000,5000,0,-1,19989,-14989
INJ_309,20220407,10250,10250,0,2,40972,-30722
INJ_309,20220412,3750,3750,0,0,14997,-11247
INJ_309,20220413,4500,4500,0,0,17988,-13488
INJ_309,20220416,8750,8750,0,0,34970,-26220
INJ_309,20220420,9000,9000,0,0,35976,-26976
INJ_309,20220421,5000,5000,0,0,19987,-14987
INJ_309,20220422,5000,5000,0,1,19984,-14984
INJ_309,20220424,4750,4750,0,1,18983,-14233
INJ_309,20220425,5750,5750,0,0,22984,-17234
INJ_309,20220427,3750,3750,0,1,14989,-11239
INJ_309,20220428,11000,11000,0,1,43977,-32977
INJ_309,20220429,3750,3750,0,1,14997,-11247
INJ_309,20220504,5750,5750,0,0,22984,-17234
INJ_309,20220505,3750,3750,0,1,14993,-11243
INJ_309,20220506,3750,3750,0,0,14996,-11246
INJ_309,20220507,2000,2000,0,0,7996,-5996
INJ_309,20220509,3750,3750,0,0,14991,-11241
INJ_309,20220510,3750,3750,0,1,14992,-11242
INJ_309,20220512,5000,5000,0,0,19986,-14986
INJ_309,20220513,8500,8500,0,1,33978,-25478
INJ_309,20220514,11250,7250,0,1,28983,-21733
INJ_309,20220517,13000,13000,0,3,50779,-37779
INJ_309,20220518,8750,8750,0,1,34978,-26228
INJ_309,20220519,3500,3500,0,0,13993,-10493
INJ_309,20220520,5000,5000,0,0,19988,-14988
INJ_309,20220521,5750,5750,0,2,22985,-17235
INJ_309,20220523,4000,4000,0,-1,15985,-11985
INJ_309,20220524,2500,2500,0,0,9992,-7492
INJ_309,20220525,3250,3250,0,0,12990,-9740
INJ_309,20220526,6750,4750,0,0,18984,-14234
INJ_309,20220527,16500,16500,0,1,65957,-49457
INJ_309,20220528,8000,8000,0,-1,31983,-23983
INJ_309,20220531,6250,6250,0,0,24989,-18739
INJ_309,20220601,4250,4250,0,3,16988,-12738
INJ_309,20220602,4000,4000,0,0,15983,-11983
INJ_309,20220603,4500,4500,0,1,17985,-13485
INJ_309,20220604,8000,8000,0,3,31985,-23985
INJ_309,20220608,13750,13750,0,1,54966,-41216
INJ_309,20220610,8250,8250,0,0,32977,-24727
INJ_309,20220611,11500,11500,0,2,45976,-34476
INJ_309,20220613,5000,3250,0,2,12992,-9742
INJ_309,20220614,10500,10500,0,0,41969,-31469
INJ_309,20220615,4500,4500,0,1,17988,-13488
INJ_309,20220616,10750,8750,0,0,34978,-26228
INJ_309,20220617,4000,4000,0,1,15989,-11989
INJ_309,20220618,4250,4250,0,0,16990,-12740
INJ_309,20220620,2500,2500,0,0,9992,-7492
INJ_309,20220621,6250,6250,0,1,24983,-18733
INJ_309,20220622,5000,5000,0,0,19991,-14991
INJ_309,20220623,4750,4750,0,1,18985,-14235
INJ_309,20220624,16000,16000,0,2,63962,-47962
INJ_309,20220627,5000,5000,0,1,19983,-14983
INJ_309,20220628,8750,8750,0,2,34975,-26225
INJ_309,20220629,3750,3750,0,0,14993,-11243
INJ_309,20220630,15500,15500,0,4,55957,-40457
INJ_309,20220701,10000,10000,0,1,39981,-29981
INJ_309,20220702,9250,9250,0,0,36981,-27731
INJ_309,20220704,3500,3500,0,0,13988,-10488
INJ_309,20220705,4500,4500,0,0,17988,-13488
INJ_309,20220706,9000,9000,0,1,35966,-26966
INJ_309,20220707,10250,10250,0,0,40965,-30715
INJ_309,20220708,11250,11250,0,-1,44968,-33718
INJ_309,20220712,3750,3750,0,0,14996,-11246
INJ_309,20220713,4250,4250,0,1,16989,-12739
INJ_309,20220714,3750,3750,0,2,14991,-11241
INJ_309,20220716,4000,4000,0,0,15989,-11989
INJ_309,20220718,7000,7000,0,-1,27992,-20992
INJ_309,20220719,6250,6250,0,2,24983,-18733
INJ_309,20220720,3250,3250,0,0,12995,-9745
INJ_309,20220721,11500,11500,0,1,45975,-34475
INJ_309,20220723,3750,3750,0,0,14990,-11240
INJ_309,20220725,7250,7250,0,1,28978,-21728
INJ_309,20220726,3750,3750,0,1,14987,-11237
INJ_309,20220727,3750,3750,0,0,14990,-11240
INJ_309,20220730,4000,4000,0,0,15988,-11988
INJ_309,20220801,4250,4250,0,0,16898,-12648
INJ_309,20220802,9250,9250,0,-2,36977,-27727
INJ_309,20220804,4250,4250,0,1,16986,-12736
INJ_309,20220805,12500,10750,0,3,49967,-39217
INJ_309,20220806,7000,7000,0,0,27986,-20986
INJ_309,20220808,3750,3750,0,0,14991,-11241
INJ_309,20220810,14750,14750,0,1,58955,-44205
INJ_309,20220811,7250,7250,0,-1,28975,-21725
INJ_309,20220813,7000,7000,0,1,27975,-20975
INJ_309,20220816,13500,13500,0,2,53960,-40460
INJ_309,20220817,7500,7500,0,0,29981,-22481
INJ_309,20220818,6500,6500,0,0,25985,-19485
INJ_309,20220819,7250,7250,0,2,28981,-21731
INJ_309,20220822,24000,24000,0,5,95915,-71915
INJ_309,20220824,15500,13500,0,1,53961,-40461
INJ_309,20220825,7250,7250,0,0,28981,-21731
INJ_309,20220826,14000,14000,0,1,55962,-41962
INJ_309,20220827,23250,23250,0,0,92918,-69668
INJ_309,20220829,13500,13500,0,1,53967,-40467
INJ_309,20220830,16500,16500,0,2,65957,-49457
INJ_309,20220831,30250,30250,0,2,120942,-90692
INJ_309,20220901,8250,8250,0,1,32974,-24724
INJ_309,20220902,7500,7500,0,1,29975,-22475
INJ_309,20220906,7250,7250,0,1,28976,-21726
INJ_309,20220909,9000,7250,0,-1,28982,-21732
INJ_309,20220910,7000,7000,0,0,27977,-20977
INJ_309,20220912,14250,14250,0,0,56970,-42720
INJ_309,20220914,14250,7250,0,0,28973,-21723
INJ_309,20220915,7500,7500,0,1,29977,-22477
INJ_309,20220916,22000,22000,0,2,87934,-65934
INJ_309,20220920,7250,7250,0,-1,28982,-21732
INJ_309,20220921,7500,7500,0,1,29983,-22483
INJ_309,20220922,7250,5500,0,0,28983,-23483
INJ_309,20220923,10250,10250,0,0,40968,-30718
INJ_309,20220927,4500,4500,0,1,17987,-13487
INJ_309,20220928,4750,4750,0,1,18987,-14237
INJ_309,20220929,4500,4500,0,0,17987,-13487
INJ_309,20220930,4500,4500,0,0,17988,-13488
INJ_309,20221001,4750,4750,0,1,18987,-14237
INJ_309,20221004,3500,3500,0,0,13991,-10491
INJ_309,20221005,3500,3500,0,0,13994,-10494
INJ_309,20221006,4750,4750,0,0,18981,-14231
INJ_309,20221008,1000,1000,0,1,2740,-1740
INJ_309,20221011,3500,3500,0,0,13995,-10495
INJ_309,20221012,3500,3500,0,0,13992,-10492
INJ_309,20221013,14750,13250,0,1,52971,-39721
INJ_309,20221014,5500,4500,0,2,17994,-13494
INJ_309,20221015,15250,15250,0,1,60944,-45694
INJ_309,20221018,3750,3750,0,-1,14988,-11238
INJ_309,20221021,13250,11750,0,-1,46972,-35222
INJ_309,20221024,3500,3500,0,1,13989,-10489
INJ_309,20221026,11250,11250,0,2,44964,-33714
INJ_309,20221027,4250,4250,0,1,16986,-12736
INJ_309,20221031,8000,7250,0,3,28981,-21731
INJ_309,20221101,3250,3250,0,3,12991,-9741
INJ_309,20221104,2750,2750,0,0,10992,-8242
INJ_309,20221105,4250,4250,0,2,16991,-12741
INJ_309,20221107,4250,4250,0,0,16994,-12744
INJ_309,20221110,4500,4500,0,1,17986,-13486
INJ_309,20221112,3500,3500,0,0,13990,-10490
INJ_309,20221114,3250,3250,0,2,12988,-9738
INJ_309,20221116,3750,3750,0,0,14989,-11239
INJ_309,20221117,3500,3500,0,0,13990,-10490
INJ_309,20221118,7750,7750,0,0,30982,-23232
INJ_309,20221121,3750,3750,0,1,14988,-11238
INJ_309,20221122,4750,4750,0,0,18990,-14240
INJ_309,20221123,8000,8000,0,1,31982,-23982
INJ_309,20221125,8000,8000,0,1,31976,-23976
INJ_309,20221128,9750,7750,0,0,30978,-23228
INJ_309,20221130,5750,3750,0,1,14992,-11242
INJ_309,20221203,3500,3500,0,1,13991,-10491
INJ_309,20221205,5000,5000,0,1,19989,-14989
INJ_309,20221206,8750,8750,0,0,34978,-26228
INJ_309,20221207,9750,7500,0,-2,29982,-22482
INJ_309,20221208,6000,4250,0,1,16991,-12741
INJ_309,20221209,8250,8250,0,2,32990,-24740
INJ_309,20221210,4750,4750,0,-2,18990,-14240
INJ_309,20221216,8000,8000,0,2,31974,-23974
INJ_309,20221217,9000,9000,0,0,35979,-26979
INJ_309,20221219,4250,4250,0,0,16989,-12739
INJ_309,20221221,10750,9250,0,-1,36981,-27731
INJ_309,20221222,7750,7750,0,-1,30984,-23234
INJ_309,20221223,6750,6750,0,1,26984,-20234
INJ_309,20221224,5000,5000,0,0,19993,-14993
INJ_309,20221226,3750,3750,0,2,14992,-11242
INJ_309,20221227,8500,8500,0,0,33988,-25488
INJ_309,20221228,4750,3500,0,0,13988,-10488
INJ_309,20221229,6000,6000,0,0,23986,-17986
INJ_309,20221230,623,623,0,0,2466,-1843
INJ_309,20221231,4000,4000,0,0,15988,-11988
INJ_309,20230101,3250,3250,0,0,12993,-9743
INJ_309,20230102,7250,7250,0,1,28984,-21734
INJ_309,20230103,3250,3250,0,0,12993,-9743
INJ_309,20230104,3500,3500,0,0,14001,-10501
INJ_309,20230105,3000,3000,0,2,12000,-9000
INJ_309,20230107,3250,3250,0,2,13002,-9752
INJ_309,20230109,3250,3250,0,0,13004,-9754
INJ_309,20230110,3250,3250,0,0,13003,-9753
INJ_309,20230112,8500,8500,0,2,34010,-25510
INJ_309,20230113,4250,4250,0,0,17000,-12750
INJ_309,20230116,7000,7000,0,2,28000,-21000
INJ_309,20230117,9000,9000,0,1,36001,-27001
INJ_309,20230118,7000,7000,0,3,28005,-21005
INJ_309,20230119,3750,3750,0,-1,14999,-11249
INJ_309,20230120,10250,8750,0,2,34992,-26242
INJ_309,20230123,4250,4250,0,1,16996,-12746
INJ_309,20230301,1750,0,0,0,592,-592
INJ_309,20230313,11750,1000,0,4,5942,-4942
INJ_401,20210928,24900,22500,0,0,74981,-52481
INJ_401,20210929,37200,37200,0,0,123969,-86769
INJ_401,20210930,35700,35700,0,3,118942,-83242
INJ_401,20211001,18300,18300,0,-1,51984,-33684
INJ_401,20211002,29700,29700,0,1,98957,-69257
INJ_401,20211004,36300,29100,0,-1,96965,-67865
INJ_401,20211005,15900,15900,0,2,52947,-37047
INJ_401,20211006,20400,20400,0,-1,67980,-47580
INJ_401,20211007,18000,17400,0,-1,57987,-40587
INJ_401,20211008,22800,22800,0,1,75988,-53188
INJ_401,20211009,26100,23700,5,579,78955,-55255
INJ_401,20211011,12000,12000,0,1,39990,-27990
INJ_401,20211012,20700,20700,0,1,68977,-48277
INJ_401,20211013,6000,3600,2,702,11999,-8399
INJ_401,20211022,33900,28800,0,1,95966,-67166
INJ_401,20211023,32700,32700,0,-2,108968,-76268
INJ_401,20211025,4500,4500,0,-1,14997,-10497
INJ_401,20211026,12600,12600,0,0,41978,-29378
INJ_401,20211027,23100,23100,0,840,88279,-65179
INJ_401,20211028,34500,34500,0,0,100970,-66470
INJ_401,20211029,12300,12300,0,-1,40989,-28689
INJ_401,20211030,34800,34800,0,0,115958,-81158
INJ_401,20211101,37800,37800,0,3,125945,-88145
INJ_401,20211102,14100,14100,0,0,46986,-32886
INJ_401,20211103,17400,17400,0,0,57982,-40582
INJ_401,20211104,41400,39900,0,0,132960,-93060
INJ_401,20211105,24300,21900,0,2,67419,-45519
INJ_401,20211106,18900,18900,0,2,62969,-44069
INJ_401,20211108,35700,35700,0,2,118949,-83249
INJ_401,20211109,24300,23700,0,-1,78974,-55274
INJ_401,20211110,21600,21600,0,1,71978,-50378
INJ_401,20211111,21900,21900,0,0,72966,-51066
INJ_401,20211112,33600,31200,0,1,103936,-72736
INJ_401,20211113,36900,32700,0,1,108979,-76279
INJ_401,20211116,4500,4500,0,0,14992,-10492
INJ_401,20211117,28800,26400,0,0,95943,-69543
INJ_401,20211118,29100,29100,0,0,96945,-67845
INJ_401,20211119,21600,21600,0,0,71970,-50370
INJ_401,20211120,28500,28500,0,0,94957,-66457
INJ_401,20211122,2100,2100,0,1,6994,-4894
INJ_401,20211126,30300,25800,0,1,85972,-60172
INJ_401,20211127,17400,13800,0,-2,37322,-23522
INJ_401,20211129,27600,27600,0,1,91967,-64367
INJ_401,20211130,14700,14700,0,1,48972,-34272
INJ_401,20211201,36000,31200,0,1,103963,-72763
INJ_401,20211202,41100,35100,0,1,107581,-72481
INJ_401,20211203,16800,16800,0,0,55976,-39176
INJ_401,20211204,22200,21300,0,0,70974,-49674
INJ_401,20211206,31800,27000,0,-1,89969,-62969
INJ_401,20211207,34500,32100,0,-2,106968,-74868
INJ_401,20211208,31800,31800,0,2,105975,-74175
INJ_401,20211209,18900,18900,0,-1,62974,-44074
INJ_401,20211210,39900,37200,0,-1,123959,-86759
INJ_401,20211211,24000,21600,0,-1,71970,-50370
INJ_401,20211213,31800,29100,0,-1,96977,-67877
INJ_401,20211214,17700,17700,0,0,58984,-41284
INJ_401,20211215,24300,23400,0,-1,77970,-54570
INJ_401,20211216,14100,14100,0,0,46987,-32887
INJ_401,20211217,40230,40230,0,1,140951,-100721
INJ_401,20211218,15900,11700,0,-1,38992,-27292
INJ_401,20211220,12000,2400,0,0,2812,-412
INJ_401,20211221,33900,33900,0,-1,112960,-79060
INJ_401,20211222,35100,35100,0,1,116963,-81863
INJ_401,20211223,38700,33900,0,2,112947,-79047
INJ_401,20211224,23100,21900,0,1,72966,-51066
INJ_401,20211225,32400,29700,0,0,98958,-69258
INJ_401,20211227,30000,30000,0,0,99961,-69961
INJ_401,20211228,25800,17400,0,1,57876,-40476
INJ_401,20211229,48600,47100,0,1,156937,-109837
INJ_401,20211230,34830,32430,0,-2,107973,-75543
INJ_401,20211231,22800,22800,0,0,75978,-53178
INJ_401,20220101,33900,33000,0,-1,112946,-79946
INJ_401,20220103,38700,36300,0,-2,120953,-84653
INJ_401,20220104,39600,39600,0,1,131955,-92355
INJ_401,20220105,11700,9000,0,1,30226,-21226
INJ_401,20220108,8100,2700,0,0,1886,814
INJ_401,20220122,12600,4200,0,0,2220,1980
INJ_401,20220126,17700,17700,0,-1,58984,-41284
INJ_401,20220127,23700,22500,0,0,74985,-52485
INJ_401,20220128,40500,40500,0,-2,134957,-94457
INJ_401,20220129,61200,54000,0,-2,179956,-125956
INJ_401,20220131,28200,28200,0,1,93982,-65782
INJ_401,20220201,33300,32400,0,0,107979,-75579
INJ_401,20220202,44700,40500,0,-1,134958,-94458
INJ_401,20220203,39600,39600,0,3,131952,-92352
INJ_401,20220204,45000,42600,0,1,141951,-99351
INJ_401,20220205,38700,38700,0,-2,128972,-90272
INJ_401,20220207,29400,29400,0,0,97983,-68583
INJ_401,20220208,43500,42000,0,3,139966,-97966
INJ_401,20220209,33300,33300,0,2,110961,-77661
INJ_401,20220210,30600,30600,0,1,101962,-71362
INJ_401,20220211,15900,15900,0,2,52984,-37084
INJ_401,20220212,49200,49200,0,1,163966,-114766
INJ_401,20220214,40500,40500,0,-1,134979,-94479
INJ_401,20220215,36900,32100,0,-1,106952,-74852
INJ_401,20220216,61500,59100,0,1,196938,-137838
INJ_401,20220217,22530,22530,0,0,74971,-52441
INJ_401,20220218,49200,43200,0,1,143957,-100757
INJ_401,20220219,31500,22500,0,-2,62409,-39909
INJ_401,20220310,7200,3600,0,0,1503,2097
INJ_401,20220923,250,250,0,-1,1996,-1746
INJ_401,20221008,375,375,0,0,2997,-2622
INJ_401,20221014,1000,1000,0,0,7999,-6999
INJ_401,20221015,1000,1000,0,0,7998,-6998
INJ_401,20221025,375,375,0,0,2999,-2624
INJ_401,20221031,500,500,0,0,3999,-3499
INJ_401,20221104,750,750,0,1,5995,-5245
INJ_401,20221123,250,250,0,-1,1998,-1748
INJ_401,20221202,375,375,0,0,2998,-2623
INJ_401,20221203,500,500,0,1,4000,-3500
INJ_401,20221207,1000,1000,0,0,7998,-6998
INJ_401,20221217,250,250,0,-1,1997,-1747
INJ_401,20221219,375,375,0,1,2999,-2624
INJ_401,20230106,750,750,0,0,5998,-5248
INJ_401,20230113,500,500,0,0,3999,-3499
INJ_401,20230114,2125,2125,0,0,16995,-14870
INJ_401,20230119,625,625,0,0,4999,-4374
INJ_401,20230125,375,375,0,0,2999,-2624
INJ_401,20230128,750,750,0,1,6001,-5251
INJ_401,20230202,500,500,0,0,3999,-3499
INJ_401,20230210,2375,2375,0,1,18997,-16622
INJ_401,20230214,1125,1125,0,-1,9003,-7878
INJ_401,20230217,500,500,0,0,3999,-3499
INJ_401,20230221,625,625,0,0,5000,-4375
INJ_401,20230314,13500,10200,0,1,34003,-23803
INJ_401,20230315,375,375,0,0,2999,-2624
INJ_401,20230318,375,375,0,0,3000,-2625
INJ_401,20230323,250,250,0,0,1999,-1749
INJ_401,20230324,500,500,0,1,3998,-3498
INJ_401,20230331,1500,750,0,0,5998,-5248
INJ_401,20230404,375,375,0,1,3001,-2626
INJ_401,20230406,625,625,0,0,5001,-4376
INJ_401,20230411,500,500,0,0,3999,-3499
INJ_401,20230413,250,250,0,0,2002,-1752
INJ_401,20230414,4950,4950,0,-1,20003,-15053
INJ_401,20230420,500,500,0,29,4000,-3500
INJ_401,20230423,375,375,0,0,3000,-2625
INJ_401,20230429,375,375,0,0,2999,-2624
INJ_401,20230503,500,500,0,1,4001,-3501
INJ_401,20230504,3875,875,0,0,6999,-6124
INJ_401,20230505,16500,16500,0,-1,54989,-38489
INJ_401,20230506,9300,5700,0,0,18998,-13298
INJ_401,20230508,43800,41400,0,-1,137983,-96583
INJ_401,20230509,35940,32720,0,1,116990,-84270
INJ_401,20230510,21160,19320,0,0,83998,-64678
INJ_401,20230511,20700,18860,0,0,82006,-63146
INJ_401,20230512,30050,30050,0,3,127009,-96959
INJ_401,20230513,44850,42320,0,6,185992,-143672
INJ_401,20230515,35420,32660,0,2,141992,-109332
INJ_401,20230516,21160,21160,0,1,91992,-70832
INJ_401,20230517,32350,32350,0,1,136997,-104647
INJ_401,20230518,18170,18170,0,1,79009,-60839
INJ_401,20230519,32660,24380,0,-1,109433,-85053
INJ_401,20230520,30820,30820,0,2,133992,-103172
INJ_401,20230522,33810,30130,0,2,130999,-100869
INJ_401,20230523,21850,21850,0,1,95000,-73150
INJ_401,20230524,46230,39790,0,-1,173000,-133210
INJ_401,20230525,36050,32630,0,2,137007,-104377
INJ_401,20230526,33120,33120,0,3,144011,-110891
INJ_401,20230527,47610,36110,-6,-901,157005,-120895
INJ_401,20230529,30640,24660,0,2,106007,-81347
INJ_401,20230530,45540,20470,0,0,88992,-68522
INJ_401,20230602,28860,2220,0,-1,6000,-3780
INJ_401,20230603,7770,1110,0,0,3001,-1891
INJ_401,20230606,23880,23880,0,-1,102018,-78138
INJ_401,20230607,26780,23100,0,0,98013,-74913
INJ_401,20230608,16100,15410,0,0,67020,-51610
INJ_401,20230609,32520,32520,0,1,188028,-155508
INJ_401,20230610,16700,15500,0,2,154993,-139493
INJ_401,20230612,28410,26810,0,-3,259993,-233183
INJ_401,20230613,18060,16460,0,-1,142997,-126537
INJ_401,20230614,15710,13910,0,1,131013,-117103
INJ_401,20230615,17200,15800,0,-2,170956,-155156
INJ_401,20230616,13200,12400,0,2,124020,-111620
INJ_401,20230617,23190,23190,0,1,212851,-189661
INJ_401,20230619,20810,18210,0,0,174612,-156402
INJ_401,20230620,16580,14690,0,-2,154477,-139787
INJ_401,20230621,12200,10500,0,-2,105007,-94507
INJ_401,20230622,11530,10630,0,-2,82004,-71374
INJ_401,20230626,14510,14510,0,-1,137010,-122500
INJ_401,20230627,4100,3000,0,-2,30000,-27000
INJ_401,20230628,31760,28960,0,-5,268006,-239046
INJ_401,20230630,14400,14400,0,1,143977,-129577
INJ_401,20230701,29490,23350,0,1,220006,-196656
INJ_401,20230703,9910,9910,0,0,90990,-81080
INJ_401,20230704,7750,6950,0,-1,56000,-49050
INJ_401,20230705,5400,5400,0,-1,54000,-48600
INJ_401,20230706,11400,10500,0,0,105006,-94506
INJ_401,20230707,17400,13800,0,0,138010,-124210
INJ_401,20230708,18010,17710,0,1,169004,-151294
INJ_401,20230710,10850,10850,0,1,94987,-84137
INJ_401,20230711,13200,9000,0,3,89994,-80994
INJ_401,20230712,28210,22210,0,2,213985,-191775
INJ_401,20230713,14670,12870,0,-2,98998,-86128
INJ_401,20230714,14380,14380,0,0,132991,-118611
INJ_401,20230715,32490,27490,0,2,255995,-228505
INJ_401,20230716,1300,1100,0,0,11002,-9902
INJ_401,20230717,22400,19100,0,0,182021,-162921
INJ_401,20230718,17300,17300,0,1,172989,-155689
INJ_401,20230719,14120,13010,0,0,121992,-108982
INJ_402,20211004,600,600,0,0,1997,-1397
INJ_402,20211009,1200,1200,0,0,3997,-2797
INJ_402,20220126,900,900,0,0,2997,-2097
INJ_402,20220127,6300,6300,0,1,20981,-14681
INJ_402,20220128,10500,10500,0,0,34971,-24471
INJ_402,20220129,12300,10800,0,1,35962,-25162
INJ_402,20220131,3300,3300,0,0,10991,-7691
INJ_402,20220201,6600,6600,0,0,21984,-15384
INJ_402,20220202,9600,9600,0,0,31973,-22373
INJ_402,20220203,5100,5100,0,1,16983,-11883
INJ_402,20220204,6900,6300,0,0,20976,-14676
INJ_402,20220205,11100,11100,0,1,36971,-25871
INJ_402,20220207,7800,7800,0,1,25982,-18182
INJ_402,20220208,6300,6300,0,0,20980,-14680
INJ_402,20220209,10200,10200,0,0,33962,-23762
INJ_402,20220210,5400,5400,0,1,17978,-12578
INJ_402,20220211,1500,1500,0,1,4993,-3493
INJ_402,20220212,11700,11700,0,0,38960,-27260
INJ_402,20220214,8400,8400,0,0,27968,-19568
INJ_402,20220215,12300,10500,0,0,34963,-24463
INJ_402,20220216,18300,17400,0,-1,57948,-40548
INJ_402,20220217,2700,2700,0,0,8992,-6292
INJ_402,20220218,9900,9900,0,2,32973,-23073
INJ_402,20220219,10500,10500,0,-1,34976,-24476
INJ_402,20220716,19500,19500,0,1,64933,-45433
INJ_402,20220718,11400,11400,0,2,37967,-26567
INJ_402,20220719,19200,17400,0,1,57955,-40555
INJ_402,20220720,6600,5400,0,0,17993,-12593
INJ_402,20220721,600,600,0,0,1997,-1397
INJ_402,20220722,4200,4200,0,0,13992,-9792
INJ_402,20220723,900,900,0,0,2997,-2097
INJ_402,20220725,3900,3900,0,0,12989,-9089
INJ_402,20220727,7800,7800,0,0,25975,-18175
INJ_402,20220729,4800,4800,0,1,15986,-11186
INJ_402,20220730,5400,5400,0,1,17980,-12580
INJ_402,20220801,10200,10200,0,0,33973,-23773
INJ_402,20220802,13500,12600,0,0,41945,-29345
INJ_402,20220803,8100,8100,0,0,26976,-18876
INJ_402,20220804,3000,3000,0,1,9985,-6985
INJ_402,20220805,1500,1500,0,0,4990,-3490
INJ_402,20220806,5400,5400,0,-1,17979,-12579
INJ_402,20220808,1500,1500,0,-1,4991,-3491
INJ_402,20220809,5100,3300,0,-1,10995,-7695
INJ_402,20220811,10200,10200,0,1,33977,-23777
INJ_402,20220812,1500,1500,0,-1,4994,-3494
INJ_402,20220813,9000,9000,0,0,29975,-20975
INJ_402,20220814,1800,1800,0,0,5991,-4191
INJ_402,20220815,8400,8400,0,0,27863,-19463
INJ_402,20220816,9600,7800,0,1,30898,-23098
INJ_402,20220817,11100,10500,0,1,34963,-24463
INJ_402,20220818,2700,2700,0,0,8993,-6293
INJ_402,20220819,2700,2700,0,1,8991,-6291
INJ_402,20220820,3600,3600,0,0,11991,-8391
INJ_402,20220822,7800,7800,0,1,25976,-18176
INJ_402,20220823,7200,7200,0,0,23982,-16782
INJ_402,20220824,2700,2700,0,1,8988,-6288
INJ_402,20220826,7200,7200,0,1,23969,-16769
INJ_402,20220827,4800,4800,0,0,15986,-11186
INJ_402,20220901,3300,3300,0,0,10989,-7689
INJ_402,20220902,2400,2400,0,0,7993,-5593
INJ_402,20220903,600,600,0,0,1994,-1394
INJ_402,20220905,2400,2400,0,0,7991,-5591
INJ_402,20220907,2700,2700,0,-1,8989,-6289
INJ_402,20220908,900,900,0,1,2997,-2097
INJ_402,20220910,1500,1500,0,-1,4993,-3493
INJ_402,20220913,2700,2700,0,1,8990,-6290
INJ_402,20220914,1500,1500,0,0,4993,-3493
INJ_402,20220916,1500,1500,1,743,4994,-3494
INJ_402,20220917,4200,4200,-1,-743,5993,-1793
INJ_402,20230322,90600,12900,0,5,42912,-30012
INJ_402,20230323,81600,6300,0,-4,20974,-14674
INJ_402,20230324,102600,8400,0,-5,27966,-19566
INJ_402,20230325,80100,6000,0,-7,19974,-13974
INJ_402,20230327,36300,4800,0,-6,15973,-11173
INJ_402,20230328,22500,3900,0,-3,12972,-9072
INJ_402,20230329,43800,5100,0,-6,16970,-11870
INJ_402,20230330,30900,3300,0,-5,10985,-7685
INJ_402,20230401,6300,900,0,-1,2995,-2095
INJ_402,20230403,26400,4200,0,-4,13975,-9775
INJ_402,20230404,24300,4500,0,-4,11982,-7482
INJ_402,20230405,54000,4800,0,-8,15979,-11179
INJ_402,20230406,8400,1500,0,-1,4990,-3490
INJ_402,20230407,22500,3600,0,-3,11980,-8380
INJ_402,20230408,51900,5700,0,-6,18976,-13276
INJ_402,20230410,14100,2400,0,-3,7985,-5585
INJ_402,20230411,19500,2100,0,-3,6988,-4888
INJ_402,20230412,47700,5700,0,-6,18967,-13267
INJ_402,20230413,16500,1500,0,-2,4994,-3494
INJ_402,20230414,83400,11100,0,-15,36937,-25837
INJ_402,20230415,15000,2400,0,-4,7983,-5583
INJ_402,20230417,18000,3000,0,-3,9977,-6977
INJ_402,20230418,21600,3000,0,-3,9983,-6983
INJ_402,20230419,25800,3000,0,-3,9984,-6984
INJ_402,20230420,46800,3900,0,-5,12985,-9085
INJ_402,20230421,37200,4200,0,-4,13981,-9781
INJ_402,20230423,50700,5100,0,-4,16980,-11880
INJ_402,20230424,51300,6600,0,-5,21963,-15363
INJ_402,20230425,17100,3000,0,-2,9979,-6979
INJ_402,20230426,5400,1200,0,-1,3991,-2791
INJ_402,20230428,38400,3000,0,-4,9430,-6430
INJ_402,20230503,19500,3300,0,-3,10981,-7681
INJ_402,20230504,78900,12000,0,-14,39929,-27929
INJ_402,20230505,47700,5400,0,-4,17974,-12574
INJ_402,20230506,19800,3300,0,-1,10980,-7680
INJ_402,20230508,87300,9000,0,-7,29961,-20961
INJ_402,20230509,31800,3900,0,-5,15977,-12077
INJ_402,20230510,5200,1000,0,-2,4989,-3989
INJ_402,20230511,5200,1000,0,-1,4992,-3992
INJ_402,20230512,3600,600,0,-1,2995,-2395
INJ_402,20230513,56400,5600,0,-7,27963,-22363
INJ_402,20230515,23200,3600,0,-6,17966,-14366
INJ_402,20230516,20000,3000,0,-4,14974,-11974
INJ_402,20230517,43600,3000,0,-4,14983,-11983
INJ_402,20230518,13600,1600,0,0,7991,-6391
INJ_402,20230519,24600,2400,0,-3,12186,-9786
INJ_402,20230520,44000,3600,0,-5,21732,-18132
INJ_402,20230521,13200,6600,0,1,2657,3943
INJ_402,20230522,48800,5800,0,-8,28957,-23157
INJ_402,20230523,27200,3000,0,-2,9983,-6983
INJ_402,20230524,12200,5200,0,1,25952,-20752
INJ_402,20230525,5800,5800,0,3,28949,-23149
INJ_402,20230526,3600,3600,0,1,14971,-11371
INJ_402,20230527,6200,5600,0,1,27939,-22339
INJ_402,20230529,5400,5400,0,2,26953,-21553
INJ_402,20230530,3600,3000,0,-1,14978,-11978
INJ_402,20230531,3600,3600,0,0,17962,-14362
INJ_402,20230601,4400,4400,0,2,21958,-17558
INJ_402,20230602,9600,6400,0,4,31948,-25548
INJ_402,20230603,5400,4800,0,0,23963,-19163
INJ_402,20230605,3400,3400,0,-1,16965,-13565
INJ_402,20230606,4400,4400,0,1,21976,-17576
INJ_402,20230607,11000,9400,0,0,44928,-35528
INJ_402,20230608,4000,4000,0,0,19964,-15964
INJ_402,20230609,3600,3600,0,0,25965,-22365
INJ_402,20230610,2400,2100,0,-1,20961,-18861
INJ_402,20230612,3300,3300,0,1,32949,-29649
INJ_402,20230613,4300,1300,0,-1,12967,-11667
INJ_402,20230614,2200,2200,0,0,21952,-19752
INJ_402,20230615,4600,4300,0,0,45226,-40926
INJ_402,20230616,2000,2000,0,1,19955,-17955
INJ_402,20230617,7300,7300,0,3,66899,-59599
INJ_402,20230619,1400,1400,0,0,13988,-12588
INJ_402,20230620,5100,5100,0,0,50947,-45847
INJ_402,20230621,3300,3300,0,2,32951,-29651
INJ_402,20230622,5700,3700,0,0,21959,-18259
INJ_402,20230623,3000,3000,0,-1,29821,-26821
INJ_402,20230624,3300,3300,0,1,32948,-29648
INJ_402,20230625,200,200,0,0,1994,-1794
INJ_402,20230626,6800,6800,0,1,55931,-49131
INJ_402,20230627,2500,2100,0,0,20974,-18874
INJ_402,20230628,8400,8400,0,0,74892,-66492
INJ_402,20230630,2600,2600,0,0,25959,-23359
INJ_402,20230701,9410,8510,0,-1,84868,-76358
INJ_402,20230703,3800,3800,0,-1,37934,-34134
INJ_402,20230704,2100,1500,0,1,14968,-13468
INJ_402,20230705,3500,3500,0,1,34951,-31451
INJ_402,20230706,4200,3700,0,-1,36930,-33230
INJ_402,20230707,3100,2700,0,0,26942,-24242
INJ_402,20230708,5800,5300,0,-1,52915,-47615
INJ_402,20230710,2600,2600,0,1,25962,-23362
INJ_402,20230711,9500,7200,0,1,71910,-64710
INJ_402,20230712,4300,4100,0,0,40925,-36825
INJ_402,20230713,9800,4100,0,0,31943,-27843
INJ_402,20230714,5300,5300,0,0,52932,-47632
INJ_402,20230715,10600,8800,0,0,87821,-79021
INJ_402,20230716,600,600,0,0,5993,-5393
INJ_402,20230717,4900,4600,0,0,45912,-41312
INJ_402,20230718,2000,2000,0,0,19967,-17967
INJ_402,20230719,5200,5200,0,2,51926,-46726
INJ_403,20210928,24600,21600,11,41,71984,-50384
INJ_403,20210929,39600,39600,0,-1,131977,-92377
INJ_403,20210930,36360,36330,0,0,120967,-84637
INJ_403,20211001,23100,23100,0,-2,66988,-43888
INJ_403,20211002,30000,30000,0,-1,99959,-69959
INJ_403,20211004,35400,35400,0,1,117971,-82571
INJ_403,20211005,19800,16800,0,-2,55978,-39178
INJ_403,20211006,18300,18300,0,0,60985,-42685
INJ_403,20211007,19800,19800,0,1,65986,-46186
INJ_403,20211008,21900,21900,0,-1,72989,-51089
INJ_403,20211009,34200,30000,7,288,99969,-69969
INJ_403,20211011,14700,14700,0,-1,48989,-34289
INJ_403,20211012,29100,29100,0,0,96974,-67874
INJ_403,20211013,7800,4800,11,611,15998,-11198
INJ_403,20211022,30600,24600,0,2,81982,-57382
INJ_403,20211023,30300,30300,0,-1,100983,-70683
INJ_403,20211025,3600,3600,0,-1,11998,-8398
INJ_403,20211026,14100,14100,0,-2,46983,-32883
INJ_403,20211027,21000,21000,1,622,80856,-59856
INJ_403,20211028,38100,38100,0,-1,110974,-72874
INJ_403,20211029,8700,8700,0,-1,28995,-20295
INJ_403,20211030,32100,32100,0,0,106974,-74874
INJ_403,20211101,36900,36900,0,1,122966,-86066
INJ_403,20211102,14700,14700,0,0,48985,-34285
INJ_403,20211103,20100,20100,0,-1,66982,-46882
INJ_403,20211104,36300,36300,0,0,120973,-84673
INJ_403,20211105,27900,24900,0,0,78090,-53190
INJ_403,20211106,19800,19800,0,0,65974,-46174
INJ_403,20211108,35100,35100,0,0,116959,-81859
INJ_403,20211109,22500,22500,0,1,74978,-52478
INJ_403,20211110,22800,22800,0,0,75983,-53183
INJ_403,20211111,22500,22500,0,-2,74969,-52469
INJ_403,20211112,33900,30900,0,0,102952,-72052
INJ_403,20211113,33300,30600,0,0,101978,-71378
INJ_403,20211115,27000,3000,0,-1,6011,-3011
INJ_403,20211116,5400,5400,0,0,17996,-12596
INJ_403,20211117,25500,25500,0,0,84981,-59481
INJ_403,20211118,29100,29100,0,-1,96967,-67867
INJ_403,20211119,21600,21600,0,0,71976,-50376
INJ_403,20211120,33900,33900,0,1,112974,-79074
INJ_403,20211122,1500,1500,0,0,4999,-3499
INJ_403,20211126,29100,21300,0,1,70985,-49685
INJ_403,20211127,17400,12000,0,0,28575,-16575
INJ_403,20211129,24900,24300,0,1,80968,-56668
INJ_403,20211130,13800,13800,0,0,45986,-32186
INJ_403,20211201,27600,25800,0,0,85974,-60174
INJ_403,20211202,27000,27000,0,-1,87398,-60398
INJ_403,20211203,17100,17100,0,2,56987,-39887
INJ_403,20211204,22500,22500,0,-1,74988,-52488
INJ_403,20211206,33000,27000,0,0,89988,-62988
INJ_403,20211207,35100,32100,0,0,106989,-74889
INJ_403,20211208,38700,36900,0,-1,122990,-86090
INJ_403,20211209,19200,17400,0,-1,57990,-40590
INJ_403,20211210,35700,32700,0,0,108982,-76282
INJ_403,20211211,24900,21900,0,2,72986,-51086
INJ_403,20211213,36300,33300,0,-2,110982,-77682
INJ_403,20211214,16200,16200,0,0,53997,-37797
INJ_403,20211215,25500,25500,0,-1,84983,-59483
INJ_403,20211216,12600,12600,0,-1,41993,-29393
INJ_403,20211217,41700,38700,0,-1,140985,-102285
INJ_403,20211218,16200,15300,0,-2,50992,-35692
INJ_403,20211220,15000,3000,0,0,2959,41
INJ_403,20211221,33000,33000,0,-1,109975,-76975
INJ_403,20211222,34800,34800,0,1,115973,-81173
INJ_403,20211223,42600,36600,0,-2,121964,-85364
INJ_403,20211224,28200,23700,0,0,78968,-55268
INJ_403,20211225,34500,31500,0,-2,104971,-73471
INJ_403,20211227,32400,32400,0,1,107969,-75569
INJ_403,20211228,27900,17100,0,0,56991,-39891
INJ_403,20211229,51600,50700,0,-1,168970,-118270
INJ_403,20211230,35100,32100,0,-1,106981,-74881
INJ_403,20211231,23400,23400,0,0,77984,-54584
INJ_403,20220101,31200,31200,0,1,100988,-69788
INJ_403,20220103,40500,37500,0,-1,124973,-87473
INJ_403,20220104,28500,28500,0,0,94980,-66480
INJ_403,20220105,10800,9000,0,0,29761,-20761
INJ_403,20220108,9000,3000,0,0,1906,1094
INJ_403,20220122,8100,2700,0,0,1601,1099
INJ_403,20220126,15900,15900,0,0,52986,-37086
INJ_403,20220127,14400,14400,0,-1,47995,-33595
INJ_403,20220128,37500,37500,0,3,124977,-87477
INJ_403,20220129,60900,53100,0,-1,176967,-123867
INJ_403,20220131,24000,24000,0,0,79989,-55989
INJ_403,20220201,31200,29400,0,1,97991,-68591
INJ_403,20220202,41400,38700,0,-1,128970,-90270
INJ_403,20220203,37500,37500,0,0,124977,-87477
INJ_403,20220204,48000,45000,0,2,149980,-104980
INJ_403,20220205,45600,45600,0,0,151980,-106380
INJ_403,20220207,31200,31200,0,0,103989,-72789
INJ_403,20220208,45600,43800,0,0,145986,-102186
INJ_403,20220209,30900,30900,0,-1,102976,-72076
INJ_403,20220210,27900,27900,0,-1,92983,-65083
INJ_403,20220211,15600,15600,0,0,51995,-36395
INJ_403,20220212,47700,47700,0,3,158977,-111277
INJ_403,20220214,42000,40200,0,-1,133992,-93792
INJ_403,20220215,33300,27300,0,0,90979,-63679
INJ_403,20220216,60300,57300,0,0,190954,-133654
INJ_403,20220217,22500,19500,0,-1,64982,-45482
INJ_403,20220218,43500,43500,0,1,144981,-101481
INJ_403,20220219,29400,21000,0,-1,58805,-37805
INJ_403,20220310,4800,2400,0,-1,1105,1295
INJ_403,20220913,500,500,0,0,3999,-3499
INJ_403,20220919,750,750,0,-1,6000,-5250
INJ_403,20220923,250,250,0,0,1998,-1748
INJ_403,20221014,1250,1250,0,0,9998,-8748
INJ_403,20221028,1750,1750,0,0,13995,-12245
INJ_403,20221102,500,500,0,0,3998,-3498
INJ_403,20221104,250,250,0,0,1999,-1749
INJ_403,20221111,750,750,0,0,5997,-5247
INJ_403,20221119,375,375,0,0,3000,-2625
INJ_403,20221124,500,500,0,0,3998,-3498
INJ_403,20221207,1250,1250,0,0,9998,-8748
INJ_403,20221209,750,750,0,1,5999,-5249
INJ_403,20221215,375,375,0,0,2999,-2624
INJ_403,20221227,1250,1250,0,0,9999,-8749
INJ_403,20230103,1375,1375,0,0,10997,-9622
INJ_403,20230106,250,250,0,0,2000,-1750
INJ_403,20230114,1500,1500,0,1,5000,-3500
INJ_403,20230116,625,625,0,0,4999,-4374
INJ_403,20230120,250,250,0,1,2000,-1750
INJ_403,20230204,500,500,0,-1,4000,-3500
INJ_403,20230210,250,250,0,1,2000,-1750
INJ_403,20230214,750,750,0,0,5998,-5248
INJ_403,20230221,375,375,0,0,3001,-2626
INJ_403,20230222,250,250,0,0,1999,-1749
INJ_403,20230314,10500,8400,0,-1,27996,-19596
INJ_403,20230315,250,250,0,0,2000,-1750
INJ_403,20230316,375,375,0,1,2999,-2624
INJ_403,20230317,375,375,0,0,3000,-2625
INJ_403,20230318,250,250,0,0,2000,-1750
INJ_403,20230322,750,750,0,1,6000,-5250
INJ_403,20230324,250,250,0,-1,1999,-1749
INJ_403,20230329,625,625,0,0,5001,-4376
INJ_403,20230414,5700,5700,0,1,19002,-13302
INJ_403,20230421,250,250,0,0,1999,-1749
INJ_403,20230504,500,500,0,1,3999,-3499
INJ_403,20230505,15600,15600,0,1,51990,-36390
INJ_403,20230506,7350,4575,0,0,16993,-12418
INJ_403,20230508,47700,44100,0,1,146986,-102886
INJ_403,20230509,27490,27490,0,1,96989,-69499
INJ_403,20230510,20390,18090,0,1,74991,-56901
INJ_403,20230511,20010,17710,0,1,77002,-59292
INJ_403,20230512,30590,30590,0,1,133001,-102411
INJ_403,20230513,43930,41630,0,1,178965,-137335
INJ_403,20230515,31280,31280,0,1,135992,-104712
INJ_403,20230516,20700,20700,0,0,89994,-69294
INJ_403,20230517,32890,32890,0,3,142988,-110098
INJ_403,20230518,17480,17480,0,-2,76005,-58525
INJ_403,20230519,26090,20340,0,3,90869,-70529
INJ_403,20230520,29670,29670,0,0,128985,-99315
INJ_403,20230522,38230,33630,0,3,144977,-111347
INJ_403,20230523,21210,21210,0,-1,90996,-69786
INJ_403,20230524,44900,38460,0,0,165997,-127537
INJ_403,20230525,33960,31660,0,2,134001,-102341
INJ_403,20230526,30820,30820,0,0,134001,-103181
INJ_403,20230527,51060,40480,-8,-343,175998,-135518
INJ_403,20230529,29210,22310,0,2,97003,-74693
INJ_403,20230530,61180,19320,0,2,85478,-66158
INJ_403,20230602,3700,740,0,-1,2000,-1260
INJ_403,20230606,25070,24380,0,1,106017,-81637
INJ_403,20230607,34270,27370,0,3,119007,-91637
INJ_403,20230608,17940,17940,0,-1,78008,-60068
INJ_403,20230609,30880,30880,0,4,184017,-153137
INJ_403,20230610,16100,15300,0,6,152980,-137680
INJ_403,20230612,24700,23100,0,4,230967,-207867
INJ_403,20230613,15900,13900,0,2,138992,-125092
INJ_403,20230614,16200,14200,0,5,141989,-127789
INJ_403,20230615,16100,15200,0,1,157367,-142167
INJ_403,20230616,12500,11500,0,4,115011,-103511
INJ_403,20230617,21600,21000,0,7,209997,-188997
INJ_403,20230619,19400,15800,0,3,158001,-142201
INJ_403,20230620,11100,11100,0,0,102521,-91421
INJ_403,20230621,13400,11400,0,1,113999,-102599
INJ_403,20230622,13840,10140,0,-1,68992,-58852
INJ_403,20230626,10090,10090,0,1,82004,-71914
INJ_403,20230627,4400,3400,0,1,33998,-30598
INJ_403,20230628,30540,26240,0,7,256972,-230732
INJ_403,20230630,14000,14000,0,2,139974,-125974
INJ_403,20230701,24000,20400,0,6,203995,-183595
INJ_403,20230703,8300,8300,0,2,82996,-74696
INJ_403,20230704,7000,6000,0,0,60003,-54003
INJ_403,20230705,6710,6710,0,1,58999,-52289
INJ_403,20230706,13240,12240,0,2,117002,-104762
INJ_403,20230707,14600,13100,0,0,131006,-117906
INJ_403,20230708,15100,15100,0,3,150958,-135858
INJ_403,20230710,9610,9610,0,1,87988,-78378
INJ_403,20230711,14800,8500,0,1,84986,-76486
INJ_403,20230712,25140,21640,0,8,210976,-189336
INJ_403,20230713,18020,16020,0,2,116986,-100966
INJ_403,20230714,12800,12800,0,2,127997,-115197
INJ_403,20230715,26300,24500,0,5,244995,-220495
INJ_403,20230716,1500,1500,0,1,15001,-13501
INJ_403,20230717,20810,16910,0,3,151031,-134121
INJ_403,20230718,18350,18350,0,5,169999,-151649
INJ_403,20230719,11300,10700,0,5,107001,-96301
INJ_404,20210927,6900,6300,0,0,125970,-119670
INJ_404,20210928,10100,10100,0,-1,82982,-72882
INJ_404,20210929,13500,10700,0,2,94980,-84280
INJ_404,20210930,6000,6000,1,182,49981,-43981
INJ_404,20211001,9700,8900,0,-2,60974,-52074
INJ_404,20211002,13900,13100,0,2,118952,-105852
INJ_404,20211004,11300,10500,1,105,92974,-82474
INJ_404,20211005,15000,13600,0,3,125959,-112359
INJ_404,20211006,8900,7300,0,-2,72980,-65680
INJ_404,20211007,7000,6200,0,0,61985,-55785
INJ_404,20211008,3000,3000,0,1,24554,-21554
INJ_404,20211009,8700,8700,0,1,80969,-72269
INJ_404,20211011,7700,6900,0,0,68978,-62078
INJ_404,20211014,3600,3600,0,-1,35987,-32387
INJ_404,20211015,8100,8100,1,586,68976,-60876
INJ_404,20211016,12900,12400,0,2,97967,-85567
INJ_404,20211018,10100,10100,0,1,82973,-72873
INJ_404,20211019,6400,6400,0,-1,55990,-49590
INJ_404,20211020,4600,4600,0,1,45984,-41384
INJ_404,20211021,6700,6700,0,3,60977,-54277
INJ_404,20211022,5100,4300,2,145,32991,-28691
INJ_404,20211023,6100,6100,1,70,50982,-44882
INJ_404,20211025,6000,6000,0,0,59977,-53977
INJ_404,20211026,11700,10100,0,0,84961,-74861
INJ_404,20211027,10000,10000,0,0,89961,-79961
INJ_404,20211028,11100,11100,0,2,110966,-99866
INJ_404,20211029,20800,7200,0,0,47987,-40787
INJ_404,20211030,8100,6900,0,1,68974,-62074
INJ_404,20211101,5500,5500,0,0,36988,-31488
INJ_404,20211102,12400,12400,0,-3,95966,-83566
INJ_404,20211103,7800,7800,0,3,67976,-60176
INJ_404,20211104,7500,7500,0,1,62985,-55485
INJ_404,20211105,9300,7900,0,3,69985,-62085
INJ_404,20211106,8400,8400,0,0,77959,-69559
INJ_404,20211108,5900,5300,0,1,52807,-47507
INJ_404,20211109,6100,6100,0,0,60975,-54875
INJ_404,20211110,7800,7800,0,0,77978,-70178
INJ_404,20211111,9300,9000,0,1,89971,-80971
INJ_404,20211112,3000,3000,0,0,29985,-26985
INJ_404,20211113,6000,6000,0,-1,39987,-33987
INJ_404,20211115,8100,8100,0,670,74980,-66880
INJ_404,20211116,6400,5400,0,-1,53978,-48578
INJ_404,20211117,12600,12600,0,1,109956,-97356
INJ_404,20211118,11100,11100,0,2,94962,-83862
INJ_404,20211119,13000,9400,0,-2,81977,-72577
INJ_404,20211120,5500,5500,0,0,42986,-37486
INJ_404,20211122,11400,10900,0,-1,102968,-92068
INJ_404,20211123,11900,11900,0,2,96962,-85062
INJ_404,20211124,3200,3200,0,0,21994,-18794
INJ_404,20211125,7400,7400,0,-1,73969,-66569
INJ_404,20211126,14300,13800,0,0,95982,-82182
INJ_404,20211127,9200,7600,0,1,75981,-68381
INJ_404,20211129,8900,8300,1,450,82961,-74661
INJ_404,20211130,4100,4100,0,1,40988,-36888
INJ_404,20211201,12200,12200,0,-1,109963,-97763
INJ_404,20211202,4700,4700,0,-1,46980,-42280
INJ_404,20211203,11500,10100,0,0,88970,-78870
INJ_404,20211204,6800,6800,0,2,55984,-49184
INJ_404,20211206,4900,4900,0,0,48982,-44082
INJ_404,20211207,7900,7900,0,453,66984,-59084
INJ_404,20211208,6100,6100,0,-1,60988,-54888
INJ_404,20211209,6600,6600,0,1,65973,-59373
INJ_404,20211210,6100,4900,0,-2,48988,-44088
INJ_404,20211211,7400,7400,0,0,63985,-56585
INJ_404,20211213,4900,4900,0,1,48983,-44083
INJ_404,20211214,3000,3000,0,0,29992,-26992
INJ_404,20211215,11100,9700,0,0,96970,-87270
INJ_404,20211216,5900,5300,0,0,52986,-47686
INJ_404,20211217,6600,6600,0,0,59982,-53382
INJ_404,20211218,7500,7500,0,0,74987,-67487
INJ_404,20211220,7800,6200,0,688,61977,-55777
INJ_404,20211221,7500,6100,0,1,48980,-42880
INJ_404,20211222,4500,4500,0,0,44986,-40486
INJ_404,20211223,9900,9900,0,0,98953,-89053
INJ_404,20211224,6000,5200,0,0,51983,-46783
INJ_404,20211225,6500,6500,0,1,48984,-42484
INJ_404,20211227,6100,6100,0,1,60982,-54882
INJ_404,20211228,10700,10700,0,-1,88963,-78263
INJ_404,20211229,6100,6100,0,0,50986,-44886
INJ_404,20211230,5500,5500,0,-1,44983,-39483
INJ_404,20211231,7700,7700,0,0,66989,-59289
INJ_404,20220101,6300,6300,0,0,62986,-56686
INJ_404,20220103,8500,7900,0,2,78965,-71065
INJ_404,20220104,7200,7200,0,0,61981,-54781
INJ_404,20220105,13000,12400,0,0,95971,-83571
INJ_404,20220106,7100,7100,0,0,64981,-57881
INJ_404,20220107,6000,6000,0,1,59981,-53981
INJ_404,20220108,12700,12700,0,1,116971,-104271
INJ_404,20220110,6900,6900,0,0,68978,-62078
INJ_404,20220111,14700,14200,0,-1,125946,-111746
INJ_404,20220112,9700,7400,0,1,74807,-67407
INJ_404,20220113,8100,8100,0,3,80972,-72872
INJ_404,20220114,9600,9600,0,0,89973,-80373
INJ_404,20220115,7400,6600,0,-1,65981,-59381
INJ_404,20220117,12400,12400,0,-1,110199,-97799
INJ_404,20220118,5100,5100,0,1,50989,-45889
INJ_404,20220119,10300,10300,0,2,92978,-82678
INJ_404,20220120,8300,8300,0,1,82963,-74663
INJ_404,20220121,12000,11000,0,0,101953,-90953
INJ_404,20220122,8000,8000,0,0,79969,-71969
INJ_404,20220124,8000,8000,0,2,71984,-63984
INJ_404,20220125,12200,7600,0,2,75982,-68382
INJ_404,20220126,6400,6400,0,1,63986,-57586
INJ_404,20220127,12700,11900,0,0,118976,-107076
INJ_404,20220128,12700,11500,0,0,98962,-87462
INJ_404,20220129,2600,2600,0,0,15994,-13394
INJ_404,20220131,6500,5700,0,4,51096,-45396
INJ_404,20220201,7700,7700,0,1,76984,-69284
INJ_404,20220202,12200,12200,0,0,115965,-103765
INJ_404,20220203,13800,13800,0,-1,105635,-91835
INJ_404,20220204,9110,7910,0,0,79057,-71147
INJ_404,20220205,11110,9710,0,2,96989,-87279
INJ_404,20220207,20500,16400,0,2,125964,-109564
INJ_404,20220208,10900,10900,0,0,104176,-93276
INJ_404,20220209,17200,17200,0,2,135959,-118759
INJ_404,20220210,12100,12100,0,2,108962,-96862
INJ_404,20220211,8700,7900,0,2,78980,-71080
INJ_404,20220212,6800,6800,0,0,61987,-55187
INJ_404,20220214,2700,2700,0,0,26996,-24296
INJ_404,20220215,18500,16100,0,4,134950,-118850
INJ_404,20220216,8300,8300,0,1,82972,-74672
INJ_404,20220217,10500,10500,0,3,104974,-94474
INJ_404,20220218,16100,16100,0,0,148964,-132864
INJ_404,20220219,3200,3200,0,1,31991,-28791
INJ_404,20220221,10800,10800,0,-1,97979,-87179
INJ_404,20220222,11000,9500,0,0,78977,-69477
INJ_404,20220223,9200,8300,0,783,76979,-68679
INJ_404,20220224,8600,8600,0,813,79972,-71372
INJ_404,20220225,11200,10400,0,4,91976,-81576
INJ_404,20220226,8300,8300,0,2,82982,-74682
INJ_404,20220228,3300,3300,0,-1,32993,-29693
INJ_404,20220301,7400,7400,0,0,73988,-66588
INJ_404,20220302,7100,6500,1,15,64988,-58488
INJ_404,20220303,12300,10800,0,-2,114975,-104175
INJ_404,20220304,13500,12700,0,0,108975,-96275
INJ_404,20220305,9900,9900,0,2,98969,-89069
INJ_404,20220307,12300,10800,0,-1,101612,-90812
INJ_404,20220308,7700,7700,0,0,76987,-69287
INJ_404,20220309,7900,7900,0,0,78983,-71083
INJ_404,20220310,6900,6900,0,0,68980,-62080
INJ_404,20220311,5800,5800,0,4,57985,-52185
INJ_404,20220312,9900,9900,0,-1,92977,-83077
INJ_404,20220314,15200,14400,0,-3,143949,-129549
INJ_404,20220315,10100,10100,0,0,100972,-90872
INJ_404,20220316,12500,11300,0,-1,94973,-83673
INJ_404,20220317,9100,9100,0,0,80984,-71884
INJ_404,20220318,11300,11300,0,751,112979,-101679
INJ_404,20220319,8900,7900,0,0,78979,-71079
INJ_404,20220321,10200,10200,0,1,101978,-91778
INJ_404,20220322,9500,8900,0,-1,88985,-80085
INJ_404,20220323,4400,4400,2,727,43987,-39587
INJ_404,20220324,8000,8000,0,2,79986,-71986
INJ_404,20220325,18100,12400,0,2,107986,-95586
INJ_404,20220326,8400,6900,0,1,52982,-46082
INJ_404,20220328,11600,11600,0,-1,109976,-98376
INJ_404,20220329,5200,5200,0,3,45989,-40789
INJ_404,20220330,5240,5230,0,0,52272,-47042
INJ_404,20220331,4050,4050,0,0,32182,-28132
INJ_404,20220401,5900,5900,0,-1,48988,-43088
INJ_404,20220402,3400,3400,0,1,42990,-39590
INJ_404,20220403,900,900,0,0,0,900
INJ_404,20220404,2300,2300,0,0,16997,-14697
INJ_404,20220405,4200,4200,0,-1,13998,-9798
INJ_404,20220406,4310,3510,0,0,35069,-31559
INJ_404,20220407,1800,1800,0,1,7998,-6198
INJ_404,20220408,4200,4200,0,-1,41987,-37787
INJ_404,20220409,3300,3300,1,923,32992,-29692
INJ_404,20220411,1600,1600,0,1,16001,-14401
INJ_404,20220412,1600,1600,0,1,15997,-14397
INJ_404,20220413,3400,3400,0,-1,33991,-30591
INJ_404,20220414,4200,3200,0,0,31989,-28789
INJ_404,20220419,5223,5223,0,1,52075,-46852
INJ_404,20220420,3691,3631,0,-1,36246,-32615
INJ_404,20220421,2910,2910,0,-1,28995,-26085
INJ_404,20220422,4700,4700,0,1,46988,-42288
INJ_404,20220424,6100,6100,0,0,60979,-54879
INJ_404,20220425,3300,3300,0,0,32995,-29695
INJ_404,20220426,4900,4900,0,1,48993,-44093
INJ_404,20220427,1700,1700,0,0,16998,-15298
INJ_404,20220428,1400,1400,0,0,13998,-12598
INJ_404,20220429,5600,5600,0,1,47988,-42388
INJ_404,20220504,3800,3800,0,0,37991,-34191
INJ_404,20220505,3300,3300,0,0,32997,-29697
INJ_404,20220509,3000,3000,0,0,29997,-26997
INJ_404,20220510,1400,1400,0,0,13992,-12592
INJ_404,20220511,1400,1400,0,0,13997,-12597
INJ_404,20220516,2300,1700,0,1,16997,-15297
INJ_404,20220518,3130,3110,0,-1,30987,-27877
INJ_404,20220519,1700,1700,0,1,16992,-15292
INJ_404,20220523,4600,3400,0,-1,33990,-30590
INJ_404,20220524,1400,1400,0,0,13999,-12599
INJ_404,20220525,1400,1400,0,-1,13997,-12597
INJ_404,20220526,3000,3000,0,0,29994,-26994
INJ_404,20220527,1800,1100,0,0,10997,-9897
INJ_404,20220528,6500,6500,0,1,64988,-58488
INJ_404,20220530,5920,5910,0,1,58989,-53079
INJ_404,20220531,4100,4100,0,0,44793,-40693
INJ_404,20220601,6890,6890,0,0,64970,-58080
INJ_404,20220603,6810,5210,0,1,52055,-46845
INJ_404,20220604,7100,6300,0,2,62987,-56687
INJ_404,20220607,10100,4900,0,0,50725,-45825
INJ_404,20220608,9300,7100,0,2,92971,-85871
INJ_404,20220609,4500,4500,0,0,44986,-40486
INJ_404,20220610,2300,1700,0,1,16995,-15295
INJ_404,20220611,10210,9410,0,-3,94056,-84646
INJ_404,20220613,8250,7450,0,0,66974,-59524
INJ_404,20220614,2300,2300,0,0,13996,-11696
INJ_404,20220615,5250,5250,0,0,47986,-42736
INJ_404,20220616,3000,1400,0,2,13999,-12599
INJ_404,20220617,3700,2900,0,-1,28992,-26092
INJ_404,20220618,5250,5250,0,0,47977,-42727
INJ_404,20220620,3700,3700,0,0,27993,-24293
INJ_404,20220622,5750,5150,0,0,46979,-41829
INJ_404,20220623,6450,6450,0,1,59975,-53525
INJ_404,20220624,3850,3850,0,-1,30986,-27136
INJ_404,20220627,4000,4000,0,0,39991,-35991
INJ_404,20220628,7200,6900,0,1,68982,-62082
INJ_404,20220629,3300,3300,0,1,32993,-29693
INJ_404,20220630,8550,8550,0,1,80986,-72436
INJ_404,20220701,9050,8250,0,1,77986,-69736
INJ_404,20220702,3200,3200,0,-1,31991,-28791
INJ_404,20220704,4500,4500,0,2,44990,-40490
INJ_404,20220705,6510,6510,0,1,64975,-58465
INJ_404,20220706,7700,7700,0,2,76982,-69282
INJ_404,20220707,3400,3400,0,0,33990,-30590
INJ_404,20220709,3600,3000,0,0,29992,-26992
INJ_404,20220712,3100,3100,0,-1,30989,-27889
INJ_404,20220713,1400,1400,0,0,13995,-12595
INJ_404,20220716,5900,5900,0,2,31992,-26092
INJ_404,20220718,5050,5050,0,-1,30990,-25940
INJ_404,20220719,1500,1500,0,0,15001,-13501
INJ_404,20220720,5800,4100,0,-1,40992,-36892
INJ_404,20220721,7800,2200,0,-1,21870,-19670
INJ_404,20220722,15800,4500,0,0,44578,-40078
INJ_404,20220723,7200,1600,0,1,15758,-14158
INJ_404,20220725,7200,2800,0,0,27987,-25187
INJ_404,20220726,6510,1910,0,1,19073,-17163
INJ_404,20220727,1600,800,0,0,7997,-7197
INJ_404,20220728,3400,1300,0,1,12999,-11699
INJ_404,20220730,4200,1400,0,1,13997,-12597
INJ_404,20220801,25200,4700,0,-1,34764,-30064
INJ_404,20220802,1500,900,0,0,7624,-6724
INJ_404,20220803,16800,5800,0,-2,54981,-49181
INJ_404,20220804,4400,2700,0,-1,26993,-24293
INJ_404,20220805,6350,6350,0,2,58978,-52628
INJ_404,20220806,4450,3450,0,-1,29994,-26544
INJ_404,20220808,5500,5500,0,0,54987,-49487
INJ_404,20220809,4450,4450,0,0,33986,-29536
INJ_404,20220810,1800,1800,0,-1,17991,-16191
INJ_404,20220811,5620,5620,0,3,56076,-50456
INJ_404,20220812,4060,4060,0,0,36067,-32007
INJ_404,20220813,4450,4450,0,0,39984,-35534
INJ_404,20220816,1400,1400,0,0,13994,-12594
INJ_404,20220817,3400,3400,0,-1,33997,-30597
INJ_404,20220818,3550,3550,0,1,30990,-27440
INJ_404,20220819,7800,7000,0,3,69985,-62985
INJ_404,20220820,5600,5600,0,-1,55984,-50384
INJ_404,20220822,4300,4300,0,-1,27987,-23687
INJ_404,20220824,6450,6450,0,0,59973,-53523
INJ_404,20220825,1850,1850,0,1,13993,-12143
INJ_404,20220826,1600,1600,0,-1,15993,-14393
INJ_404,20220827,1600,1600,0,0,15994,-14394
INJ_404,20220829,6600,6600,0,0,65988,-59388
INJ_404,20220830,5950,5950,0,1,54987,-49037
INJ_404,20220831,3400,2800,1,239,27994,-25194
INJ_404,20220901,4600,4600,0,0,45978,-41378
INJ_404,20220903,23300,3800,0,1,8486,-4686
INJ_404,20220905,4000,800,0,0,3742,-2942
INJ_404,20220908,1700,1700,0,0,16996,-15296
INJ_404,20220909,5100,5100,0,1,50985,-45885
INJ_404,20220910,1800,1800,0,0,17996,-16196
INJ_404,20220913,2800,2800,0,694,27994,-25194
INJ_404,20220914,5550,5550,0,0,50977,-45427
INJ_404,20220915,1700,1700,0,1,16997,-15297
INJ_404,20220916,6950,6950,0,3,64979,-58029
INJ_404,20220917,3700,3700,0,0,36991,-33291
INJ_404,20220919,5110,5110,0,1,45075,-39965
INJ_404,20220920,4400,3600,0,0,35993,-32393
INJ_404,20220921,1600,1600,0,0,15998,-14398
INJ_404,20220922,3400,3400,0,0,33988,-30588
INJ_404,20220923,3100,3100,0,0,30990,-27890
INJ_404,20220924,9950,9950,0,-3,91970,-82020
INJ_404,20220926,5100,5100,0,0,50984,-45884
INJ_404,20220928,1400,1400,0,-1,13999,-12599
INJ_404,20220929,4310,4310,0,1,43043,-38733
INJ_404,20220930,1600,1600,0,1,15998,-14398
INJ_404,20221001,1700,1700,0,0,16998,-15298
INJ_404,20221004,2900,2900,0,1,28997,-26097
INJ_404,20221005,2150,2150,0,0,13992,-11842
INJ_404,20221006,1100,1100,0,0,10997,-9897
INJ_404,20221007,1900,1900,1,113,28992,-27092
INJ_404,20221008,7850,6850,0,-602,44991,-38141
INJ_404,20221010,2150,2150,0,0,16997,-14847
INJ_404,20221011,900,500,0,-1,8998,-8498
INJ_404,20221012,1400,1400,0,1,13994,-12594
INJ_404,20221013,1850,1850,0,0,10998,-9148
INJ_404,20221014,4500,4500,0,0,44993,-40493
INJ_404,20221015,900,900,0,0,8993,-8093
INJ_404,20221017,8600,8600,0,0,76964,-68364
INJ_404,20221019,7200,6600,0,2,65981,-59381
INJ_404,20221021,8500,8500,0,-3,69986,-61486
INJ_404,20221022,3900,3300,0,1,32991,-29691
INJ_404,20221024,4400,4400,0,0,43985,-39585
INJ_404,20221025,2800,2800,0,0,28060,-25260
INJ_404,20221026,4900,4100,0,1,32994,-28894
INJ_404,20221027,5350,5350,0,0,45981,-40631
INJ_404,20221028,5850,5850,0,0,53991,-48141
INJ_404,20221029,2500,2500,0,0,24990,-22490
INJ_404,20221031,4150,3150,0,1,23998,-20848
INJ_404,20221101,1850,1850,0,-1,13990,-12140
INJ_404,20221102,6100,5100,0,0,31988,-26888
INJ_404,20221103,3100,3100,0,-1,30989,-27889
INJ_404,20221104,1900,1900,0,0,18994,-17094
INJ_404,20221105,5600,5000,0,1,49989,-44989
INJ_404,20221107,4700,4700,0,1,46992,-42292
INJ_404,20221109,1400,1400,0,0,13997,-12597
INJ_404,20221110,2400,2400,0,1,23993,-21593
INJ_404,20221111,1600,1600,0,0,15995,-14395
INJ_404,20221112,3000,3000,0,-1,29988,-26988
INJ_404,20221114,2700,2700,0,2,26990,-24290
INJ_404,20221115,2500,2500,0,-1,24988,-22488
INJ_404,20221116,1800,1800,0,1,17995,-16195
INJ_404,20221118,1400,1400,0,0,13995,-12595
INJ_404,20221119,3110,3110,0,-1,31088,-27978
INJ_404,20221121,4000,3000,0,1,29996,-26996
INJ_404,20221122,1400,1400,0,0,13998,-12598
INJ_404,20221123,4810,4810,0,0,48044,-43234
INJ_404,20221124,4800,4200,0,0,41986,-37786
INJ_404,20221125,3600,3600,0,1,35986,-32386
INJ_404,20221126,3550,3550,0,1,27991,-24441
INJ_404,20221128,4600,4600,0,-1,45997,-41397
INJ_404,20221129,1400,1400,0,0,13999,-12599
INJ_404,20221130,3300,3300,0,0,32995,-29695
INJ_404,20221202,2400,2400,0,1,23996,-21596
INJ_404,20221203,5200,5200,0,0,51988,-46788
INJ_404,20221205,7550,7550,0,1,61989,-54439
INJ_404,20221206,1600,1600,0,1,15996,-14396
INJ_404,20221207,4400,4400,0,0,43992,-39592
INJ_404,20221208,1900,1900,0,-1,18992,-17092
INJ_404,20221210,1600,1600,0,0,15997,-14397
INJ_404,20221212,3000,3000,0,1,29998,-26998
INJ_404,20221213,1600,1600,0,1,15997,-14397
INJ_404,20221216,4500,4500,0,0,44992,-40492
INJ_404,20221217,3000,3000,0,0,29991,-26991
INJ_404,20221219,1400,1400,0,-1,13995,-12595
INJ_404,20221220,3100,3100,0,0,30989,-27889
INJ_404,20221221,1500,1500,0,0,14996,-13496
INJ_404,20221222,1400,1400,0,0,13994,-12594
INJ_404,20221226,4600,4600,0,1,45993,-41393
INJ_404,20221227,3300,3300,0,-1,32993,-29693
INJ_404,20221230,2600,2600,0,2,25995,-23395
INJ_404,20221231,3300,3300,0,-2,32992,-29692
INJ_404,20230102,3300,3300,0,1,32998,-29698
INJ_404,20230103,9700,8900,0,4,88990,-80090
INJ_404,20230104,9250,8450,0,399,90813,-82363
INJ_404,20230105,5700,4700,0,2,32001,-27301
INJ_404,20230106,9500,8700,0,-2,87001,-78301
INJ_404,20230107,8550,8550,0,1,80860,-72310
INJ_404,20230109,2800,2800,0,0,28002,-25202
INJ_404,20230110,8950,8950,0,0,85001,-76051
INJ_404,20230111,6200,6200,0,1,62004,-55804
INJ_404,20230112,5450,5450,0,1,47008,-41558
INJ_404,20230113,7950,7950,0,-1,75001,-67051
INJ_404,20230114,6450,5050,0,2,46000,-40950
INJ_404,20230116,4000,4000,0,0,40001,-36001
INJ_404,20230117,1400,1400,0,0,14000,-12600
INJ_404,20230118,4700,4700,0,-2,47001,-42301
INJ_404,20230119,3300,3300,0,1,32995,-29695
INJ_404,20230120,10600,10600,0,-1,94003,-83403
INJ_404,20230121,6000,6000,0,0,60000,-54000
INJ_404,20230123,9800,9800,0,0,98001,-88201
INJ_404,20230124,13000,13000,0,3,108998,-95998
INJ_404,20230125,8800,7500,0,1,69012,-61512
INJ_404,20230126,1600,1600,0,1,16000,-14400
INJ_404,20230127,3300,3300,0,-2,33005,-29705
INJ_404,20230128,5400,5400,0,0,54002,-48602
INJ_404,20230130,7450,6850,0,2,60996,-54146
INJ_404,20230131,6400,5000,0,1,49996,-44996
INJ_404,20230201,4600,4600,0,0,46007,-41407
INJ_404,20230202,9650,9650,0,0,91994,-82344
INJ_404,20230203,7800,7800,0,2,77989,-70189
INJ_404,20230204,6300,6300,0,1,62998,-56698
INJ_404,20230206,11100,9400,0,-1,93996,-84596
INJ_404,20230207,10100,9300,0,-3,80988,-71688
INJ_404,20230208,7200,7200,0,0,59995,-52795
INJ_404,20230209,5150,5150,0,0,46995,-41845
INJ_404,20230210,8200,8200,0,1,66990,-58790
INJ_404,20230211,5100,4600,0,0,46001,-41401
INJ_404,20230213,3300,3300,0,0,33002,-29702
INJ_404,20230214,37000,5000,0,11,49996,-44996
INJ_404,20230215,4900,4900,0,1,39998,-35098
INJ_404,20230216,11000,11000,0,-1,110005,-99005
INJ_404,20230217,7000,7000,0,0,70008,-63008
INJ_404,20230218,4700,4700,0,1,47009,-42309
INJ_404,20230220,5050,5050,0,1,46005,-40955
INJ_404,20230221,6900,6400,0,2,64005,-57605
INJ_404,20230222,7800,6400,0,0,64010,-57610
INJ_404,20230223,5000,5000,0,0,50003,-45003
INJ_404,20230224,2900,2900,0,-1,17002,-14102
INJ_404,20230227,3000,3000,0,1,30001,-27001
INJ_404,20230228,6300,5100,0,-2,51001,-45901
INJ_404,20230301,7250,7250,0,-1,68000,-60750
INJ_404,20230303,6800,6800,0,-1,68006,-61206
INJ_404,20230304,5100,5100,0,0,51005,-45905
INJ_404,20230306,6800,6800,0,1,67995,-61195
INJ_404,20230307,6700,6000,0,0,59999,-53999
INJ_404,20230308,3200,3200,0,0,32003,-28803
INJ_404,20230309,6900,6900,0,2,69003,-62103
INJ_404,20230310,7800,7800,0,-1,77997,-70197
INJ_404,20230311,8700,8700,0,0,81009,-72309
INJ_404,20230313,15200,12500,0,2,124982,-112482
INJ_404,20230314,11510,5410,0,2,44999,-39589
INJ_404,20230315,8300,7500,0,2,75000,-67500
INJ_404,20230316,10450,10450,0,-1,76001,-65551
INJ_404,20230317,14750,14750,0,0,98006,-83256
INJ_404,20230318,8500,8500,0,-1,60996,-52496
INJ_404,20230320,22250,21650,0,3,163991,-142341
INJ_404,20230321,14400,11300,0,-1,88998,-77698
INJ_404,20230322,10500,6100,0,0,61004,-54904
INJ_404,20230323,12710,10110,0,2,101008,-90898
INJ_404,20230324,15650,15650,0,4,82997,-67347
INJ_404,20230325,15950,12850,0,1,96993,-84143
INJ_404,20230327,6200,5900,0,0,28997,-23097
INJ_404,20230328,14000,14000,0,2,80006,-66006
INJ_404,20230329,9800,9800,0,1,97987,-88187
INJ_404,20230330,18550,15950,0,1,107994,-92044
INJ_404,20230331,9700,8200,0,0,81992,-73792
INJ_404,20230401,13100,6050,0,-1,40996,-34946
INJ_404,20230403,37500,16750,0,0,94297,-77547
INJ_404,20230404,23900,13400,0,2,86558,-73158
INJ_404,20230405,80200,9600,0,1,96003,-86403
INJ_404,20230406,21700,14100,0,-2,80997,-66897
INJ_404,20230407,29150,23650,0,0,136005,-112355
INJ_404,20230408,24800,18750,0,-1,131989,-113239
INJ_404,20230410,22550,8750,0,-1,60374,-51624
INJ_404,20230411,6850,6850,0,3,64002,-57152
INJ_404,20230412,23100,16600,0,5,121002,-104402
INJ_404,20230413,15600,10300,0,-1,74011,-63711
INJ_404,20230414,8400,6350,0,1,56008,-49658
INJ_404,20230415,8350,6950,0,2,65004,-58054
INJ_404,20230417,12700,7900,0,0,78994,-71094
INJ_404,20230418,12800,8850,0,2,62992,-54142
INJ_404,20230419,48800,20050,0,1,115823,-95773
INJ_404,20230420,28800,17050,0,31,96772,-79722
INJ_404,20230421,26200,10750,0,0,85310,-74560
INJ_404,20230424,35900,7000,0,1,47856,-40856
INJ_404,20230425,27400,13150,0,-1,82781,-69631
INJ_404,20230426,34400,7600,0,2,56846,-49246
INJ_404,20230427,18200,10800,0,1,71994,-61194
INJ_404,20230428,37200,13700,0,1,97355,-83655
INJ_404,20230429,10900,6000,0,-1,51998,-45998
INJ_404,20230501,2000,1400,0,1,13999,-12599
INJ_404,20230502,21800,8550,0,-1,39857,-31307
INJ_404,20230503,21100,7350,0,1,46078,-38728
INJ_404,20230504,13900,7600,0,-1,75991,-68391
INJ_404,20230505,7500,3000,0,0,29996,-26996
INJ_404,20230506,68850,13650,0,3,96387,-82737
INJ_404,20230508,14950,6450,0,-1,41993,-35543
INJ_404,20230509,28300,4600,0,-1,41823,-37223
INJ_404,20230510,119550,14400,0,1,100111,-85711
INJ_404,20230511,28650,7800,0,1,58454,-50654
INJ_404,20230512,38600,5800,0,-1,34793,-28993
INJ_404,20230513,57800,7900,0,0,40079,-32179
INJ_404,20230515,52450,5950,0,0,29254,-23304
INJ_404,20230516,12000,2000,0,3,10230,-8230
INJ_404,20230517,67250,9350,0,-1,62832,-53482
INJ_404,20230518,33300,4950,0,1,39002,-34052
INJ_404,20230519,48750,5150,0,4,36134,-30984
INJ_404,20230520,73250,8350,0,-1,62855,-54505
INJ_404,20230522,26900,4200,0,2,32277,-28077
INJ_404,20230523,28450,5350,0,1,26713,-21363
INJ_404,20230524,21400,2300,0,2,14003,-11703
INJ_404,20230525,16600,2200,0,-1,21999,-19799
INJ_404,20230526,43100,7950,0,5,38023,-30073
INJ_404,20230527,45200,5900,0,2,37037,-31137
INJ_404,20230529,31200,5000,0,3,32166,-27166
INJ_404,20230530,26900,3500,0,0,22373,-18873
INJ_404,20230531,22900,3300,0,-1,11179,-7879
INJ_404,20230601,39800,5100,0,0,19968,-14868
INJ_404,20230602,78400,8450,0,1,47140,-38690
INJ_404,20230603,63000,8650,0,0,50750,-42100
INJ_404,20230605,61300,8150,0,0,40281,-32131
INJ_404,20230606,26800,3200,0,0,27712,-24512
INJ_404,20230607,67200,7700,0,3,53011,-45311
INJ_404,20230608,49600,9600,0,1,63415,-53815
INJ_404,20230609,47300,4300,0,2,25333,-21033
INJ_404,20230610,22200,4000,0,0,26267,-22267
INJ_404,20230612,24000,2800,0,1,23254,-20454
INJ_404,20230613,8450,8450,0,1,76994,-68544
INJ_404,20230614,16300,15000,0,2,99006,-84006
INJ_404,20230615,8900,7900,0,1,64006,-56106
INJ_404,20230616,24900,11650,0,0,56321,-44671
INJ_404,20230617,17950,14800,0,4,121669,-106869
INJ_404,20230619,7900,6200,0,2,60387,-54187
INJ_404,20230620,36013,9863,0,0,61010,-51147
INJ_404,20230621,35600,3900,0,2,20465,-16565
INJ_404,20230622,30000,4100,0,1,40998,-36898
INJ_404,20230623,57500,8850,0,0,54015,-45165
INJ_404,20230624,75710,10560,0,1,70367,-59807
INJ_404,20230626,43100,6300,0,-1,36835,-30535
INJ_404,20230627,36700,9100,0,1,41843,-32743
INJ_404,20230628,35750,5250,0,1,20879,-15629
INJ_404,20230630,36950,7350,0,0,16458,-9108
INJ_404,20230701,33000,5000,0,0,19615,-14615
INJ_404,20230703,22450,4350,0,1,27754,-23404
INJ_404,20230704,54200,7100,0,1,52493,-45393
INJ_404,20230705,41450,7550,0,2,57420,-49870
INJ_404,20230706,17700,2100,0,0,18726,-16626
INJ_404,20230707,40500,6000,0,-1,12434,-6434
INJ_404,20230708,37000,6250,0,0,44648,-38398
INJ_404,20230710,19500,3000,0,1,12569,-9569
INJ_404,20230711,11800,3200,0,0,13556,-10356
INJ_404,20230712,13250,2350,0,-1,8763,-6413
INJ_404,20230713,44700,5250,0,3,26642,-21392
INJ_404,20230714,48500,3800,0,2,38000,-34200
INJ_404,20230715,76500,6300,0,1,35997,-29697
INJ_404,20230717,181750,14350,0,2,78397,-64047
INJ_404,20230718,31600,3800,0,5,29330,-25530
INJ_404,20230719,17400,2800,0,-2,19198,-16398
INJ_405,20210927,1875,1875,0,0,18980,-17105
INJ_405,20210928,9375,9375,0,1,24981,-15606
INJ_405,20210929,7500,4875,0,0,12990,-8115
INJ_405,20210930,1500,1500,0,0,3996,-2496
INJ_405,20211001,9000,9000,0,-1,23984,-14984
INJ_405,20211002,4875,3000,0,0,7995,-4995
INJ_405,20211004,4500,4500,0,0,11989,-7489
INJ_405,20211005,6750,5250,0,1,13991,-8741
INJ_405,20211006,5250,5250,0,0,13990,-8740
INJ_405,20211007,7875,7875,0,0,20987,-13112
INJ_405,20211008,1125,1125,0,0,2997,-1872
INJ_405,20211009,5250,5250,0,314,13992,-8742
INJ_405,20211011,3375,3375,0,0,8995,-5620
INJ_405,20211012,1875,1875,0,1,4997,-3122
INJ_405,20211014,1875,1875,8,255,4995,-3120
INJ_405,20211015,7875,7875,0,0,20988,-13113
INJ_405,20211016,7875,7875,0,0,20987,-13112
INJ_405,20211018,3750,3750,0,0,9994,-6244
INJ_405,20211019,7500,7500,0,-1,19987,-12487
INJ_405,20211020,1125,1125,0,0,2997,-1872
INJ_405,20211021,4875,4875,0,1,12992,-8117
INJ_405,20211022,3750,2625,0,-1,6994,-4369
INJ_405,20211023,1500,1500,0,0,3998,-2498
INJ_405,20211025,6000,6000,0,-1,15989,-9989
INJ_405,20211026,13125,9375,0,-1,24983,-15608
INJ_405,20211027,1500,1500,0,0,3998,-2498
INJ_405,20211028,2250,2250,0,0,5994,-3744
INJ_405,20211029,4875,4875,0,0,12992,-8117
INJ_405,20211030,1875,1875,0,0,4997,-3122
INJ_405,20211101,2250,2250,0,0,5996,-3746
INJ_405,20211102,7125,7125,0,0,18986,-11861
INJ_405,20211103,3375,3375,0,0,8993,-5618
INJ_405,20211104,3000,3000,0,-1,7994,-4994
INJ_405,20211105,6000,6000,0,1,15986,-9986
INJ_405,20211109,3000,3000,0,0,7994,-4994
INJ_405,20211110,3000,3000,0,0,7994,-4994
INJ_405,20211111,9000,9000,0,0,23985,-14985
INJ_405,20211112,3750,3750,0,0,9993,-6243
INJ_405,20211113,3375,3375,0,0,8995,-5620
INJ_405,20211115,3375,3375,0,0,8994,-5619
INJ_405,20211116,3750,3750,0,0,9994,-6244
INJ_405,20211117,10125,10125,0,0,26981,-16856
INJ_405,20211118,8250,8250,0,0,21990,-13740
INJ_405,20211119,3750,3750,0,-1,9994,-6244
INJ_405,20211120,4875,4875,0,1,12993,-8118
INJ_405,20211122,9375,9375,0,1,24983,-15608
INJ_405,20211123,4500,3375,0,1,8992,-5617
INJ_405,20211124,3375,3375,0,0,8995,-5620
INJ_405,20211125,3750,3750,0,0,9994,-6244
INJ_405,20211126,5625,5625,0,0,14990,-9365
INJ_405,20211127,7125,4875,0,6,12991,-8116
INJ_405,20211129,1500,1500,0,0,3997,-2497
INJ_405,20211130,3000,3000,0,0,7994,-4994
INJ_405,20211201,8250,8250,0,0,21982,-13732
INJ_405,20211202,1500,1500,0,0,3998,-2498
INJ_405,20211204,2625,2625,0,0,6994,-4369
INJ_405,20211206,1500,1500,0,0,3997,-2497
INJ_405,20211207,1125,1125,0,5,2996,-1871
INJ_405,20211208,3375,3375,0,1,8994,-5619
INJ_405,20211209,1875,1875,0,0,4996,-3121
INJ_405,20211210,3375,3375,0,-1,8994,-5619
INJ_405,20211213,1500,1500,0,4,3997,-2497
INJ_405,20211214,1500,1500,0,0,3997,-2497
INJ_405,20211215,3000,3000,0,0,7994,-4994
INJ_405,20211216,3000,3000,0,0,7994,-4994
INJ_405,20211217,4125,4125,0,24,10995,-6870
INJ_405,20211218,6750,6750,0,-1,17987,-11237
INJ_405,20211220,3750,3750,0,1,9990,-6240
INJ_405,20211221,2250,1125,0,0,2996,-1871
INJ_405,20211222,3000,3000,0,0,7994,-4994
INJ_405,20211223,1875,1875,0,1,4997,-3122
INJ_405,20211224,1875,1875,0,0,4996,-3121
INJ_405,20211225,5250,5250,0,1,13989,-8739
INJ_405,20211227,5625,5625,0,0,14990,-9365
INJ_405,20211228,7125,7125,0,0,18983,-11858
INJ_405,20211229,2250,2250,0,0,5997,-3747
INJ_405,20211230,3000,3000,0,0,7994,-4994
INJ_405,20211231,3750,3750,0,1,9993,-6243
INJ_405,20220101,3375,3375,0,-1,8994,-5619
INJ_405,20220103,4125,4125,0,0,10994,-6869
INJ_405,20220104,3750,3750,0,-1,9994,-6244
INJ_405,20220105,7500,7500,0,-1,19989,-12489
INJ_405,20220106,5250,5250,0,1,13990,-8740
INJ_405,20220107,6000,6000,0,0,15991,-9991
INJ_405,20220108,7125,7125,0,-1,18989,-11864
INJ_405,20220111,4875,4875,0,0,12991,-8116
INJ_405,20220112,7875,6750,0,0,20150,-13400
INJ_405,20220113,5625,5625,0,1,14991,-9366
INJ_405,20220114,2625,2625,0,0,6995,-4370
INJ_405,20220115,3000,3000,0,0,7993,-4993
INJ_405,20220117,7875,7875,0,0,16993,-9118
INJ_405,20220119,1500,1500,0,0,3998,-2498
INJ_405,20220120,3375,3375,0,0,8994,-5619
INJ_405,20220121,3750,3750,0,0,9988,-6238
INJ_405,20220122,6375,6375,0,-1,16987,-10612
INJ_405,20220124,2250,2250,0,0,5994,-3744
INJ_405,20220125,7125,7125,0,-1,18988,-11863
INJ_405,20220126,2250,2250,0,0,5994,-3744
INJ_405,20220127,6750,4875,0,-1,12992,-8117
INJ_405,20220128,9000,9000,0,1,23982,-14982
INJ_405,20220129,1500,1500,0,0,3997,-2497
INJ_405,20220131,2250,2250,0,0,858,1392
INJ_405,20220201,1500,1500,0,0,3997,-2497
INJ_405,20220202,4125,4125,0,0,10993,-6868
INJ_405,20220203,8250,8250,0,-2,21985,-13735
INJ_405,20220204,4125,4125,0,0,10993,-6868
INJ_405,20220205,6750,5250,0,0,13992,-8742
INJ_405,20220207,9750,7500,0,0,19986,-12486
INJ_405,20220208,1875,1875,0,0,4997,-3122
INJ_405,20220209,5250,5250,0,1,13989,-8739
INJ_405,20220210,6000,6000,0,0,15987,-9987
INJ_405,20220211,5250,5250,0,-1,13990,-8740
INJ_405,20220212,2625,2625,0,0,6994,-4369
INJ_405,20220214,2250,2250,0,0,5994,-3744
INJ_405,20220215,13500,9750,0,0,25982,-16232
INJ_405,20220216,4125,4125,0,0,10994,-6869
INJ_405,20220217,11625,11625,0,-1,30981,-19356
INJ_405,20220218,6750,6750,0,-1,17985,-11235
INJ_405,20220219,3000,3000,0,0,7995,-4995
INJ_405,20220221,2250,2250,0,0,5994,-3744
INJ_405,20220222,1500,1500,0,1,3997,-2497
INJ_405,20220223,6000,6000,0,-1,15992,-9992
INJ_405,20220224,3375,3375,0,0,8995,-5620
INJ_405,20220225,6000,6000,0,-1,15985,-9985
INJ_405,20220226,4125,4125,0,5,10995,-6870
INJ_405,20220228,3375,3375,0,0,8994,-5619
INJ_405,20220301,6000,6000,0,-1,15992,-9992
INJ_405,20220302,3375,2250,0,1,5994,-3744
INJ_405,20220303,3000,3000,0,-1,7993,-4993
INJ_405,20220304,10500,10500,0,0,27980,-17480
INJ_405,20220305,4875,4875,0,-1,12989,-8114
INJ_405,20220307,7500,7500,0,-1,19986,-12486
INJ_405,20220308,5625,5625,0,0,14985,-9360
INJ_405,20220309,3750,3750,0,-1,9995,-6245
INJ_405,20220310,1125,1125,0,0,2996,-1871
INJ_405,20220311,5625,5625,0,1,14993,-9368
INJ_405,20220312,6750,6750,0,0,17989,-11239
INJ_405,20220314,7875,6375,0,0,16986,-10611
INJ_405,20220315,1500,1500,0,0,3997,-2497
INJ_405,20220316,6000,6000,0,0,15985,-9985
INJ_405,20220317,3375,3375,0,0,8994,-5619
INJ_405,20220318,4125,4125,0,0,10990,-6865
INJ_405,20220319,2250,2250,0,1,5997,-3747
INJ_405,20220321,4875,4875,0,0,12991,-8116
INJ_405,20220322,9000,9000,0,-1,23983,-14983
INJ_405,20220323,4500,4500,0,5,11990,-7490
INJ_405,20220324,2625,2625,0,0,6997,-4372
INJ_405,20220325,8250,8250,0,0,21984,-13734
INJ_405,20220326,1500,1500,0,1,3996,-2496
INJ_405,20220328,4875,4875,0,-1,12992,-8117
INJ_405,20220329,3000,3000,0,1,7993,-4993
INJ_405,20220405,1500,1500,0,0,3997,-2497
INJ_405,20220406,1500,1500,0,1,3998,-2498
INJ_405,20220408,2250,2250,0,0,5994,-3744
INJ_405,20220409,1125,1125,0,-1,2998,-1873
INJ_405,20220411,1500,1500,0,0,3996,-2496
INJ_405,20220412,1875,1875,0,0,4995,-3120
INJ_405,20220413,1875,1875,0,0,4995,-3120
INJ_405,20220414,2250,2250,0,0,5997,-3747
INJ_405,20220421,3750,3750,0,0,9993,-6243
INJ_405,20220422,1500,1500,0,0,3995,-2495
INJ_405,20220424,4125,4125,0,-1,10988,-6863
INJ_405,20220425,1125,1125,0,0,2996,-1871
INJ_405,20220426,2250,2250,0,0,5995,-3745
INJ_405,20220427,2250,2250,0,0,5997,-3747
INJ_405,20220428,2625,2625,0,0,6997,-4372
INJ_405,20220429,3750,3750,0,-1,9989,-6239
INJ_405,20220505,1875,1875,0,0,4995,-3120
INJ_405,20220509,1125,1125,0,-1,2998,-1873
INJ_405,20220516,1125,1125,0,0,2997,-1872
INJ_405,20220518,1875,1875,0,0,4998,-3123
INJ_405,20220519,1500,1500,0,1,3997,-2497
INJ_405,20220525,1200,1200,0,0,3997,-2797
INJ_405,20220526,2400,2400,0,0,7993,-5593
INJ_405,20220527,6000,4200,0,0,13991,-9791
INJ_405,20220528,3000,3000,0,-1,9994,-6994
INJ_405,20220530,4650,4650,0,0,11989,-7339
INJ_405,20220531,1200,1200,0,-1,3996,-2796
INJ_405,20220601,7200,7200,0,0,23984,-16784
INJ_405,20220603,9000,6000,0,-1,19978,-13978
INJ_405,20220604,5700,3900,0,0,12993,-9093
INJ_405,20220607,4500,4500,0,0,14992,-10492
INJ_405,20220608,1800,1800,0,0,5997,-4197
INJ_405,20220609,2100,2100,0,0,6997,-4897
INJ_405,20220611,7800,6600,0,0,21984,-15384
INJ_405,20220613,6600,6600,0,1,21984,-15384
INJ_405,20220614,1200,1200,0,0,3997,-2797
INJ_405,20220615,1200,1200,0,0,3996,-2796
INJ_405,20220616,3600,1200,0,0,3997,-2797
INJ_405,20220617,3000,1500,0,1,4998,-3498
INJ_405,20220618,1200,1200,0,0,3998,-2798
INJ_405,20220620,1800,1800,0,0,5991,-4191
INJ_405,20220622,1200,1200,0,0,3996,-2796
INJ_405,20220623,7200,5100,0,0,16989,-11889
INJ_405,20220624,3900,3900,0,0,12987,-9087
INJ_405,20220627,4200,3900,0,-1,12986,-9086
INJ_405,20220628,4800,4800,0,0,15985,-11185
INJ_405,20220629,2100,2100,0,0,6994,-4894
INJ_405,20220630,2700,2700,0,0,8992,-6292
INJ_405,20220701,2400,2400,0,1,7991,-5591
INJ_405,20220702,2400,2400,0,0,7991,-5591
INJ_405,20220704,2700,2700,0,0,8991,-6291
INJ_405,20220705,2400,2400,0,0,7992,-5592
INJ_405,20220706,5700,5700,0,7,18986,-13286
INJ_405,20220707,2400,2400,0,-1,7994,-5594
INJ_405,20220708,3900,3900,0,0,12987,-9087
INJ_405,20220709,2700,2700,0,-1,8994,-6294
INJ_405,20220712,3600,3600,0,0,11988,-8388
INJ_405,20220713,900,900,0,0,2997,-2097
INJ_405,20220714,3900,3900,0,0,12986,-9086
INJ_405,20220716,2400,2400,0,0,7993,-5593
INJ_405,20220718,1800,1800,0,0,5994,-4194
INJ_405,20220719,1800,1800,0,0,5996,-4196
INJ_405,20220720,4500,1500,0,0,4997,-3497
INJ_405,20220721,2400,2400,0,0,7995,-5595
INJ_405,20220722,1500,1500,0,0,4998,-3498
INJ_405,20220723,1200,1200,0,1,3997,-2797
INJ_405,20220725,6900,6900,0,0,22979,-16079
INJ_405,20220726,900,900,0,0,2995,-2095
INJ_405,20220727,5400,5400,0,-1,17983,-12583
INJ_405,20220728,3900,3900,0,0,12983,-9083
INJ_405,20220730,3900,3900,0,0,12984,-9084
INJ_405,20220801,2600,2600,0,0,3996,-1396
INJ_405,20220802,1500,1500,0,0,4997,-3497
INJ_405,20220803,11750,10550,0,-1,26978,-16428
INJ_405,20220804,1200,1200,0,0,3997,-2797
INJ_405,20220805,3000,3000,0,0,9995,-6995
INJ_405,20220806,4200,2700,0,0,8993,-6293
INJ_405,20220808,6900,5400,0,0,17985,-12585
INJ_405,20220809,1800,1800,0,-1,5996,-4196
INJ_405,20220810,6000,6000,0,1,19979,-13979
INJ_405,20220811,7800,7800,0,0,25981,-18181
INJ_405,20220812,4200,4200,0,-1,13987,-9787
INJ_405,20220813,8700,8700,0,0,28976,-20276
INJ_405,20220815,3900,3900,0,0,12988,-9088
INJ_405,20220816,1500,1500,0,0,4998,-3498
INJ_405,20220818,7800,7800,0,1,25974,-18174
INJ_405,20220819,2400,1200,0,0,3997,-2797
INJ_405,20220820,9000,9000,0,-1,29980,-20980
INJ_405,20220822,3600,3600,0,0,11994,-8394
INJ_405,20220823,3900,3900,0,0,12984,-9084
INJ_405,20220824,3000,3000,0,-1,9992,-6992
INJ_405,20220825,3900,3900,0,1,12984,-9084
INJ_405,20220826,1500,1500,0,0,4995,-3495
INJ_405,20220827,7800,7800,0,0,25975,-18175
INJ_405,20220829,1500,1500,0,0,4995,-3495
INJ_405,20220830,4200,4200,0,0,13991,-9791
INJ_405,20220831,1200,1200,0,0,3998,-2798
INJ_405,20220901,1800,1800,0,0,5997,-4197
INJ_405,20220902,5100,3900,0,0,12987,-9087
INJ_405,20220903,3900,3900,0,0,12986,-9086
INJ_405,20220905,1200,1200,0,0,3995,-2795
INJ_405,20220908,1200,1200,0,-1,3997,-2797
INJ_405,20220909,2400,2400,0,0,7993,-5593
INJ_405,20220910,900,900,0,0,2997,-2097
INJ_405,20220913,1500,1500,0,0,4997,-3497
INJ_405,20220914,9600,9600,0,1,31978,-22378
INJ_405,20220916,3600,3600,5,741,11995,-8395
INJ_405,20220919,10800,1800,0,0,5993,-4193
INJ_405,20220920,36600,3300,0,0,10991,-7691
INJ_405,20220921,48000,4500,0,2,14988,-10488
INJ_405,20220922,19800,1800,0,-1,5996,-4196
INJ_405,20220923,15000,1500,0,0,4996,-3496
INJ_405,20220924,51000,4500,0,0,14992,-10492
INJ_405,20220926,5400,900,0,0,2997,-2097
INJ_405,20220929,53400,3900,0,1,12996,-9096
INJ_405,20221004,9600,1200,0,0,3997,-2797
INJ_405,20221011,54000,3000,0,1,9997,-6997
INJ_405,20221012,9600,1200,0,1,3997,-2797
INJ_405,20221013,6300,2100,0,0,1893,207
INJ_405,20221014,15000,1500,0,0,4997,-3497
INJ_405,20221015,15000,1500,0,0,4997,-3497
INJ_405,20221019,15000,1500,0,0,4995,-3495
INJ_405,20221021,15000,1500,0,0,4997,-3497
INJ_405,20221022,3000,1500,0,0,1247,253
INJ_405,20221024,6600,2100,0,0,3578,-1478
INJ_405,20221025,24600,2700,0,1,8992,-6292
INJ_405,20221027,19200,2400,0,-1,7994,-5594
INJ_405,20221028,5400,900,0,0,2997,-2097
INJ_405,20221029,21600,1800,0,0,5997,-4197
INJ_405,20221031,19200,2400,0,2,7994,-5594
INJ_405,20221102,14400,3600,0,0,5304,-1704
INJ_405,20221105,9600,1200,0,1,3998,-2798
INJ_405,20221107,15000,2100,0,1,6995,-4895
INJ_405,20221109,9600,1200,0,0,3997,-2797
INJ_405,20221110,38400,3300,0,0,10992,-7692
INJ_405,20221111,13500,1500,0,1,4997,-3497
INJ_405,20221112,900,900,0,0,152,748
INJ_405,20221115,2400,2400,0,0,7996,-5596
INJ_405,20221116,900,900,0,0,2998,-2098
INJ_405,20221117,5700,5700,0,0,18989,-13289
INJ_405,20221118,1200,1200,0,1,3998,-2798
INJ_405,20221119,1500,1500,0,-1,4997,-3497
INJ_405,20221121,2400,2400,0,0,7998,-5598
INJ_405,20221123,1800,1800,0,0,5999,-4199
INJ_405,20221124,2400,2400,0,0,7989,-5589
INJ_405,20221125,2700,2700,0,-1,8994,-6294
INJ_405,20221126,900,900,0,0,2995,-2095
INJ_405,20221130,8100,8100,0,0,26986,-18886
INJ_405,20221202,3600,3600,0,-1,11993,-8393
INJ_405,20221205,1200,1200,0,1,3996,-2796
INJ_405,20221207,1800,1800,0,-1,5993,-4193
INJ_405,20221210,1500,1500,0,0,4995,-3495
INJ_405,20221216,1500,1500,0,1,4997,-3497
INJ_405,20221219,900,900,0,0,2997,-2097
INJ_405,20221220,1800,900,0,0,2997,-2097
INJ_405,20221221,1800,1800,0,0,5998,-4198
INJ_405,20221226,1200,1200,0,-1,3997,-2797
INJ_405,20230103,1200,1200,0,1,3994,-2794
INJ_405,20230104,5700,4200,1,198,15939,-11739
INJ_405,20230105,3600,3600,0,0,5997,-2397
INJ_405,20230106,5400,3900,0,0,12985,-9085
INJ_405,20230107,3300,3300,0,1,10986,-7686
INJ_405,20230109,2100,2100,0,-1,6993,-4893
INJ_405,20230110,3000,3000,0,1,9994,-6994
INJ_405,20230111,3300,3300,0,0,10992,-7692
INJ_405,20230113,6900,6900,0,0,22981,-16081
INJ_405,20230114,2400,2400,0,-1,7995,-5595
INJ_405,20230116,6600,6600,0,0,21806,-15206
INJ_405,20230118,3300,3300,0,0,10991,-7691
INJ_405,20230120,6600,6600,0,1,21984,-15384
INJ_405,20230121,3000,3000,0,0,9992,-6992
INJ_405,20230123,3300,3300,0,0,10988,-7688
INJ_405,20230124,3900,3900,0,0,12987,-9087
INJ_405,20230130,9900,9900,0,0,32985,-23085
INJ_405,20230131,5100,3600,0,0,11991,-8391
INJ_405,20230202,1200,1200,0,0,3997,-2797
INJ_405,20230203,5100,5100,0,0,16985,-11885
INJ_405,20230204,1200,1200,0,0,3996,-2796
INJ_405,20230206,6300,6300,0,1,20975,-14675
INJ_405,20230207,3000,3000,0,0,9991,-6991
INJ_405,20230209,2700,2700,0,-1,8992,-6292
INJ_405,20230210,2700,2700,0,0,8991,-6291
INJ_405,20230211,2100,2100,0,-1,6996,-4896
INJ_405,20230214,2400,2400,0,0,7991,-5591
INJ_405,20230215,5700,5700,0,-1,18990,-13290
INJ_405,20230216,3600,3600,0,0,11990,-8390
INJ_405,20230217,900,900,0,0,2998,-2098
INJ_405,20230220,2700,2700,0,0,8992,-6292
INJ_405,20230315,2400,2400,0,0,7990,-5590
INJ_405,20230316,3000,3000,0,452,9990,-6990
INJ_405,20230317,1800,1800,0,-1,5988,-4188
INJ_405,20230318,1500,1500,0,0,4994,-3494
INJ_405,20230320,7200,7200,0,601,23969,-16769
INJ_405,20230321,4800,4800,0,598,15976,-11176
INJ_405,20230323,5100,5100,0,0,16976,-11876
INJ_405,20230325,2700,2700,0,-1,8987,-6287
INJ_405,20230328,6600,6600,0,597,21974,-15374
INJ_405,20230329,3600,3600,0,0,11984,-8384
INJ_405,20230330,4200,4200,1,53,13981,-9781
INJ_405,20230331,7500,5100,0,0,16985,-11885
INJ_405,20230401,1500,1500,0,600,4995,-3495
INJ_405,20230403,3600,3600,1,796,11991,-8391
INJ_405,20230404,5700,5700,0,449,18979,-13279
INJ_405,20230405,27300,4500,0,1,14979,-10479
INJ_405,20230406,1500,1500,1,947,4995,-3495
INJ_405,20230407,4500,4500,1,795,14984,-10484
INJ_405,20230408,6000,6000,0,754,19973,-13973
INJ_405,20230410,2400,2400,0,0,7990,-5590
INJ_405,20230411,3900,3900,0,0,12984,-9084
INJ_405,20230412,4200,4200,1,806,13981,-9781
INJ_405,20230413,3600,3600,0,602,11983,-8383
INJ_405,20230414,1200,1200,0,-1,3995,-2795
INJ_405,20230415,2700,2700,0,0,8987,-6287
INJ_405,20230417,6900,3900,0,0,12981,-9081
INJ_405,20230419,1200,1200,1,653,3992,-2792
INJ_405,20230420,1200,1200,2,699,3995,-2795
INJ_405,20230421,6300,6300,0,451,20977,-14677
INJ_405,20230424,900,900,1,49,2996,-2096
INJ_405,20230425,3900,3900,1,355,12985,-9085
INJ_405,20230426,4500,4500,0,595,14985,-10485
INJ_405,20230427,3600,3600,0,-1,11984,-8384
INJ_405,20230428,3600,3600,0,904,11983,-8383
INJ_405,20230503,3900,3900,0,0,12980,-9080
INJ_405,20230504,1500,1500,0,0,4995,-3495
INJ_405,20230505,1200,1200,0,0,3995,-2795
INJ_405,20230506,3000,3000,0,446,9990,-6990
INJ_405,20230508,1200,1200,0,900,3995,-2795
INJ_405,20230509,4200,4200,0,1,13984,-9784
INJ_405,20230510,2400,2400,1,202,7990,-5590
INJ_405,20230511,3300,3300,0,601,10991,-7691
INJ_405,20230512,3000,2100,1,49,6989,-4889
INJ_405,20230513,3000,3000,0,754,9989,-6989
INJ_405,20230515,3300,2400,1,201,7987,-5587
INJ_405,20230516,2700,2700,0,0,8987,-6287
INJ_405,20230517,9000,4800,1,205,15985,-11185
INJ_405,20230518,3300,3300,0,447,10990,-7690
INJ_405,20230519,3000,3000,1,52,9990,-6990
INJ_405,20230520,6000,6000,0,0,19980,-13980
INJ_405,20230522,12150,9750,0,0,28966,-19216
INJ_405,20230523,3000,3000,0,453,9985,-6985
INJ_405,20230525,3300,3300,0,1,10981,-7681
INJ_405,20230526,6900,6900,2,100,22976,-16076
INJ_405,20230527,4500,4500,1,213,14979,-10479
INJ_405,20230529,1800,1800,0,-1,5995,-4195
INJ_405,20230530,7500,5100,0,0,16986,-11886
INJ_405,20230531,1500,1500,1,197,4995,-3495
INJ_405,20230601,4500,4500,0,598,14984,-10484
INJ_405,20230602,3600,2700,1,351,8987,-6287
INJ_405,20230603,8400,8400,1,203,27972,-19572
INJ_405,20230605,1800,1800,0,903,5993,-4193
INJ_405,20230606,7800,6000,0,0,19979,-13979
INJ_405,20230607,6300,4800,0,1,15980,-11180
INJ_405,20230608,4500,4500,0,451,14980,-10480
INJ_405,20230609,1200,1200,0,0,3993,-2793
INJ_405,20230610,6300,6300,0,-1,20983,-14683
INJ_405,20230613,5100,5100,0,0,16984,-11884
INJ_405,20230614,1500,1500,0,450,4993,-3493
INJ_405,20230615,900,900,0,0,2993,-2093
INJ_405,20230616,1800,1800,1,497,5994,-4194
INJ_405,20230617,9900,9900,0,750,32945,-23045
INJ_405,20230619,3600,3600,0,-1,11985,-8385
INJ_405,20230620,2400,2400,1,347,7989,-5589
INJ_405,20230621,900,900,0,748,2996,-2096
INJ_405,20230622,1800,1800,0,-1,5986,-4186
INJ_405,20230623,8700,8700,1,355,28970,-20270
INJ_405,20230624,2400,2400,1,350,7990,-5590
INJ_405,20230626,2700,2700,1,202,8990,-6290
INJ_405,20230627,4500,4500,0,603,14985,-10485
INJ_405,20230628,1500,1500,1,650,4996,-3496
INJ_405,20230630,4500,4500,1,795,14982,-10482
INJ_405,20230701,4950,4950,0,899,12979,-8029
INJ_405,20230703,5400,5400,0,747,17983,-12583
INJ_405,20230704,1500,1500,0,0,4992,-3492
INJ_405,20230705,6000,6000,1,201,19975,-13975
INJ_405,20230706,3000,1500,0,-1,4995,-3495
INJ_405,20230708,1500,1500,0,750,4994,-3494
INJ_405,20230710,1800,1800,0,449,5996,-4196
INJ_405,20230711,2400,2400,0,-1,7990,-5590
INJ_405,20230712,1200,1200,1,501,3994,-2794
INJ_405,20230713,10800,2400,0,738,7986,-5586
INJ_405,20230714,15900,3300,0,0,10990,-7690
INJ_405,20230715,10500,1500,0,451,4994,-3494
INJ_405,20230717,38100,4200,0,450,13984,-9784
INJ_405,20230718,2400,2400,0,0,7988,-5588
INJ_405,20230719,10800,8400,0,1,27978,-19578
INJ_406,20210927,6400,6400,0,1,131959,-125559
INJ_406,20210928,8600,8600,0,-1,69982,-61382
INJ_406,20210929,11700,9800,0,0,89986,-80186
INJ_406,20210930,5500,5500,0,0,44980,-39480
INJ_406,20211001,10400,10400,0,-1,79966,-69566
INJ_406,20211002,12400,12000,0,-2,103962,-91962
INJ_406,20211004,12100,12100,0,-1,92970,-80870
INJ_406,20211005,15800,14600,0,0,123964,-109364
INJ_406,20211006,10000,8600,0,0,77974,-69374
INJ_406,20211007,5900,5500,0,0,48991,-43491
INJ_406,20211008,3900,3300,0,1,38440,-35140
INJ_406,20211009,7000,7000,0,-1,69978,-62978
INJ_406,20211011,7600,7600,0,2,61985,-54385
INJ_406,20211012,3600,3600,0,0,27995,-24395
INJ_406,20211014,3300,3300,4,636,24991,-21691
INJ_406,20211015,10300,10300,0,1,74967,-64667
INJ_406,20211016,9500,9500,0,-1,78975,-69475
INJ_406,20211018,8000,8000,0,0,71978,-63978
INJ_406,20211019,8400,8400,0,1,55991,-47591
INJ_406,20211020,7400,7400,0,-1,49985,-42585
INJ_406,20211021,5800,5800,0,0,57987,-52187
INJ_406,20211022,3300,2600,0,-1,25997,-23397
INJ_406,20211023,5400,5400,0,2,43991,-38591
INJ_406,20211025,8000,8000,0,0,55985,-47985
INJ_406,20211026,11600,10400,0,0,87968,-77568
INJ_406,20211027,7100,7100,0,-1,70978,-63878
INJ_406,20211028,11400,11400,0,1,113966,-102566
INJ_406,20211029,5400,5400,0,0,37993,-32593
INJ_406,20211030,6800,6400,0,0,57979,-51579
INJ_406,20211101,2300,2300,0,1,22993,-20693
INJ_406,20211102,9500,9500,0,0,82970,-73470
INJ_406,20211103,6300,6300,0,2,54986,-48686
INJ_406,20211104,6100,6100,0,0,60987,-54887
INJ_406,20211105,11900,10600,0,2,78990,-68390
INJ_406,20211106,9500,9500,0,-1,86963,-77463
INJ_406,20211108,5900,5600,0,2,45980,-40380
INJ_406,20211109,7100,7100,0,1,62980,-55880
INJ_406,20211110,9300,9300,0,1,78979,-69679
INJ_406,20211111,11000,11000,0,-1,83967,-72967
INJ_406,20211112,2600,2600,0,0,25985,-23385
INJ_406,20211113,4600,4600,0,417,37992,-33392
INJ_406,20211115,10500,10500,0,2,88974,-78474
INJ_406,20211116,8200,7600,0,2,67984,-60384
INJ_406,20211117,11200,11200,0,-1,93972,-82772
INJ_406,20211118,11300,11300,0,1,80970,-69670
INJ_406,20211119,8800,7900,0,0,72916,-65016
INJ_406,20211120,5100,5100,0,1,42990,-37890
INJ_406,20211122,12900,12900,0,-1,102970,-90070
INJ_406,20211123,11200,10000,0,2,91978,-81978
INJ_406,20211124,3500,3500,0,1,34989,-31489
INJ_406,20211125,9900,9900,0,2,80984,-71084
INJ_406,20211126,10300,10300,0,-1,86989,-76689
INJ_406,20211127,9800,8400,0,0,75987,-67587
INJ_406,20211129,11700,11200,0,0,77973,-66773
INJ_406,20211130,7200,7200,0,0,49989,-42789
INJ_406,20211201,13300,12900,0,1,98962,-86062
INJ_406,20211202,5800,5800,0,2,47983,-42183
INJ_406,20211203,9000,9000,0,0,75914,-66914
INJ_406,20211204,6900,6900,0,0,68984,-62084
INJ_406,20211206,4600,4600,0,-1,45991,-41391
INJ_406,20211207,8600,8600,0,1,61987,-53387
INJ_406,20211208,9400,9400,0,1,61987,-52587
INJ_406,20211209,6900,6900,0,-1,60981,-54081
INJ_406,20211210,6600,5100,0,0,40993,-35893
INJ_406,20211211,7800,7800,0,3,67991,-60191
INJ_406,20211213,5600,5600,0,-1,45993,-40393
INJ_406,20211214,3200,3200,0,1,31994,-28794
INJ_406,20211215,11000,10300,0,3,92827,-82527
INJ_406,20211216,3800,3800,0,-1,37743,-33943
INJ_406,20211217,7700,7700,0,-2,60990,-53290
INJ_406,20211218,8800,8800,0,1,71991,-63191
INJ_406,20211220,9300,7600,0,0,59980,-52380
INJ_406,20211221,8000,6900,0,1,46988,-40088
INJ_406,20211222,6200,6200,0,0,45991,-39791
INJ_406,20211223,9400,9400,0,1,93964,-84564
INJ_406,20211224,6300,5600,0,0,41985,-36385
INJ_406,20211225,5100,4400,0,-1,35988,-31588
INJ_406,20211227,8000,8000,0,0,55983,-47983
INJ_406,20211228,10600,10600,0,-2,89976,-79376
INJ_406,20211229,4200,4200,0,0,41991,-37791
INJ_406,20211230,5200,5200,0,0,45993,-40793
INJ_406,20211231,6900,6100,0,0,55001,-48901
INJ_406,20220101,6800,6800,0,-1,59991,-53191
INJ_406,20220103,9100,9100,0,4,74978,-65878
INJ_406,20220104,7400,7400,0,1,59986,-52586
INJ_406,20220105,9000,9000,0,0,81983,-72983
INJ_406,20220106,5300,5300,0,-1,52991,-47691
INJ_406,20220107,8200,8200,0,1,55986,-47786
INJ_406,20220108,12100,12100,0,1,94982,-82882
INJ_406,20220110,7900,7900,0,-1,62977,-55077
INJ_406,20220111,15100,14700,0,1,124955,-110255
INJ_406,20220112,8000,6100,0,-1,67393,-61293
INJ_406,20220113,9900,9900,0,-2,68985,-59085
INJ_406,20220114,6800,6800,0,0,67979,-61179
INJ_406,20220115,7500,6800,0,1,57988,-51188
INJ_406,20220117,13500,13500,0,-1,104024,-90524
INJ_406,20220118,4800,4800,0,-1,47993,-43193
INJ_406,20220119,7800,7800,0,1,67911,-60111
INJ_406,20220120,8700,8700,0,-1,72969,-64269
INJ_406,20220121,9200,9200,0,3,85978,-76778
INJ_406,20220122,7800,7800,0,0,67984,-60184
INJ_406,20220124,5400,5400,0,-1,53989,-48589
INJ_406,20220125,11100,9200,0,3,69984,-60784
INJ_406,20220126,8000,8000,0,-1,61991,-53991
INJ_406,20220127,12900,12300,0,-1,98991,-86691
INJ_406,20220128,13900,13200,0,2,107973,-94773
INJ_406,20220129,1300,1300,0,-1,12997,-11697
INJ_406,20220131,5700,5700,0,-1,50662,-44962
INJ_406,20220201,11000,11000,0,-3,83988,-72988
INJ_406,20220202,11400,11400,0,3,103969,-92569
INJ_406,20220203,12300,12300,0,0,102980,-90680
INJ_406,20220204,11900,9100,0,0,74916,-65816
INJ_406,20220205,12600,10100,0,2,86987,-76887
INJ_406,20220207,16100,14200,0,1,117982,-103782
INJ_406,20220208,9700,9200,0,0,88808,-79608
INJ_406,20220209,11400,11400,0,-1,113965,-102565
INJ_406,20220210,13200,13200,0,0,105975,-92775
INJ_406,20220211,10900,10200,0,2,71989,-61789
INJ_406,20220212,7100,7100,0,1,62990,-55890
INJ_406,20220214,3300,3300,0,-2,32999,-29699
INJ_406,20220215,16400,15600,0,0,135946,-120346
INJ_406,20220216,8500,8500,0,1,70974,-62474
INJ_406,20220217,11700,11300,0,0,94979,-83679
INJ_406,20220218,15400,15400,0,-1,129978,-114578
INJ_406,20220219,3600,3600,0,0,25994,-22394
INJ_406,20220221,9400,9400,0,1,93980,-84580
INJ_406,20220222,9200,9200,0,-1,81990,-72790
INJ_406,20220223,9300,8200,0,1,71987,-63787
INJ_406,20220224,7600,7600,0,-1,75980,-68380
INJ_406,20220225,10500,9800,0,0,89977,-80177
INJ_406,20220226,8700,8700,0,0,70983,-62283
INJ_406,20220228,2400,2400,0,0,23996,-21596
INJ_406,20220301,9100,9100,0,0,74987,-65887
INJ_406,20220302,6100,6100,0,0,60990,-54890
INJ_406,20220303,13700,13700,0,1,107995,-94295
INJ_406,20220304,11100,10400,0,-1,93977,-83577
INJ_406,20220305,10800,10800,0,-1,85981,-75181
INJ_406,20220307,13900,12700,0,2,109340,-96640
INJ_406,20220308,10136,9736,0,0,72993,-63257
INJ_406,20220309,10400,10400,0,1,75987,-65587
INJ_406,20220310,7000,7000,0,-1,59983,-52983
INJ_406,20220311,6500,6500,0,0,58981,-52481
INJ_406,20220312,8700,8700,0,0,86981,-78281
INJ_406,20220314,14900,14200,0,-1,135973,-121773
INJ_406,20220315,10700,10700,0,1,92982,-82282
INJ_406,20220316,10200,9700,0,0,86986,-77286
INJ_406,20220317,8300,8300,0,0,74988,-66688
INJ_406,20220318,12700,12300,0,-1,106998,-94698
INJ_406,20220319,10100,9000,0,0,79985,-70985
INJ_406,20220321,9900,9900,0,3,82989,-73089
INJ_406,20220322,8800,8500,0,0,84991,-76491
INJ_406,20220323,5100,5100,0,0,42994,-37894
INJ_406,20220324,7800,7800,0,1,77992,-70192
INJ_406,20220325,13900,13500,0,0,100837,-87337
INJ_406,20220326,4900,4200,0,-2,41988,-37788
INJ_406,20220328,13200,13200,0,1,107971,-94771
INJ_406,20220329,5300,5300,0,1,44989,-39689
INJ_406,20220330,4720,4710,0,-1,47003,-42293
INJ_406,20220331,2800,2800,0,0,27996,-25196
INJ_406,20220401,4700,4700,0,1,46988,-42288
INJ_406,20220402,3200,3200,0,0,50992,-47792
INJ_406,20220403,2700,2700,0,0,0,2700
INJ_406,20220404,1100,1100,0,0,11000,-9900
INJ_406,20220405,1500,1500,0,0,14997,-13497
INJ_406,20220406,4200,3700,0,0,26997,-23297
INJ_406,20220407,2500,2500,0,0,24993,-22493
INJ_406,20220408,5100,5100,0,0,50986,-45886
INJ_406,20220409,3000,3000,0,1,29988,-26988
INJ_406,20220411,1300,1300,0,0,12998,-11698
INJ_406,20220412,1200,1200,0,0,12000,-10800
INJ_406,20220413,2700,2700,0,0,26991,-24291
INJ_406,20220414,2800,2800,0,1,27990,-25190
INJ_406,20220419,5513,5500,0,3,47124,-41624
INJ_406,20220420,3000,3000,0,0,29995,-26995
INJ_406,20220421,3510,3500,0,-1,27093,-23593
INJ_406,20220422,5600,5600,0,-1,47992,-42392
INJ_406,20220424,6000,6000,0,-1,59987,-53987
INJ_406,20220425,6300,6300,0,2,62993,-56693
INJ_406,20220426,4400,4400,0,1,43991,-39591
INJ_406,20220427,1000,1000,0,1,10001,-9001
INJ_406,20220428,1200,1200,0,-2,11998,-10798
INJ_406,20220429,7400,6600,0,0,73982,-67382
INJ_406,20220504,3400,3400,0,0,27995,-24595
INJ_406,20220505,4500,3800,0,0,27999,-24199
INJ_406,20220509,4100,4100,0,0,32998,-28898
INJ_406,20220510,2600,1900,0,0,18996,-17096
INJ_406,20220511,1900,1900,0,0,18994,-17094
INJ_406,20220513,3300,3300,0,-1,32995,-29695
INJ_406,20220516,4600,4600,0,3,45994,-41394
INJ_406,20220518,3810,3800,0,-1,30060,-26260
INJ_406,20220519,1200,1200,0,-1,11996,-10796
INJ_406,20220523,4200,3200,0,0,31990,-28790
INJ_406,20220524,2500,2500,0,1,18995,-16495
INJ_406,20220525,1500,1500,0,0,14994,-13494
INJ_406,20220526,2800,2800,0,-1,27993,-25193
INJ_406,20220527,1300,800,0,0,7998,-7198
INJ_406,20220528,6450,6450,0,-1,57068,-50618
INJ_406,20220530,6110,6100,0,0,60985,-54885
INJ_406,20220531,4200,4200,0,1,41989,-37789
INJ_406,20220601,8020,7620,0,-1,76125,-68505
INJ_406,20220603,7850,7050,0,-1,59973,-52923
INJ_406,20220604,6300,5600,0,0,55980,-50380
INJ_406,20220606,3300,3300,0,-1,32983,-29683
INJ_406,20220607,7600,4100,0,-1,33253,-29153
INJ_406,20220608,3600,2200,0,0,0,2200
INJ_406,20220609,1400,1400,0,0,13991,-12591
INJ_406,20220610,2300,1600,0,-1,15993,-14393
INJ_406,20220611,9400,8650,0,0,81971,-73321
INJ_406,20220613,6650,6650,0,2,55980,-49330
INJ_406,20220614,1950,1950,0,0,14992,-13042
INJ_406,20220615,4700,4700,0,-1,46988,-42288
INJ_406,20220616,3350,1950,0,0,14994,-13044
INJ_406,20220617,3800,3200,0,1,31989,-28789
INJ_406,20220618,4700,4700,0,0,46976,-42276
INJ_406,20220620,3210,3210,0,1,31960,-28750
INJ_406,20220622,4800,4800,0,2,47973,-43173
INJ_406,20220623,5500,5500,0,1,54979,-49479
INJ_406,20220624,4250,4250,0,1,34984,-30734
INJ_406,20220627,2600,2600,0,1,25991,-23391
INJ_406,20220628,6000,6000,0,0,59982,-53982
INJ_406,20220629,2600,2600,0,0,25991,-23391
INJ_406,20220630,8700,8700,0,1,74981,-66281
INJ_406,20220701,8500,8500,0,0,78985,-70485
INJ_406,20220702,3050,3050,0,0,25991,-22941
INJ_406,20220704,4500,4500,0,0,44972,-40472
INJ_406,20220705,6360,6350,0,-1,59033,-52683
INJ_406,20220706,7350,7350,0,-3,68970,-61620
INJ_406,20220707,3000,3000,0,0,23990,-20990
INJ_406,20220709,4050,4050,0,0,26991,-22941
INJ_406,20220712,2900,2900,0,1,22994,-20094
INJ_406,20220713,1600,1600,0,0,15992,-14392
INJ_406,20220716,2600,2600,0,-1,25990,-23390
INJ_406,20220718,4250,4250,0,0,28991,-24741
INJ_406,20220719,1200,1200,0,-1,11999,-10799
INJ_406,20220720,6900,5300,0,-2,52991,-47691
INJ_406,20220721,3600,3600,0,1,35994,-32394
INJ_406,20220722,5750,5350,0,-2,48973,-43623
INJ_406,20220723,6000,4600,0,-1,45978,-41378
INJ_406,20220725,2800,2800,0,-1,27987,-25187
INJ_406,20220726,5800,5000,0,3,43980,-38980
INJ_406,20220727,3500,3500,0,-1,19992,-16492
INJ_406,20220728,2000,2000,0,0,19991,-17991
INJ_406,20220730,1900,1900,0,0,18993,-17093
INJ_406,20220801,7500,7500,0,1,59982,-52482
INJ_406,20220802,3400,2500,0,1,20364,-17864
INJ_406,20220803,12650,12350,0,1,115774,-103424
INJ_406,20220804,3950,3950,0,0,34987,-31037
INJ_406,20220805,6900,6900,0,0,62975,-56075
INJ_406,20220806,3500,2700,0,0,26996,-24296
INJ_406,20220808,7650,6950,0,-1,58983,-52033
INJ_406,20220809,2600,2600,0,1,25988,-23388
INJ_406,20220810,800,800,0,0,7996,-7196
INJ_406,20220811,6200,6200,0,-1,49971,-43771
INJ_406,20220812,2900,2900,0,0,28991,-26091
INJ_406,20220813,5210,5210,0,-1,43049,-37839
INJ_406,20220816,1850,1850,0,1,13996,-12146
INJ_406,20220817,3200,3200,0,-1,31992,-28792
INJ_406,20220818,3500,3500,0,0,34985,-31485
INJ_406,20220819,6500,5800,0,1,57982,-52182
INJ_406,20220820,6350,6350,0,0,58991,-52641
INJ_406,20220822,3200,3200,0,0,25989,-22789
INJ_406,20220824,7100,6800,0,3,61971,-55171
INJ_406,20220825,2950,2950,0,-1,18994,-16044
INJ_406,20220826,1200,1200,0,0,11997,-10797
INJ_406,20220827,1700,1700,0,-1,16993,-15293
INJ_406,20220829,6100,6100,0,1,60985,-54885
INJ_406,20220830,6900,6900,0,0,62979,-56079
INJ_406,20220831,4600,4600,0,6,33994,-29394
INJ_406,20220901,5400,4700,0,0,46975,-42275
INJ_406,20220903,19450,1450,0,0,8032,-6582
INJ_406,20220905,3500,700,0,1,3739,-3039
INJ_406,20220908,1200,1200,0,-1,11997,-10797
INJ_406,20220909,5310,5310,0,2,53067,-47757
INJ_406,20220910,1200,1200,0,3,11996,-10796
INJ_406,20220913,3300,3300,0,0,32993,-29693
INJ_406,20220914,5250,5250,0,0,41981,-36731
INJ_406,20220915,1600,1600,0,1,15993,-14393
INJ_406,20220916,5500,5500,0,0,54978,-49478
INJ_406,20220917,2900,2900,0,-1,28993,-26093
INJ_406,20220919,5400,5400,0,1,47983,-42583
INJ_406,20220920,5800,5800,0,1,51991,-46191
INJ_406,20220921,4100,4100,0,2,34996,-30896
INJ_406,20220922,2600,2600,0,-2,25992,-23392
INJ_406,20220923,3000,3000,0,1,29989,-26989
INJ_406,20220924,9100,9100,0,0,90973,-81873
INJ_406,20220926,4500,4500,0,-1,44991,-40491
INJ_406,20220928,1900,1900,0,0,18997,-17097
INJ_406,20220929,4900,4900,0,1,42982,-38082
INJ_406,20220930,1700,1700,0,1,16992,-15292
INJ_406,20221001,1600,1600,0,1,15994,-14394
INJ_406,20221004,4350,4350,0,403,32990,-28640
INJ_406,20221005,1500,1500,0,1,14994,-13494
INJ_406,20221006,1500,1500,0,-1,14995,-13495
INJ_406,20221007,1400,1400,0,810,17993,-16593
INJ_406,20221008,7400,6600,0,-808,47986,-41386
INJ_406,20221010,1200,1200,0,0,11998,-10798
INJ_406,20221011,1200,1200,0,0,7998,-6798
INJ_406,20221012,1950,1950,0,0,14996,-13046
INJ_406,20221013,400,400,0,0,3999,-3599
INJ_406,20221014,5350,5350,0,-1,48993,-43643
INJ_406,20221015,1900,1900,0,1,18992,-17092
INJ_406,20221017,8850,8850,0,0,83959,-75109
INJ_406,20221019,6700,6700,0,2,60972,-54272
INJ_406,20221021,6100,5700,0,2,56982,-51282
INJ_406,20221022,2800,2800,0,0,27986,-25186
INJ_406,20221024,5850,5850,0,4,47981,-42131
INJ_406,20221025,2900,2900,0,0,28984,-26084
INJ_406,20221026,4050,4050,0,0,32987,-28937
INJ_406,20221027,4500,4500,0,0,44980,-40480
INJ_406,20221028,4200,4200,0,-1,41985,-37785
INJ_406,20221029,3950,3950,0,0,34991,-31041
INJ_406,20221031,6000,5200,0,-1,33992,-28792
INJ_406,20221101,1900,1900,0,-1,18993,-17093
INJ_406,20221102,5600,4600,0,1,49975,-45375
INJ_406,20221103,3500,3500,0,0,34989,-31489
INJ_406,20221104,1400,1400,0,0,13998,-12598
INJ_406,20221105,5450,4950,0,1,44979,-40029
INJ_406,20221107,5250,5250,0,-1,44989,-39739
INJ_406,20221109,1950,1950,0,0,14992,-13042
INJ_406,20221110,3100,3100,0,1,30987,-27887
INJ_406,20221111,1200,1200,0,1,11996,-10796
INJ_406,20221112,3300,3300,0,0,32990,-29690
INJ_406,20221114,3300,3300,0,0,26988,-23688
INJ_406,20221115,3900,3900,0,1,32983,-29083
INJ_406,20221116,1200,1200,0,0,11994,-10794
INJ_406,20221117,1400,1400,0,0,13992,-12592
INJ_406,20221118,1950,1950,0,-1,14995,-13045
INJ_406,20221119,3600,3600,0,1,29988,-26388
INJ_406,20221121,3200,2800,0,-1,27991,-25191
INJ_406,20221122,1400,1400,0,0,13994,-12594
INJ_406,20221123,4500,4500,0,0,44987,-40487
INJ_406,20221124,6350,5650,0,2,48980,-43330
INJ_406,20221125,2550,2550,0,0,20993,-18443
INJ_406,20221126,4100,4100,0,-1,34982,-30882
INJ_406,20221128,5750,5350,0,1,48985,-43635
INJ_406,20221129,1950,1950,0,0,11992,-10042
INJ_406,20221130,4950,4950,0,1,38991,-34041
INJ_406,20221202,3000,3000,0,-1,29988,-26988
INJ_406,20221203,4700,4700,0,1,46982,-42282
INJ_406,20221205,7200,7200,0,1,65977,-58777
INJ_406,20221206,1700,1700,0,-1,16992,-15292
INJ_406,20221207,4900,4900,0,0,48984,-44084
INJ_406,20221208,1400,1400,0,0,13998,-12598
INJ_406,20221210,1800,1800,0,0,11998,-10198
INJ_406,20221212,3600,3600,0,0,35993,-32393
INJ_406,20221213,1700,1700,0,1,16993,-15293
INJ_406,20221216,4900,4900,0,0,48987,-44087
INJ_406,20221217,3600,3600,0,-1,35991,-32391
INJ_406,20221219,3200,2200,0,-1,15994,-13794
INJ_406,20221220,3200,3200,0,0,31985,-28785
INJ_406,20221221,1800,1800,0,0,11997,-10197
INJ_406,20221222,1900,1900,0,0,18993,-17093
INJ_406,20221226,5350,5350,0,2,48990,-43640
INJ_406,20221227,3300,3300,0,0,32995,-29695
INJ_406,20221230,700,700,0,0,6994,-6294
INJ_406,20230103,8950,8250,0,1,71995,-63745
INJ_406,20230104,9900,9200,0,331,79636,-70436
INJ_406,20230105,4600,4600,0,-1,27998,-23398
INJ_406,20230106,10950,10250,0,1,98000,-87750
INJ_406,20230107,8500,8500,0,0,73007,-64507
INJ_406,20230109,3700,3700,0,2,31001,-27301
INJ_406,20230110,8200,8200,0,1,70003,-61803
INJ_406,20230111,7100,7100,0,1,59004,-51904
INJ_406,20230112,5200,5200,0,-2,52005,-46805
INJ_406,20230113,6700,6700,0,0,66997,-60297
INJ_406,20230114,4500,4500,0,0,44997,-40497
INJ_406,20230116,4150,4150,0,0,36955,-32805
INJ_406,20230117,2500,2500,0,1,19000,-16500
INJ_406,20230118,4700,4700,0,2,41002,-36302
INJ_406,20230119,3300,3300,0,0,32998,-29698
INJ_406,20230120,8800,8800,0,1,81984,-73184
INJ_406,20230121,7250,7250,0,0,62000,-54750
INJ_406,20230123,9650,9650,0,1,88999,-79349
INJ_406,20230124,12400,12400,0,-1,109001,-96601
INJ_406,20230125,9700,7950,0,1,62909,-54959
INJ_406,20230126,1700,1700,0,0,16999,-15299
INJ_406,20230127,3750,3750,0,-1,33002,-29252
INJ_406,20230128,4500,4500,0,0,44996,-40496
INJ_406,20230130,8500,7700,0,1,70991,-63291
INJ_406,20230131,5200,3700,0,-1,36997,-33297
INJ_406,20230201,5300,5300,0,0,53007,-47707
INJ_406,20230202,10200,10200,0,0,101979,-91779
INJ_406,20230203,7750,7750,0,1,69997,-62247
INJ_406,20230204,7850,7850,0,0,64997,-57147
INJ_406,20230206,9850,9050,0,1,82988,-73938
INJ_406,20230207,8100,7400,0,0,73995,-66595
INJ_406,20230208,7950,7950,0,0,71990,-64040
INJ_406,20230209,4300,4300,0,-1,42996,-38696
INJ_406,20230210,5600,5600,0,0,55995,-50395
INJ_406,20230211,8000,6100,0,0,45995,-39895
INJ_406,20230213,3300,3300,0,1,32996,-29696
INJ_406,20230214,36900,6100,0,0,54993,-48893
INJ_406,20230215,4000,4000,0,0,39998,-35998
INJ_406,20230216,12700,12700,0,0,109004,-96304
INJ_406,20230217,5900,5900,0,0,59001,-53101
INJ_406,20230218,5200,5200,0,0,52005,-46805
INJ_406,20230220,4400,4400,0,0,44004,-39604
INJ_406,20230221,7850,7850,0,0,68004,-60154
INJ_406,20230222,8100,7400,0,1,67994,-60594
INJ_406,20230223,4900,4900,0,0,49002,-44102
INJ_406,20230224,1600,1600,0,0,16000,-14400
INJ_406,20230227,7000,4200,0,1,35999,-31799
INJ_406,20230228,5550,5550,0,0,48002,-42452
INJ_406,20230301,6400,6400,0,1,64004,-57604
INJ_406,20230303,6400,6400,0,0,63997,-57597
INJ_406,20230304,4800,4800,0,0,48008,-43208
INJ_406,20230306,7600,7600,0,2,63992,-56392
INJ_406,20230307,6600,6600,0,-2,66000,-59400
INJ_406,20230308,2900,2900,0,-1,29003,-26103
INJ_406,20230309,6000,6000,0,1,59999,-53999
INJ_406,20230310,8700,8700,0,-1,87007,-78307
INJ_406,20230311,9850,9850,0,1,79010,-69160
INJ_406,20230313,13950,13950,0,-1,131993,-118043
INJ_406,20230314,8200,7200,0,2,54001,-46801
INJ_406,20230315,9100,9100,0,-3,82000,-72900
INJ_406,20230316,10300,10300,0,1,75996,-65696
INJ_406,20230317,14950,14950,0,3,93999,-79049
INJ_406,20230318,9150,9150,0,3,65993,-56843
INJ_406,20230320,19200,19200,0,3,170994,-151794
INJ_406,20230321,12050,11450,0,2,88999,-77549
INJ_406,20230322,7550,7550,0,0,71003,-63453
INJ_406,20230323,13950,12950,0,2,113007,-100057
INJ_406,20230324,13200,13200,0,-3,72004,-58804
INJ_406,20230325,12200,12200,0,1,91987,-79787
INJ_406,20230327,5400,5400,0,-1,32999,-27599
INJ_406,20230328,9950,9950,0,-1,59005,-49055
INJ_406,20230329,9250,9250,0,0,87985,-78735
INJ_406,20230330,16250,14950,0,1,101991,-87041
INJ_406,20230331,7600,6600,0,1,65988,-59388
INJ_406,20230401,9050,7300,0,-2,48997,-41697
INJ_406,20230403,20000,17450,0,4,112691,-95241
INJ_406,20230404,15750,14250,0,2,89431,-75181
INJ_406,20230405,76050,11250,0,2,86998,-75748
INJ_406,20230406,17950,17250,0,2,99007,-81757
INJ_406,20230407,22950,22250,0,0,134010,-111760
INJ_406,20230408,20950,18950,0,2,139989,-121039
INJ_406,20230410,15900,13400,0,0,96605,-83205
INJ_406,20230411,7300,7300,0,0,55001,-47701
INJ_406,20230412,18200,17400,0,0,117012,-99612
INJ_406,20230413,10600,9400,0,0,74999,-65599
INJ_406,20230414,7800,7800,0,0,72007,-64207
INJ_406,20230415,6550,6550,0,1,57987,-51437
INJ_406,20230417,9700,8500,0,1,72995,-64495
INJ_406,20230418,10900,9150,0,1,65999,-56849
INJ_406,20230419,23500,19550,0,-1,133170,-113620
INJ_406,20230420,17050,13450,0,0,78998,-65548
INJ_406,20230421,18400,14450,0,-1,121658,-107208
INJ_406,20230424,11050,10450,0,-2,74125,-63675
INJ_406,20230425,23900,14650,0,2,93198,-78548
INJ_406,20230426,17900,16900,0,4,122141,-105241
INJ_406,20230427,10950,10950,0,0,80989,-70039
INJ_406,20230428,22600,18550,0,1,115634,-97084
INJ_406,20230429,9150,9150,0,1,80003,-70853
INJ_406,20230501,1900,1900,0,0,18998,-17098
INJ_406,20230502,17800,12050,0,0,79142,-67092
INJ_406,20230503,12450,10700,0,0,72919,-62219
INJ_406,20230504,9000,9000,0,3,83978,-74978
INJ_406,20230505,3200,3200,0,0,31993,-28793
INJ_406,20230506,26550,21500,0,2,154591,-133091
INJ_406,20230508,6500,6500,0,1,46994,-40494
INJ_406,20230509,13450,11850,0,-1,109162,-97312
INJ_406,20230510,34650,31550,0,4,213886,-182336
INJ_406,20230511,18050,16350,0,-1,124553,-108203
INJ_406,20230512,17200,15450,0,3,83212,-67762
INJ_406,20230513,21850,17750,0,3,109886,-92136
INJ_406,20230515,21850,18550,0,1,119732,-101182
INJ_406,20230516,5700,3700,0,1,46769,-43069
INJ_406,20230517,27000,20650,0,1,144157,-123507
INJ_406,20230518,18200,16450,0,2,112004,-95554
INJ_406,20230519,25400,21800,0,-3,144869,-123069
INJ_406,20230520,27350,22950,0,3,181111,-158161
INJ_406,20230522,14039,11239,0,0,104097,-92858
INJ_406,20230523,16450,12100,0,4,92281,-80181
INJ_406,20230524,10700,3400,0,0,34002,-30602
INJ_406,20230525,7500,7500,0,0,66001,-58501
INJ_406,20230526,22350,16400,0,2,122976,-106576
INJ_406,20230527,18400,13850,0,0,104984,-91134
INJ_406,20230529,15350,12550,0,1,126828,-114278
INJ_406,20230530,12350,9050,0,1,92613,-83563
INJ_406,20230531,16300,12800,0,2,107806,-95006
INJ_406,20230601,24300,18800,0,2,159004,-140204
INJ_406,20230602,27275,21875,0,3,165902,-144027
INJ_406,20230603,27650,20900,0,3,177250,-156350
INJ_406,20230605,30400,24400,0,-2,145720,-121320
INJ_406,20230606,9800,8000,0,-1,84296,-76296
INJ_406,20230607,25000,19200,0,2,162005,-142805
INJ_406,20230608,21250,14850,0,-2,116609,-101759
INJ_406,20230609,13100,10600,0,-1,69673,-59073
INJ_406,20230610,12500,8600,0,-1,84720,-76120
INJ_406,20230612,9700,7700,0,2,75741,-68041
INJ_406,20230613,9600,8900,0,3,71001,-62101
INJ_406,20230614,17350,17350,0,0,123986,-106636
INJ_406,20230615,6500,6500,0,-1,65002,-58502
INJ_406,20230616,20300,17050,0,3,92683,-75633
INJ_406,20230617,17850,16650,0,1,137335,-120685
INJ_406,20230619,7150,6550,0,0,59612,-53062
INJ_406,20230620,17650,14400,0,0,87127,-72727
INJ_406,20230621,12650,10150,0,-1,70538,-60388
INJ_406,20230622,9800,9100,0,1,84987,-75887
INJ_406,20230623,20400,16150,0,1,105984,-89834
INJ_406,20230624,27550,23300,0,-2,143673,-120373
INJ_406,20230626,24150,19150,0,0,111169,-92019
INJ_406,20230627,27950,20650,0,-1,203110,-182460
INJ_406,20230628,15550,11300,0,1,62115,-50815
INJ_406,20230630,18600,11850,0,1,88534,-76684
INJ_406,20230701,9200,8700,0,2,60376,-51676
INJ_406,20230703,14300,11950,0,1,81236,-69286
INJ_406,20230704,17110,16110,0,4,107564,-91454
INJ_406,20230705,20800,17550,0,0,145575,-128025
INJ_406,20230706,20300,15100,0,1,141261,-126161
INJ_406,20230707,21000,15000,0,1,71566,-56566
INJ_406,20230708,16700,14050,0,2,110318,-96268
INJ_406,20230710,9400,7650,0,1,44423,-36773
INJ_406,20230711,11150,7550,0,0,77431,-69881
INJ_406,20230712,10850,10050,0,0,76224,-66174
INJ_406,20230713,46100,13700,0,2,101861,-88161
INJ_406,20230714,40600,6200,0,1,50001,-43801
INJ_406,20230715,78500,8200,0,1,54999,-46799
INJ_406,20230717,157000,19350,0,-1,135626,-116276
INJ_406,20230718,24450,9350,0,1,94660,-85310
INJ_406,20230719,11300,8200,0,-1,84798,-76598
INJ_407,20210929,4000,4000,0,1,15995,-11995
INJ_407,20210930,13000,5500,0,0,21984,-16484
INJ_407,20211001,8000,5500,0,0,21992,-16492
INJ_407,20211004,8750,1750,0,743,6996,-5246
INJ_407,20211005,7750,7750,0,-1,30991,-23241
INJ_407,20211006,5750,5750,0,-1,22993,-17243
INJ_407,20211008,12250,12250,0,0,48986,-36736
INJ_407,20211009,4250,4250,0,1,16992,-12742
INJ_407,20211011,3000,3000,0,0,11996,-8996
INJ_407,20211015,21500,12000,0,-1,44786,-32786
INJ_407,20211016,12000,12000,0,1,47984,-35984
INJ_407,20211018,4750,4000,0,-1,15993,-11993
INJ_407,20211019,4250,4250,0,0,16997,-12747
INJ_407,20211021,3750,3750,0,0,14997,-11247
INJ_407,20211022,21000,12750,0,1,49114,-36364
INJ_407,20211023,8500,4000,0,0,10350,-6350
INJ_407,20211025,7750,7750,0,0,30997,-23247
INJ_407,20211027,3750,3750,0,0,14995,-11245
INJ_407,20211028,8000,8000,0,2,31989,-23989
INJ_407,20211029,4250,4250,2,578,16995,-12745
INJ_407,20211030,7250,7250,0,1,28993,-21743
INJ_407,20211102,7250,7250,0,1,28992,-21742
INJ_407,20211103,4250,3250,0,2,12993,-9743
INJ_407,20211104,3750,3750,0,0,14996,-11246
INJ_407,20211105,8000,8000,0,0,31995,-23995
INJ_407,20211106,3750,3750,0,2,14996,-11246
INJ_407,20211108,8250,8250,0,-1,32981,-24731
INJ_407,20211111,4000,4000,0,0,15999,-11999
INJ_407,20211112,7000,7000,0,-2,27985,-20985
INJ_407,20211115,8000,2000,0,0,7998,-5998
INJ_407,20211119,8750,8750,0,0,34984,-26234
INJ_407,20211123,9750,9750,0,-1,38976,-29226
INJ_407,20211124,13000,10500,0,0,41989,-31489
INJ_407,20211125,3750,3750,0,0,14997,-11247
INJ_407,20211126,7500,7500,0,-1,29992,-22492
INJ_407,20211127,12250,12250,0,2,48988,-36738
INJ_407,20211129,16750,8000,0,0,31986,-23986
INJ_407,20211202,4250,4250,0,1,16997,-12747
INJ_407,20211203,7750,7750,0,2,30985,-23235
INJ_407,20211204,4250,4250,0,0,16993,-12743
INJ_407,20211206,3500,3500,0,0,13994,-10494
INJ_407,20211207,4250,4250,0,0,16990,-12740
INJ_407,20211209,5250,4250,0,469,10783,-6533
INJ_407,20211213,4000,4000,0,0,15995,-11995
INJ_407,20211214,7500,7500,0,0,29993,-22493
INJ_407,20211215,8000,8000,0,0,31993,-23993
INJ_407,20211216,3750,3750,0,0,14993,-11243
INJ_407,20211217,7750,7750,0,-1,30992,-23242
INJ_407,20211218,10500,8000,0,0,31993,-23993
INJ_407,20211220,7750,3750,0,0,11236,-7486
INJ_407,20211221,17000,12000,0,1,47980,-35980
INJ_407,20211222,4250,4250,0,0,16992,-12742
INJ_407,20211223,4000,4000,0,1,15991,-11991
INJ_407,20211224,16750,14250,0,0,56971,-42721
INJ_407,20211225,3750,3750,0,898,14997,-11247
INJ_407,20211227,7500,7500,0,1,29990,-22490
INJ_407,20211228,7500,7500,0,0,29989,-22489
INJ_407,20211229,3750,3750,0,-1,14996,-11246
INJ_407,20211230,3750,3750,0,-1,14996,-11246
INJ_407,20211231,5750,5750,0,925,22992,-17242
INJ_407,20220101,8000,8000,0,-1,31999,-23999
INJ_407,20220103,12500,12500,0,1,49983,-37483
INJ_407,20220104,7250,7250,0,0,28987,-21737
INJ_407,20220105,2750,2750,0,2,10995,-8245
INJ_407,20220106,3250,3250,0,-1,12996,-9746
INJ_407,20220110,5500,4000,0,0,15992,-11992
INJ_407,20220111,4500,4500,0,0,17992,-13492
INJ_407,20220118,4750,4750,0,0,18996,-14246
INJ_407,20220121,3750,3750,0,872,14998,-11248
INJ_407,20220122,8000,8000,0,1,31988,-23988
INJ_407,20220125,11500,9500,0,-1,37991,-28491
INJ_407,20220128,3750,3750,0,0,14997,-11247
INJ_407,20220131,7250,7250,0,0,28993,-21743
INJ_407,20220202,4250,4250,0,-1,16991,-12741
INJ_407,20220203,7750,7750,0,1,30989,-23239
INJ_407,20220204,4000,4000,0,0,15993,-11993
INJ_407,20220205,3750,3750,0,1,14997,-11247
INJ_407,20220207,8250,8250,0,1,32991,-24741
INJ_407,20220209,4000,4000,1,207,15993,-11993
INJ_407,20220210,12000,12000,0,0,47988,-35988
INJ_407,20220211,6500,6500,0,0,25990,-19490
INJ_407,20220214,4500,4500,0,-1,17996,-13496
INJ_407,20220215,9000,7250,0,-1,28986,-21736
INJ_407,20220216,3250,3250,0,1,12995,-9745
INJ_407,20220217,15750,15750,0,1,62983,-47233
INJ_407,20220218,9750,8000,1,134,31988,-23988
INJ_407,20220219,4750,4750,0,1,18993,-14243
INJ_407,20220221,8250,8250,0,2,32993,-24743
INJ_407,20220222,3750,3750,0,1,14998,-11248
INJ_407,20220223,6500,2500,1,204,9999,-7499
INJ_407,20220224,6750,2500,0,0,9995,-7495
INJ_407,20220225,7750,7750,0,0,30996,-23246
INJ_407,20220226,7000,7000,0,-1,27992,-20992
INJ_407,20220302,10000,4250,0,0,16995,-12745
INJ_407,20220303,3500,3500,2,258,13997,-10497
INJ_407,20220304,7500,7500,0,0,29995,-22495
INJ_407,20220305,3250,3250,0,0,12997,-9747
INJ_407,20220308,7750,7750,0,0,30986,-23236
INJ_407,20220309,4500,4500,0,1,17995,-13495
INJ_407,20220310,8500,8500,0,1,33993,-25493
INJ_407,20220311,7000,7000,0,1,27993,-20993
INJ_407,20220312,7000,7000,0,0,27992,-20992
INJ_407,20220314,4250,4250,0,-1,16994,-12744
INJ_407,20220315,15500,13000,0,1,51983,-38983
INJ_407,20220316,17500,16250,0,2,64990,-48740
INJ_407,20220317,8000,8000,0,2,31995,-23995
INJ_407,20220318,8000,2000,0,-1,7999,-5999
INJ_407,20220319,7500,7500,0,0,29990,-22490
INJ_407,20220321,6250,6250,0,0,24994,-18744
INJ_407,20220322,7000,7000,0,0,27996,-20996
INJ_407,20220323,21750,5750,0,-1,22657,-16907
INJ_407,20220324,5500,5500,0,0,21999,-16499
INJ_407,20220328,7500,7500,0,-1,29990,-22490
INJ_407,20220330,3250,3250,0,717,12996,-9746
INJ_407,20220331,3750,3750,0,295,14995,-11245
INJ_407,20220401,7750,7000,0,0,27992,-20992
INJ_407,20220402,3750,3750,0,-1,14998,-11248
INJ_407,20220405,4250,4250,0,0,16999,-12749
INJ_407,20220407,2250,2250,0,0,8995,-6745
INJ_407,20220408,3750,3750,0,425,14991,-11241
INJ_407,20220409,19750,5750,0,194,22993,-17243
INJ_407,20220412,4250,4250,0,0,16989,-12739
INJ_407,20220414,8250,8250,0,403,32988,-24738
INJ_407,20220415,4250,4250,0,1,16993,-12743
INJ_407,20220416,6000,4250,0,0,16998,-12748
INJ_407,20220419,3310,3310,0,0,13143,-9833
INJ_407,20220421,4275,4275,0,-1,17042,-12767
INJ_407,20220428,4500,4500,0,0,17998,-13498
INJ_407,20220510,3250,3250,0,-1,12994,-9744
INJ_407,20220513,7500,7500,0,0,29994,-22494
INJ_407,20220518,5500,3750,0,-1,14995,-11245
INJ_407,20220519,3750,3750,0,1,14993,-11243
INJ_407,20220607,5000,3000,0,0,0,3000
INJ_407,20220610,4500,4500,0,1,17995,-13495
INJ_407,20220611,3750,3750,0,-1,14995,-11245
INJ_407,20220615,12500,12500,0,0,49989,-37489
INJ_407,20220620,4000,4000,0,0,15996,-11996
INJ_407,20220621,4750,4750,0,0,18989,-14239
INJ_407,20220622,4000,4000,0,1,15990,-11990
INJ_407,20220623,10250,7750,0,1,30988,-23238
INJ_407,20220624,3500,3500,0,1,13995,-10495
INJ_407,20220625,3750,3750,0,1,14993,-11243
INJ_407,20220628,4000,4000,0,1,15994,-11994
INJ_407,20220630,3750,3750,0,0,14996,-11246
INJ_407,20220706,14500,7000,0,0,27989,-20989
INJ_407,20220707,3750,3750,0,0,14995,-11245
INJ_407,20220708,4250,4250,0,0,16998,-12748
INJ_407,20220709,2500,2500,0,0,9997,-7497
INJ_407,20220720,8500,8500,0,1,33990,-25490
INJ_407,20220804,3775,3775,0,651,15058,-11283
INJ_407,20220810,3750,3750,0,0,14993,-11243
INJ_407,20220816,6500,6500,0,2,25992,-19492
INJ_407,20220820,4250,4250,0,0,16996,-12746
INJ_407,20220824,3750,3750,0,0,14998,-11248
INJ_407,20220825,3000,3000,0,1,11997,-8997
INJ_407,20220831,4500,1500,0,0,6000,-4500
INJ_407,20220902,8000,8000,0,1,31987,-23987
INJ_407,20220907,3500,3500,0,-1,13997,-10497
INJ_407,20220909,4000,4000,0,1,15998,-11998
INJ_407,20220910,4250,3250,0,0,16993,-13743
INJ_407,20220913,8250,2750,0,0,4379,-1629
INJ_407,20220916,3250,3250,18,887,12995,-9745
INJ_407,20220919,3750,3750,0,-1,14995,-11245
INJ_407,20220920,4250,4250,0,2,16997,-12747
INJ_407,20220924,3250,3250,0,1,12995,-9745
INJ_407,20220926,4000,4000,0,0,15997,-11997
INJ_407,20220927,3750,3750,0,1,14997,-11247
INJ_407,20220928,3750,3750,0,0,14997,-11247
INJ_407,20221005,10750,10750,0,1,42989,-32239
INJ_407,20221008,7975,4225,0,0,28044,-23819
INJ_407,20221010,3750,3750,0,4,14992,-11242
INJ_407,20221011,3750,3750,0,0,14998,-11248
INJ_407,20221012,3250,3250,0,0,12996,-9746
INJ_407,20221018,2750,2750,0,0,10999,-8249
INJ_407,20221022,3750,3750,0,0,14997,-11247
INJ_407,20221027,7750,7750,0,2,30993,-23243
INJ_407,20221028,3250,3250,0,0,12998,-9748
INJ_407,20221029,2500,2500,0,-1,9994,-7494
INJ_407,20221031,4500,4500,0,1,17996,-13496
INJ_407,20221101,3750,3750,0,0,14996,-11246
INJ_407,20221111,3250,3250,0,0,12994,-9744
INJ_407,20221117,5750,4000,0,0,15998,-11998
INJ_407,20221121,3750,3750,0,0,14995,-11245
INJ_407,20221125,7000,7000,0,0,27992,-20992
INJ_407,20221207,3750,3750,0,-1,14996,-11246
INJ_407,20221224,4775,4775,0,1,19053,-14278
INJ_407,20230102,21750,21750,0,3,86981,-65231
INJ_407,20230103,11500,11500,0,1,45994,-34494
INJ_407,20230104,4000,4000,0,0,15998,-11998
INJ_407,20230105,3750,3750,0,0,14998,-11248
INJ_407,20230106,1750,1750,0,0,7001,-5251
INJ_407,20230107,3750,3750,0,-1,15002,-11252
INJ_407,20230109,3750,3750,0,0,15003,-11253
INJ_407,20230110,7750,7750,0,0,31004,-23254
INJ_407,20230111,4000,4000,0,0,16003,-12003
INJ_407,20230114,4500,4500,-1,-904,0,4500
INJ_407,20230119,3750,3750,0,0,14996,-11246
INJ_407,20230120,5750,4750,0,0,18999,-14249
INJ_407,20230121,3250,3250,0,0,12998,-9748
INJ_407,20230123,6250,6250,0,-1,24998,-18748
INJ_407,20230314,20750,2000,0,0,7966,-5966
INJ_408,20211001,600,600,0,0,3996,-3396
INJ_408,20211005,1050,1050,0,1,6994,-5944
INJ_408,20211006,2100,2100,0,0,13990,-11890
INJ_408,20211008,1650,1650,0,0,10992,-9342
INJ_408,20211009,450,450,0,0,2998,-2548
INJ_408,20211011,450,450,0,0,2997,-2547
INJ_408,20211012,750,750,0,0,4998,-4248
INJ_408,20211015,600,600,0,0,3997,-3397
INJ_408,20211016,1950,1950,0,0,12991,-11041
INJ_408,20211018,600,600,0,1,3997,-3397
INJ_408,20211021,600,600,0,-1,3997,-3397
INJ_408,20211022,1350,900,0,1,5994,-5094
INJ_408,20211023,600,600,0,0,3996,-3396
INJ_408,20211025,1800,1200,0,1,7995,-6795
INJ_408,20211027,600,600,0,0,3997,-3397
INJ_408,20211028,900,900,0,0,5995,-5095
INJ_408,20211029,450,450,0,1,2997,-2547
INJ_408,20211030,1650,1650,0,-1,10989,-9339
INJ_408,20211102,600,600,0,1,3997,-3397
INJ_408,20211104,600,600,0,0,3997,-3397
INJ_408,20211105,1350,1350,0,0,8994,-7644
INJ_408,20211106,450,450,0,0,2996,-2546
INJ_408,20211108,1050,1050,0,0,6995,-5945
INJ_408,20211111,600,600,0,0,3998,-3398
INJ_408,20211112,1050,1050,0,-1,6994,-5944
INJ_408,20211115,750,750,0,0,4997,-4247
INJ_408,20211119,750,750,0,0,4997,-4247
INJ_408,20211123,2700,2700,0,1,17990,-15290
INJ_408,20211124,3000,3000,0,-1,19985,-16985
INJ_408,20211125,600,600,0,0,3997,-3397
INJ_408,20211126,600,600,0,0,3997,-3397
INJ_408,20211127,1800,1800,0,0,11990,-10190
INJ_408,20211129,600,600,0,0,3995,-3395
INJ_408,20211204,450,450,0,0,2997,-2547
INJ_408,20211206,600,600,0,-1,3997,-3397
INJ_408,20211207,750,750,0,0,4996,-4246
INJ_408,20211213,600,600,0,0,3996,-3396
INJ_408,20211214,1050,1050,0,0,6993,-5943
INJ_408,20211215,450,450,0,1,2996,-2546
INJ_408,20211216,600,600,0,0,3997,-3397
INJ_408,20211217,1050,1050,0,18,6995,-5945
INJ_408,20211218,1050,1050,0,1,6996,-5946
INJ_408,20211220,600,600,0,-1,3996,-3396
INJ_408,20211221,2100,1500,0,0,9989,-8489
INJ_408,20211222,1200,1200,0,0,7992,-6792
INJ_408,20211223,600,600,0,1,3997,-3397
INJ_408,20211224,3300,3300,0,0,21985,-18685
INJ_408,20211225,600,600,0,0,3996,-3396
INJ_408,20211227,600,600,0,0,3995,-3395
INJ_408,20211228,1500,1500,0,0,9990,-8490
INJ_408,20211229,900,900,0,0,5996,-5096
INJ_408,20211230,450,450,0,0,2997,-2547
INJ_408,20211231,3600,3600,0,1,23983,-20383
INJ_408,20220101,1050,1050,0,-1,6994,-5944
INJ_408,20220103,1200,1200,0,1,7993,-6793
INJ_408,20220104,1050,1050,0,0,6993,-5943
INJ_408,20220105,1200,1200,0,-1,7995,-6795
INJ_408,20220106,600,600,0,0,3997,-3397
INJ_408,20220110,1200,600,0,0,3997,-3397
INJ_408,20220121,450,450,0,0,2997,-2547
INJ_408,20220122,1200,1200,0,0,7994,-6794
INJ_408,20220125,450,450,0,0,2997,-2547
INJ_408,20220128,450,450,0,1,2997,-2547
INJ_408,20220131,900,900,0,-1,5997,-5097
INJ_408,20220202,450,450,0,0,2996,-2546
INJ_408,20220203,1500,1500,0,1,9992,-8492
INJ_408,20220207,600,600,0,1,3997,-3397
INJ_408,20220209,450,450,0,0,2996,-2546
INJ_408,20220210,1500,1500,0,0,9991,-8491
INJ_408,20220211,1650,1650,0,0,10990,-9340
INJ_408,20220215,1350,1350,0,0,8992,-7642
INJ_408,20220216,450,450,0,0,2997,-2547
INJ_408,20220217,1650,1650,0,0,10990,-9340
INJ_408,20220221,1050,1050,0,0,6993,-5943
INJ_408,20220223,750,750,0,0,4997,-4247
INJ_408,20220224,600,600,0,-1,3997,-3397
INJ_408,20220225,1050,1050,0,0,6995,-5945
INJ_408,20220226,1800,1800,0,0,11992,-10192
INJ_408,20220303,600,600,0,0,3996,-3396
INJ_408,20220304,1350,1350,0,0,8993,-7643
INJ_408,20220305,450,450,0,0,2997,-2547
INJ_408,20220308,1350,1350,0,-1,8994,-7644
INJ_408,20220310,450,450,0,0,2997,-2547
INJ_408,20220311,1350,1350,0,0,8994,-7644
INJ_408,20220312,1200,1200,0,0,7993,-6793
INJ_408,20220314,450,450,0,0,2997,-2547
INJ_408,20220315,3300,2700,0,1,17984,-15284
INJ_408,20220316,2700,2700,0,0,17986,-15286
INJ_408,20220317,1200,1200,0,0,7993,-6793
INJ_408,20220318,1200,1200,0,0,7993,-6793
INJ_408,20220319,450,450,0,0,2997,-2547
INJ_408,20220321,1800,1800,0,0,11991,-10191
INJ_408,20220322,1350,1350,0,0,8994,-7644
INJ_408,20220323,1950,1500,0,-1,9991,-8491
INJ_408,20220324,1650,1650,0,1,10991,-9341
INJ_408,20220328,600,600,0,0,3998,-3398
INJ_408,20220405,450,450,0,0,2996,-2546
INJ_408,20220407,600,600,0,0,3997,-3397
INJ_408,20220409,1200,1200,0,0,7993,-6793
INJ_408,20220414,450,450,0,0,2996,-2546
INJ_408,20220415,450,450,0,0,2997,-2547
INJ_408,20220416,450,450,0,0,2998,-2548
INJ_408,20220419,750,750,0,0,4996,-4246
INJ_408,20220510,750,750,0,0,4998,-4248
INJ_408,20220513,450,450,0,0,2996,-2546
INJ_408,20220519,600,600,0,0,3997,-3397
INJ_408,20220606,5700,5700,0,-2,37974,-32274
INJ_408,20220607,450,450,0,0,2996,-2546
INJ_408,20220610,600,600,0,0,3996,-3396
INJ_408,20220611,1200,1200,0,0,7994,-6794
INJ_408,20220614,5250,5250,0,0,34983,-29733
INJ_408,20220615,5400,5400,0,0,35977,-30577
INJ_408,20220620,600,600,0,0,3996,-3396
INJ_408,20220624,750,750,0,0,4996,-4246
INJ_408,20220625,450,450,0,0,2997,-2547
INJ_408,20220630,600,600,0,0,3996,-3396
INJ_408,20220706,1050,1050,0,0,6994,-5944
INJ_408,20220707,1200,1200,0,-1,7993,-6793
INJ_408,20220708,450,450,0,1,2998,-2548
INJ_408,20220709,750,750,0,0,4996,-4246
INJ_408,20220720,1650,1650,0,0,10993,-9343
INJ_408,20220816,1350,1350,0,0,8994,-7644
INJ_408,20220820,450,450,0,0,2998,-2548
INJ_408,20220824,1050,1050,0,1,6992,-5942
INJ_408,20220825,1950,1950,0,0,12988,-11038
INJ_408,20220831,450,450,0,0,2995,-2545
INJ_408,20220902,600,600,0,0,3995,-3395
INJ_408,20220907,600,600,0,0,3995,-3395
INJ_408,20220909,1500,1500,0,0,9997,-8497
INJ_408,20220910,450,450,0,0,2997,-2547
INJ_408,20220913,2850,1800,0,0,11994,-10194
INJ_408,20220916,450,450,0,0,2997,-2547
INJ_408,20220919,450,450,0,0,2997,-2547
INJ_408,20220920,450,450,0,0,2996,-2546
INJ_408,20220924,750,750,0,0,4997,-4247
INJ_408,20220926,600,600,0,0,3997,-3397
INJ_408,20220927,450,450,0,0,2997,-2547
INJ_408,20220928,600,600,0,0,3995,-3395
INJ_408,20221010,750,750,0,1,4996,-4246
INJ_408,20221022,1050,1050,0,-1,6994,-5944
INJ_408,20221027,1650,1650,0,0,10994,-9344
INJ_408,20221029,1500,1500,0,1,9997,-8497
INJ_408,20221111,750,750,0,0,4995,-4245
INJ_408,20221121,6000,750,0,1,4996,-4246
INJ_408,20221207,1800,450,0,0,2997,-2547
INJ_408,20221224,9000,900,0,1,5997,-5097
INJ_408,20230102,8400,1200,0,1,7994,-6794
INJ_408,20230103,13200,1800,0,0,11989,-10189
INJ_408,20230104,4200,600,0,0,3996,-3396
INJ_408,20230105,6000,750,0,1,4997,-4247
INJ_408,20230106,2250,450,0,0,2996,-2546
INJ_408,20230107,6000,750,0,0,4996,-4246
INJ_408,20230109,1800,450,0,2,2996,-2546
INJ_408,20230110,4650,1050,0,0,6993,-5943
INJ_408,20230119,15600,1200,0,0,7994,-6794
INJ_408,20230120,2250,450,0,0,2997,-2547
INJ_408,20230121,2250,450,0,0,2998,-2548
INJ_408,20230316,450,450,2,998,2996,-2546
INJ_408,20230320,600,600,7,197,3994,-3394
INJ_408,20230321,600,600,4,797,3994,-3394
INJ_408,20230324,1950,1950,0,0,12976,-11026
INJ_408,20230327,600,600,0,1,3994,-3394
INJ_408,20230328,600,600,6,602,3993,-3393
INJ_408,20230330,1050,1050,4,204,6987,-5937
INJ_408,20230401,1200,600,1,498,3995,-3395
INJ_408,20230403,1800,1800,3,599,11983,-10183
INJ_408,20230404,450,450,5,700,2994,-2544
INJ_408,20230406,1950,1950,1,499,12985,-11035
INJ_408,20230407,1800,1800,4,503,11985,-10185
INJ_408,20230408,750,750,6,3,4995,-4245
INJ_408,20230412,1800,1800,4,201,11985,-10185
INJ_408,20230413,600,600,3,598,3994,-3394
INJ_408,20230418,900,450,0,0,2992,-2542
INJ_408,20230419,2250,1650,1,198,10983,-9333
INJ_408,20230420,3150,2700,1,201,17970,-15270
INJ_408,20230421,900,450,6,298,2994,-2544
INJ_408,20230424,1050,1050,0,902,6990,-5940
INJ_408,20230425,1950,1350,3,898,8991,-7641
INJ_408,20230426,600,600,4,504,3995,-3395
INJ_408,20230428,1350,900,3,604,5988,-5088
INJ_408,20230502,1650,1200,0,0,7990,-6790
INJ_408,20230506,450,450,2,999,2995,-2545
INJ_408,20230508,900,900,1,198,5990,-5090
INJ_408,20230510,1200,1200,2,398,7992,-6792
INJ_408,20230511,600,600,3,298,3996,-3396
INJ_408,20230512,1050,1050,1,997,6990,-5940
INJ_408,20230513,750,750,3,1,4994,-4244
INJ_408,20230515,1200,1200,2,414,7990,-6790
INJ_408,20230517,1200,1200,4,838,7990,-6790
INJ_408,20230518,900,450,3,302,2995,-2545
INJ_408,20230519,1050,1050,3,3,6991,-5941
INJ_408,20230523,450,450,1,201,2994,-2544
INJ_408,20230526,2100,2100,6,952,13982,-11882
INJ_408,20230527,2400,1200,4,498,7992,-6792
INJ_408,20230531,1200,1200,1,497,7994,-6794
INJ_408,20230601,600,600,4,498,3995,-3395
INJ_408,20230602,1350,1350,2,701,8988,-7638
INJ_408,20230603,1200,1200,8,404,7990,-6790
INJ_408,20230605,900,900,1,803,5988,-5088
INJ_408,20230608,450,450,4,497,2996,-2546
INJ_408,20230614,450,450,1,500,2995,-2545
INJ_408,20230616,1500,1500,1,799,9981,-8481
INJ_408,20230617,750,750,9,892,4995,-4245
INJ_408,20230620,1950,1350,2,404,8987,-7637
INJ_408,20230621,750,750,0,902,4992,-4242
INJ_408,20230623,1350,1350,8,697,8988,-7638
INJ_408,20230624,1350,1350,2,400,8988,-7638
INJ_408,20230626,1650,1200,2,699,7989,-6789
INJ_408,20230627,600,600,4,497,3995,-3395
INJ_408,20230628,1650,1650,1,499,10990,-9340
INJ_408,20230630,1800,1800,4,497,11988,-10188
INJ_408,20230701,900,900,4,951,5994,-5094
INJ_408,20230703,750,750,5,398,4994,-4244
INJ_408,20230705,1200,1200,6,1,7987,-6787
INJ_408,20230707,2250,2250,0,1,14980,-12730
INJ_408,20230708,750,750,1,501,4995,-4245
INJ_408,20230710,450,450,1,802,2994,-2544
INJ_408,20230712,1500,1500,1,199,9994,-8494
INJ_408,20230713,1500,750,1,903,4994,-4244
INJ_408,20230715,450,450,0,872,2994,-2544
INJ_408,20230717,450,450,0,300,2993,-2543
INJ_409,20210929,4250,4250,0,0,16997,-12747
INJ_409,20210930,11000,11000,0,1,43984,-32984
INJ_409,20211001,14250,10500,0,1,41982,-31482
INJ_409,20211004,6500,6500,0,0,25992,-19492
INJ_409,20211005,7000,7000,0,0,27991,-20991
INJ_409,20211006,7250,7250,0,2,28988,-21738
INJ_409,20211008,9750,9750,0,0,38992,-29242
INJ_409,20211009,3250,3250,0,0,12998,-9748
INJ_409,20211011,4500,4500,0,0,17995,-13495
INJ_409,20211012,7000,7000,0,2,27993,-20993
INJ_409,20211015,15500,11750,0,1,50182,-38432
INJ_409,20211016,10000,10000,0,1,39986,-29986
INJ_409,20211018,3250,3250,0,0,12994,-9744
INJ_409,20211019,4000,4000,0,0,15996,-11996
INJ_409,20211021,3500,3500,0,1,13995,-10495
INJ_409,20211022,15250,10500,0,0,43853,-33353
INJ_409,20211023,5000,3250,0,0,18641,-15391
INJ_409,20211025,8250,6750,0,0,26996,-20246
INJ_409,20211027,3500,3500,0,0,13995,-10495
INJ_409,20211028,7000,7000,0,0,27993,-20993
INJ_409,20211029,3250,3250,0,0,12998,-9748
INJ_409,20211030,7000,7000,0,1,27997,-20997
INJ_409,20211102,9500,8250,0,0,32992,-24742
INJ_409,20211103,5000,5000,0,-1,19996,-14996
INJ_409,20211104,3500,3500,0,0,13995,-10495
INJ_409,20211105,6250,6250,0,0,24997,-18747
INJ_409,20211108,6500,6500,0,0,25994,-19494
INJ_409,20211111,3250,3250,0,-1,12996,-9746
INJ_409,20211112,7750,7750,0,0,30988,-23238
INJ_409,20211115,5000,5000,0,0,19995,-14995
INJ_409,20211119,6500,6500,0,-1,25991,-19491
INJ_409,20211123,10500,10500,0,1,41986,-31486
INJ_409,20211124,9250,9250,0,2,36991,-27741
INJ_409,20211125,3500,3500,0,1,13997,-10497
INJ_409,20211126,8000,8000,0,-1,31995,-23995
INJ_409,20211127,9500,9500,0,0,37994,-28494
INJ_409,20211129,7500,7500,0,1,29988,-22488
INJ_409,20211202,3250,3250,0,0,12997,-9747
INJ_409,20211203,7750,7750,0,1,30989,-23239
INJ_409,20211204,3250,3250,0,0,12995,-9745
INJ_409,20211206,3750,3750,0,0,14999,-11249
INJ_409,20211207,4750,2750,0,0,10999,-8249
INJ_409,20211209,5250,3250,0,1,12981,-9731
INJ_409,20211213,3250,3250,0,0,12998,-9748
INJ_409,20211214,11500,7750,0,1,30998,-23248
INJ_409,20211215,7750,7750,0,1,30993,-23243
INJ_409,20211216,3500,3500,0,1,13998,-10498
INJ_409,20211217,7000,7000,0,1,27996,-20996
INJ_409,20211218,10000,6750,0,1,26996,-20246
INJ_409,20211220,5250,3500,0,-1,17750,-14250
INJ_409,20211221,18250,10750,0,1,42991,-32241
INJ_409,20211222,2000,2000,0,0,7999,-5999
INJ_409,20211223,3250,3250,0,0,12994,-9744
INJ_409,20211224,15250,13250,0,2,52978,-39728
INJ_409,20211225,3500,3500,0,0,13993,-10493
INJ_409,20211227,8750,8000,0,1,31991,-23991
INJ_409,20211228,6500,6500,0,1,25995,-19495
INJ_409,20211229,3000,3000,0,2,11998,-8998
INJ_409,20211230,3750,3750,0,1,15000,-11250
INJ_409,20211231,13000,13000,0,2,51993,-38993
INJ_409,20220101,6750,6750,0,0,27003,-20253
INJ_409,20220103,10250,10250,0,-1,40986,-30736
INJ_409,20220104,7500,7500,0,2,29989,-22489
INJ_409,20220105,3500,3500,0,-1,13997,-10497
INJ_409,20220106,4000,4000,0,1,15997,-11997
INJ_409,20220110,5250,3250,0,1,12996,-9746
INJ_409,20220111,3750,3750,0,1,14996,-11246
INJ_409,20220118,3500,3500,0,0,13997,-10497
INJ_409,20220121,3750,3750,0,1,14993,-11243
INJ_409,20220122,6500,6500,0,0,25993,-19493
INJ_409,20220125,6250,6250,0,-2,24994,-18744
INJ_409,20220128,3750,3750,0,2,14997,-11247
INJ_409,20220131,8250,8250,0,0,32997,-24747
INJ_409,20220202,3250,3250,0,1,12997,-9747
INJ_409,20220203,6250,6250,0,0,24999,-18749
INJ_409,20220204,4250,4250,0,1,16995,-12745
INJ_409,20220205,4500,4500,0,0,17996,-13496
INJ_409,20220207,7250,7250,0,-1,28995,-21745
INJ_409,20220209,3500,3500,0,1,13996,-10496
INJ_409,20220210,10250,10250,0,1,40989,-30739
INJ_409,20220211,7250,7250,0,0,28998,-21748
INJ_409,20220214,3750,3750,0,1,14997,-11247
INJ_409,20220215,8750,7000,0,0,27995,-20995
INJ_409,20220216,4250,4250,0,1,16996,-12746
INJ_409,20220217,14500,14500,0,2,57989,-43489
INJ_409,20220218,8500,8500,0,2,33993,-25493
INJ_409,20220219,3500,3500,0,-1,13999,-10499
INJ_409,20220221,6500,6500,0,1,25994,-19494
INJ_409,20220222,4500,4500,0,0,17996,-13496
INJ_409,20220223,4500,4500,0,0,18002,-13502
INJ_409,20220224,4750,4750,0,1,18996,-14246
INJ_409,20220225,7000,7000,0,-2,27995,-20995
INJ_409,20220226,6500,6500,0,1,25855,-19355
INJ_409,20220302,6000,4000,0,0,15998,-11998
INJ_409,20220303,3750,3750,0,0,15000,-11250
INJ_409,20220304,6750,6750,0,4,27000,-20250
INJ_409,20220305,4250,4250,0,1,16997,-12747
INJ_409,20220308,6500,6500,0,1,25998,-19498
INJ_409,20220309,3750,3750,0,1,15001,-11251
INJ_409,20220310,7250,7250,0,0,28996,-21746
INJ_409,20220311,7250,7250,0,-1,28990,-21740
INJ_409,20220312,7500,7500,0,2,29994,-22494
INJ_409,20220314,3750,3750,0,0,14997,-11247
INJ_409,20220315,17500,15500,0,-1,61993,-46493
INJ_409,20220316,14500,13750,0,0,55005,-41255
INJ_409,20220317,6500,6500,0,3,25995,-19495
INJ_409,20220318,4250,4250,0,1,16998,-12748
INJ_409,20220319,8250,8250,0,1,32997,-24747
INJ_409,20220321,7250,7250,0,1,28999,-21749
INJ_409,20220322,7250,7250,0,2,29001,-21751
INJ_409,20220323,11000,8250,0,-1,33341,-25091
INJ_409,20220324,6750,6750,0,3,26998,-20248
INJ_409,20220328,8000,8000,0,1,31995,-23995
INJ_409,20220330,5000,5000,0,1,19995,-14995
INJ_409,20220331,3500,3500,0,1,13998,-10498
INJ_409,20220401,9500,9500,0,0,37995,-28495
INJ_409,20220402,5000,5000,0,0,19997,-14997
INJ_409,20220405,3750,3750,0,0,15000,-11250
INJ_409,20220407,5000,5000,0,0,19995,-14995
INJ_409,20220408,4500,4500,0,1,17995,-13495
INJ_409,20220409,13000,9250,0,0,36995,-27745
INJ_409,20220412,4000,4000,0,1,15998,-11998
INJ_409,20220414,7500,7500,0,0,29995,-22495
INJ_409,20220415,3250,3250,0,1,12997,-9747
INJ_409,20220416,4500,3250,0,0,12998,-9748
INJ_409,20220419,3750,3750,0,0,14995,-11245
INJ_409,20220421,4000,4000,0,0,15996,-11996
INJ_409,20220428,3750,3750,0,1,15000,-11250
INJ_409,20220510,3750,3750,0,2,14998,-11248
INJ_409,20220513,8750,8750,0,1,34996,-26246
INJ_409,20220518,6500,4500,0,1,17995,-13495
INJ_409,20220519,3500,3500,0,0,13997,-10497
INJ_409,20220606,7000,7000,0,1,27885,-20885
INJ_409,20220607,7500,4500,0,1,29992,-25492
INJ_409,20220610,2750,2750,0,0,10995,-8245
INJ_409,20220611,2500,2500,0,0,9995,-7495
INJ_409,20220615,3750,3750,0,1,14999,-11249
INJ_409,20220620,3250,3250,0,1,12993,-9743
INJ_409,20220621,3500,3500,0,-1,13994,-10494
INJ_409,20220622,4275,4275,0,0,17046,-12771
INJ_409,20220623,13000,9250,0,1,36983,-27733
INJ_409,20220624,3500,3500,0,0,13995,-10495
INJ_409,20220625,3750,3750,0,0,14998,-11248
INJ_409,20220628,4275,4275,0,1,17064,-12789
INJ_409,20220630,3500,3500,0,1,13995,-10495
INJ_409,20220706,19500,8250,0,1,32992,-24742
INJ_409,20220707,2500,2500,0,0,9997,-7497
INJ_409,20220708,3250,3250,0,0,12996,-9746
INJ_409,20220709,4500,4500,0,1,17993,-13493
INJ_409,20220720,5250,5250,0,2,20993,-15743
INJ_409,20220804,4500,4500,0,1,17994,-13494
INJ_409,20220810,4500,4500,0,2,17990,-13490
INJ_409,20220816,7750,7750,0,1,30992,-23242
INJ_409,20220820,3250,3250,0,0,13001,-9751
INJ_409,20220824,2750,2750,0,1,10995,-8245
INJ_409,20220825,2000,2000,0,1,7997,-5997
INJ_409,20220831,6000,6000,0,1,23995,-17995
INJ_409,20220902,7500,7500,0,0,29990,-22490
INJ_409,20220907,3750,3750,0,0,14997,-11247
INJ_409,20220909,1750,1750,0,0,6999,-5249
INJ_409,20220910,4250,4250,0,0,12998,-8748
INJ_409,20220913,2500,2500,0,0,9998,-7498
INJ_409,20220916,4250,4250,0,1,16992,-12742
INJ_409,20220919,3750,3750,0,0,14997,-11247
INJ_409,20220920,3250,3250,0,0,12997,-9747
INJ_409,20220924,3750,3750,0,1,14996,-11246
INJ_409,20220926,3250,3250,0,0,12996,-9746
INJ_409,20220927,3750,3750,0,0,14997,-11247
INJ_409,20220928,3500,3500,0,1,13995,-10495
INJ_409,20221005,12000,12000,0,2,47990,-35990
INJ_409,20221008,5750,4750,0,0,20255,-15505
INJ_409,20221010,3250,3250,0,1,12995,-9745
INJ_409,20221011,3750,3750,0,2,14995,-11245
INJ_409,20221018,5000,3250,0,-1,12996,-9746
INJ_409,20221022,2750,2750,0,-1,10995,-8245
INJ_409,20221027,6000,6000,0,0,23991,-17991
INJ_409,20221028,3750,3750,0,-1,14995,-11245
INJ_409,20221029,3750,3750,0,0,14999,-11249
INJ_409,20221031,3750,3750,0,1,14997,-11247
INJ_409,20221101,3750,3750,0,1,14993,-11243
INJ_409,20221111,3750,3750,0,-1,14997,-11247
INJ_409,20221117,5000,3250,0,0,12996,-9746
INJ_409,20221121,3250,3250,0,1,12993,-9743
INJ_409,20221125,8000,8000,0,1,31985,-23985
INJ_409,20221207,3750,3750,0,-1,14997,-11247
INJ_409,20221224,2000,2000,0,0,7999,-5999
INJ_409,20230103,10250,10250,0,2,40994,-30744
INJ_409,20230104,3250,3250,0,-1,12999,-9749
INJ_409,20230105,3250,3250,0,0,12997,-9747
INJ_409,20230106,5750,5750,0,0,22998,-17248
INJ_409,20230107,3250,3250,0,1,13000,-9750
INJ_409,20230109,3750,3750,0,1,15003,-11253
INJ_409,20230110,7000,7000,0,0,28000,-21000
INJ_409,20230111,4250,4250,0,1,17001,-12751
INJ_409,20230114,3750,3750,-1,-797,0,3750
INJ_409,20230119,2500,2500,0,2,9998,-7498
INJ_409,20230120,2750,2750,0,-1,11000,-8250
INJ_409,20230121,4250,4250,0,0,17000,-12750
INJ_409,20230123,8750,8750,0,2,34996,-26246
INJ_409,20230314,19500,1500,0,0,5999,-4499
INJ_501,20210927,18000,16200,0,0,100922,-84722
INJ_501,20210928,31200,31200,0,601,103915,-72715
INJ_501,20210929,31800,31800,0,-1,101687,-69887
INJ_501,20210930,30600,30600,0,0,101922,-71322
INJ_501,20211001,54600,52200,0,-2,167980,-115780
INJ_501,20211002,30900,29100,0,3,96936,-67836
INJ_501,20211004,32100,32100,0,2,106918,-74818
INJ_501,20211005,31200,28200,0,0,93938,-65738
INJ_501,20211006,33600,30000,0,0,99930,-69930
INJ_501,20211007,34200,34200,0,-1,113941,-79741
INJ_501,20211008,17100,17100,0,1,56957,-39857
INJ_501,20211009,60600,51600,0,-1,171885,-120285
INJ_501,20211011,36300,36300,0,0,120920,-84620
INJ_501,20211012,29400,25200,0,1,83946,-58746
INJ_501,20211013,9900,9900,18,5,32979,-23079
INJ_501,20211014,48600,3900,0,-1,12992,-9092
INJ_501,20211015,19500,2100,0,0,6989,-4889
INJ_501,20211022,41100,36000,0,447,112493,-76493
INJ_501,20211023,45300,39300,0,-1,130921,-91621
INJ_501,20211025,12300,10500,0,-2,34976,-24476
INJ_501,20211026,14100,14100,0,0,46959,-32859
INJ_501,20211027,32400,32400,0,-2,107913,-75513
INJ_501,20211028,32400,32400,0,-2,107921,-75521
INJ_501,20211029,21900,21900,0,-1,72958,-51058
INJ_501,20211030,33900,33900,0,1,112934,-79034
INJ_501,20211101,21600,21600,0,0,71948,-50348
INJ_501,20211102,24900,22500,0,0,74947,-52447
INJ_501,20211103,37800,37800,0,1,125930,-88130
INJ_501,20211104,40800,40800,0,-3,135912,-95112
INJ_501,20211105,59100,59100,0,1,196889,-137789
INJ_501,20211106,41400,41400,0,2,137912,-96512
INJ_501,20211108,39900,36900,0,-2,122872,-85972
INJ_501,20211109,23100,23100,0,-2,76937,-53837
INJ_501,20211110,46500,46500,0,0,154897,-108397
INJ_501,20211111,42000,34200,0,-2,113938,-79738
INJ_501,20211112,47100,41100,0,-1,136889,-95789
INJ_501,20211113,29400,27000,0,-1,83362,-56362
INJ_501,20211115,7200,5400,0,0,22699,-17299
INJ_501,20211116,12600,12600,0,0,41970,-29370
INJ_501,20211117,39300,39300,0,-1,122942,-83642
INJ_501,20211118,23100,20100,0,-2,71946,-51846
INJ_501,20211119,25800,25800,0,0,85947,-60147
INJ_501,20211120,36600,36600,0,-2,121920,-85320
INJ_501,20211122,31200,5100,0,1,17510,-12410
INJ_501,20211124,4800,2400,0,0,1095,1305
INJ_501,20211126,33300,31200,0,0,103930,-72730
INJ_501,20211127,31800,28800,0,0,95936,-67136
INJ_501,20211129,27000,24600,0,1,81928,-57328
INJ_501,20211130,21000,18000,0,0,59960,-41960
INJ_501,20211201,48600,46200,0,1,153867,-107667
INJ_501,20211202,29700,29700,0,0,98919,-69219
INJ_501,20211203,40800,36000,0,601,131901,-95901
INJ_501,20211204,37800,37800,0,2,125905,-88105
INJ_501,20211206,18000,17100,0,-2,44964,-27864
INJ_501,20211207,8400,8400,0,0,27979,-19579
INJ_501,20211208,21000,21000,0,0,69948,-48948
INJ_501,20211209,12900,12900,0,0,42971,-30071
INJ_501,20211210,37500,37500,0,1,124913,-87413
INJ_501,20211211,28500,24900,0,0,82945,-58045
INJ_501,20211213,32700,30000,0,1,99933,-69933
INJ_501,20211214,37200,35700,0,1,118921,-83221
INJ_501,20211215,45000,42600,0,0,141899,-99299
INJ_501,20211216,47700,39300,0,0,124607,-85307
INJ_501,20211217,33900,32700,0,1,108927,-76227
INJ_501,20211218,44700,40500,0,-3,134909,-94409
INJ_501,20211220,12000,2400,0,0,2968,-568
INJ_501,20211221,56400,52800,0,1,175874,-123074
INJ_501,20211222,53400,53400,0,-2,177750,-124350
INJ_501,20211223,31500,29100,0,1,96942,-67842
INJ_501,20211224,17430,15630,0,-1,51977,-36347
INJ_501,20211225,12600,11400,0,-1,37961,-26561
INJ_501,20211227,34500,34500,0,0,114921,-80421
INJ_501,20211228,27300,23100,0,-1,76939,-53839
INJ_501,20211229,17400,17400,0,0,57959,-40559
INJ_501,20211230,34800,34800,0,0,115914,-81114
INJ_501,20211231,54000,54000,0,2,179863,-125863
INJ_501,20220101,36000,36000,0,-2,119925,-83925
INJ_501,20220103,56400,55200,0,-2,183851,-128651
INJ_501,20220104,46200,43800,0,2,145884,-102084
INJ_501,20220105,14700,9900,0,-1,26098,-16198
INJ_501,20220106,7200,2400,0,0,1675,725
INJ_501,20220108,8100,2700,0,0,1865,835
INJ_501,20220126,39300,39300,0,-2,130921,-91621
INJ_501,20220127,38100,38100,0,0,126909,-88809
INJ_501,20220128,39300,39300,0,0,130908,-91608
INJ_501,20220129,66600,58800,0,-3,195869,-137069
INJ_501,20220131,35400,35400,0,3,117919,-82519
INJ_501,20220201,53400,49800,0,-1,165889,-116089
INJ_501,20220202,34500,34500,0,1,114917,-80417
INJ_501,20220203,34800,34800,0,0,115905,-81105
INJ_501,20220204,42600,40800,0,3,135906,-95106
INJ_501,20220205,49800,49800,0,0,165903,-116103
INJ_501,20220207,59400,56700,0,0,188865,-132165
INJ_501,20220208,22200,22200,0,1,73948,-51748
INJ_501,20220209,30000,28800,0,1,95930,-67130
INJ_501,20220210,38400,38400,0,2,127896,-89496
INJ_501,20220211,49800,49800,0,-3,165893,-116093
INJ_501,20220212,51300,51300,0,-2,170879,-119579
INJ_501,20220214,51000,46800,0,0,155901,-109101
INJ_501,20220215,42600,41700,0,-1,138891,-97191
INJ_501,20220216,39635,37235,0,3,124026,-86791
INJ_501,20220217,57000,57000,0,0,189855,-132855
INJ_501,20220218,38400,38400,0,0,127899,-89499
INJ_501,20220219,66900,21300,0,-1,67251,-45951
INJ_501,20220711,3600,1200,0,0,1248,-48
INJ_501,20220912,375,375,0,0,2997,-2622
INJ_501,20220919,1375,1375,0,0,10994,-9619
INJ_501,20220927,500,500,0,-1,3997,-3497
INJ_501,20220928,750,750,0,0,5997,-5247
INJ_501,20220930,1000,1000,0,0,7992,-6992
INJ_501,20221004,500,500,0,0,3997,-3497
INJ_501,20221005,750,750,0,-1,5990,-5240
INJ_501,20221012,500,500,0,0,3995,-3495
INJ_501,20221025,375,375,0,0,2997,-2622
INJ_501,20221102,375,375,0,0,2995,-2620
INJ_501,20221109,750,750,0,0,5997,-5247
INJ_501,20221112,375,375,0,0,2995,-2620
INJ_501,20221114,500,500,0,0,3997,-3497
INJ_501,20221115,375,375,0,1,2994,-2619
INJ_501,20221116,250,250,0,-1,1995,-1745
INJ_501,20221121,750,750,0,0,5995,-5245
INJ_501,20221202,375,375,0,0,2997,-2622
INJ_501,20221205,375,375,0,0,2997,-2622
INJ_501,20221210,625,625,0,0,4993,-4368
INJ_501,20221213,500,500,0,0,3994,-3494
INJ_501,20221228,375,375,0,1,2997,-2622
INJ_501,20221231,375,375,0,0,2994,-2619
INJ_501,20230102,750,750,0,0,5998,-5248
INJ_501,20230103,500,500,0,0,3996,-3496
INJ_501,20230110,375,375,0,0,2995,-2620
INJ_501,20230112,375,375,0,-1,2997,-2622
INJ_501,20230120,1500,1500,0,0,11991,-10491
INJ_501,20230124,375,375,0,0,2995,-2620
INJ_501,20230128,500,500,0,0,3996,-3496
INJ_501,20230130,375,375,0,0,2997,-2622
INJ_501,20230202,500,500,0,0,3994,-3494
INJ_501,20230207,375,375,0,0,2996,-2621
INJ_501,20230208,250,250,0,0,1995,-1745
INJ_501,20230209,500,500,0,0,3993,-3493
INJ_501,20230210,500,500,0,0,3994,-3494
INJ_501,20230211,250,250,0,0,1994,-1744
INJ_501,20230213,625,625,0,0,4994,-4369
INJ_501,20230216,750,750,0,0,5994,-5244
INJ_501,20230221,500,500,0,0,3998,-3498
INJ_501,20230223,375,375,0,0,2996,-2621
INJ_501,20230225,1375,1375,0,0,10990,-9615
INJ_501,20230228,625,625,0,1,4991,-4366
INJ_501,20230301,500,500,0,0,3996,-3496
INJ_501,20230302,375,375,0,0,2995,-2620
INJ_501,20230303,375,375,0,0,2998,-2623
INJ_501,20230306,750,750,0,0,5995,-5245
INJ_501,20230308,375,375,0,0,2997,-2622
INJ_501,20230309,500,500,0,0,3995,-3495
INJ_501,20230314,5650,4150,0,0,14988,-10838
INJ_501,20230316,500,500,0,0,3997,-3497
INJ_501,20230323,375,375,0,-1,2998,-2623
INJ_501,20230325,375,375,0,0,2995,-2620
INJ_501,20230405,750,750,0,0,5995,-5245
INJ_501,20230413,375,375,0,0,2998,-2623
INJ_501,20230419,500,500,0,0,3994,-3494
INJ_501,20230420,250,250,0,1,1996,-1746
INJ_501,20230424,1125,1125,0,-1,8990,-7865
INJ_501,20230427,500,500,0,0,3995,-3495
INJ_501,20230428,375,375,0,0,2996,-2621
INJ_501,20230505,7900,7900,0,1,30975,-23075
INJ_501,20230506,19450,19450,0,-2,65958,-46508
INJ_501,20230508,28750,28750,0,1,96948,-68198
INJ_501,20230509,54710,51800,0,1,181892,-130092
INJ_501,20230510,50420,49730,0,-3,214878,-165148
INJ_501,20230511,40260,37040,0,0,154228,-117188
INJ_501,20230512,41860,39100,-2,-787,169908,-130808
INJ_501,20230513,59310,59310,0,0,252833,-193523
INJ_501,20230515,34730,34730,0,1,147455,-112725
INJ_501,20230516,20470,20470,0,-1,88949,-68479
INJ_501,20230517,47800,46420,0,2,199885,-153465
INJ_501,20230518,46970,46970,0,0,202880,-155910
INJ_501,20230519,37790,37790,0,2,153475,-115685
INJ_501,20230520,41170,41170,0,0,178891,-137721
INJ_501,20230522,67120,59760,0,2,254587,-194827
INJ_501,20230523,34920,32160,0,0,137812,-105652
INJ_501,20230524,29170,29170,0,0,124934,-95764
INJ_501,20230525,19830,17990,0,1,76956,-58966
INJ_501,20230526,34270,34270,0,-1,148915,-114645
INJ_501,20230527,39430,37130,0,-3,158923,-121793
INJ_501,20230529,33580,33580,0,0,145915,-112335
INJ_501,20230530,17480,12880,0,0,55958,-43078
INJ_501,20230531,13800,2760,0,0,3742,-982
INJ_501,20230602,58300,4060,0,-1,13993,-9933
INJ_501,20230606,34730,28980,0,1,128769,-99789
INJ_501,20230607,31700,29860,0,-1,127924,-98064
INJ_501,20230608,43010,35880,0,0,155906,-120026
INJ_501,20230609,18240,18240,0,-3,106935,-88695
INJ_501,20230610,20140,20140,0,3,195840,-175700
INJ_501,20230612,25080,13340,0,0,114140,-100800
INJ_501,20230613,9900,9900,0,-1,98914,-89014
INJ_501,20230614,14210,13310,0,-1,131660,-118350
INJ_501,20230615,11800,11800,0,-2,117930,-106130
INJ_501,20230616,16800,16300,0,5,162917,-146617
INJ_501,20230617,19070,19070,0,-2,160887,-141817
INJ_501,20230619,20800,18600,0,-1,185873,-167273
INJ_501,20230620,14500,13900,0,-2,138894,-124994
INJ_501,20230621,10710,10710,0,-1,98940,-88230
INJ_501,20230622,8200,8200,0,1,81933,-73733
INJ_501,20230624,2800,1800,0,0,17992,-16192
INJ_501,20230626,8200,8200,0,0,81945,-73745
INJ_501,20230627,11500,10700,0,-2,106930,-96230
INJ_501,20230628,23400,20200,0,2,201860,-181660
INJ_501,20230630,14080,12880,0,-2,117920,-105040
INJ_501,20230701,19780,18780,0,-3,152512,-133732
INJ_501,20230703,9500,9500,0,0,94948,-85448
INJ_501,20230704,12100,11300,0,0,119222,-107922
INJ_501,20230705,13000,12200,0,-1,121915,-109715
INJ_501,20230706,10360,10360,0,1,81948,-71588
INJ_501,20230707,10680,10680,0,2,95938,-85258
INJ_501,20230708,22300,22300,0,0,222853,-200553
INJ_501,20230710,18180,16780,0,0,156885,-140105
INJ_501,20230711,25300,16100,0,2,160877,-144777
INJ_501,20230712,8600,8600,0,-1,85930,-77330
INJ_501,20230713,15610,13610,0,-3,127909,-114299
INJ_501,20230714,8810,8810,0,1,79939,-71129
INJ_501,20230715,17500,15700,0,0,156903,-141203
INJ_501,20230716,6880,6880,0,0,57976,-51096
INJ_501,20230717,25910,19310,0,3,193912,-174602
INJ_501,20230718,16400,13700,0,-1,136908,-123208
INJ_501,20230719,11300,11300,0,-1,112911,-101611
INJ_502,20211005,600,600,0,0,1997,-1397
INJ_502,20211106,5400,900,0,0,2995,-2095
INJ_502,20220126,8100,8100,0,0,26972,-18872
INJ_502,20220127,3900,3900,0,-2,12980,-9080
INJ_502,20220128,7800,7800,0,-1,25978,-18178
INJ_502,20220129,13200,12600,0,1,41852,-29252
INJ_502,20220131,12600,12600,0,0,41957,-29357
INJ_502,20220201,11400,11400,0,0,37966,-26566
INJ_502,20220202,3900,3900,0,0,12986,-9086
INJ_502,20220203,8100,8100,0,-1,26970,-18870
INJ_502,20220204,12600,12600,0,-1,41958,-29358
INJ_502,20220205,9900,9900,0,0,32963,-23063
INJ_502,20220207,8400,8400,0,-1,27961,-19561
INJ_502,20220208,4800,4800,0,1,15984,-11184
INJ_502,20220209,7800,7800,0,0,25963,-18163
INJ_502,20220210,9900,9900,0,1,32973,-23073
INJ_502,20220211,10530,10530,0,-1,35053,-24523
INJ_502,20220212,10500,10500,0,-1,34952,-24452
INJ_502,20220214,14400,13800,0,3,45946,-32146
INJ_502,20220215,7800,6900,0,-1,22966,-16066
INJ_502,20220216,10200,10200,0,1,33958,-23758
INJ_502,20220217,13200,13200,0,0,43951,-30751
INJ_502,20220218,9000,9000,0,-2,29963,-20963
INJ_502,20220219,13200,11400,0,-1,37961,-26561
INJ_502,20220716,9000,8100,0,-1,26956,-18856
INJ_502,20220718,7200,7200,0,-1,23970,-16770
INJ_502,20220719,16500,11400,0,-1,37965,-26565
INJ_502,20220720,11700,11700,0,0,38959,-27259
INJ_502,20220721,4500,4500,0,0,14984,-10484
INJ_502,20220722,18900,18000,0,0,59951,-41951
INJ_502,20220723,15000,13800,0,0,45953,-32153
INJ_502,20220725,2400,2400,0,0,7983,-5583
INJ_502,20220726,1500,1500,0,1,4993,-3493
INJ_502,20220727,8100,8100,0,-1,26976,-18876
INJ_502,20220728,6000,6000,0,-1,19974,-13974
INJ_502,20220729,12600,12600,0,1,41941,-29341
INJ_502,20220730,13500,13500,0,-1,44929,-31429
INJ_502,20220801,5700,5700,0,0,18977,-13277
INJ_502,20220802,11400,11400,0,1,37947,-26547
INJ_502,20220803,6300,5400,0,1,17970,-12570
INJ_502,20220804,17400,13500,0,-1,44960,-31460
INJ_502,20220805,6930,6930,0,0,22950,-16020
INJ_502,20220806,8100,8100,0,-2,26957,-18857
INJ_502,20220807,8100,8100,0,0,26974,-18874
INJ_502,20220808,15600,14100,0,0,46946,-32846
INJ_502,20220809,8700,7200,0,-1,23972,-16772
INJ_502,20220810,10500,9900,0,0,32955,-23055
INJ_502,20220811,8400,8400,0,-1,27967,-19567
INJ_502,20220812,6300,6300,0,1,20969,-14669
INJ_502,20220813,12000,10800,0,1,35952,-25152
INJ_502,20220814,5400,4200,0,0,13983,-9783
INJ_502,20220815,15300,14400,0,0,47956,-33556
INJ_502,20220816,13800,13800,0,1,41050,-27250
INJ_502,20220817,4800,4800,0,-1,15989,-11189
INJ_502,20220818,7800,7800,0,1,25976,-18176
INJ_502,20220819,1500,1500,0,0,4992,-3492
INJ_502,20220820,5700,5700,0,1,18980,-13280
INJ_502,20220821,7500,7500,0,1,24967,-17467
INJ_502,20220822,10200,10200,0,-1,33969,-23769
INJ_502,20220823,12000,12000,0,-1,39964,-27964
INJ_502,20220824,600,600,0,0,1996,-1396
INJ_502,20220827,20400,18900,0,1,62930,-44030
INJ_502,20220828,5700,5700,0,0,18971,-13271
INJ_502,20220901,6000,6000,0,1,19973,-13973
INJ_502,20220902,5100,5100,0,-1,16981,-11881
INJ_502,20220903,5700,5700,0,0,18979,-13279
INJ_502,20220904,1200,1200,0,0,3994,-2794
INJ_502,20220905,5700,5700,0,0,18977,-13277
INJ_502,20220906,2700,2700,0,-1,8988,-6288
INJ_502,20220907,6600,6600,0,0,21967,-15367
INJ_502,20220908,3600,3600,0,0,11979,-8379
INJ_502,20220909,6600,6600,0,1,21984,-15384
INJ_502,20220910,11700,9900,0,-1,32967,-23067
INJ_502,20220912,600,600,0,-1,1995,-1395
INJ_502,20220913,3900,3900,0,0,12981,-9081
INJ_502,20220914,6900,6900,0,0,22966,-16066
INJ_502,20220915,2400,2400,0,-1,7991,-5591
INJ_502,20220916,2400,2400,0,902,7992,-5592
INJ_502,20220917,6900,6900,0,0,22964,-16064
INJ_502,20230314,2700,2700,0,0,8993,-6293
INJ_502,20230322,6000,6000,0,2,19972,-13972
INJ_502,20230323,10500,10500,0,0,34959,-24459
INJ_502,20230324,8400,8400,0,1,27964,-19564
INJ_502,20230325,14400,13800,0,1,45951,-32151
INJ_502,20230327,8400,8400,0,1,27980,-19580
INJ_502,20230328,4800,4800,0,1,15984,-11184
INJ_502,20230329,6600,6600,0,-2,21963,-15363
INJ_502,20230330,7800,7800,0,0,25973,-18173
INJ_502,20230401,3600,3600,0,0,11980,-8380
INJ_502,20230403,6600,6600,0,1,21973,-15373
INJ_502,20230404,11700,11700,0,0,38969,-27269
INJ_502,20230405,2400,2400,0,1,7988,-5588
INJ_502,20230406,8400,8400,0,0,27978,-19578
INJ_502,20230407,4200,3600,0,1,11978,-8378
INJ_502,20230408,5400,4800,0,0,15984,-11184
INJ_502,20230410,900,900,0,0,2996,-2096
INJ_502,20230411,5700,5700,0,-1,18980,-13280
INJ_502,20230412,5100,5100,0,0,16978,-11878
INJ_502,20230413,8400,8400,0,1,27977,-19577
INJ_502,20230414,5700,5700,0,1,18976,-13276
INJ_502,20230415,3600,3600,0,1,11995,-8395
INJ_502,20230417,6600,4800,0,0,15923,-11123
INJ_502,20230418,4500,4500,0,0,14986,-10486
INJ_502,20230419,6900,6900,0,0,22968,-16068
INJ_502,20230420,8100,8100,0,-3,26960,-18860
INJ_502,20230421,6000,4200,0,0,13990,-9790
INJ_502,20230423,7800,7800,0,0,25978,-18178
INJ_502,20230424,8700,8700,0,0,28956,-20256
INJ_502,20230425,6600,6600,0,1,21977,-15377
INJ_502,20230426,11700,11700,0,2,38950,-27250
INJ_502,20230427,7500,7500,0,0,24973,-17473
INJ_502,20230428,8700,8700,0,0,28981,-20281
INJ_502,20230429,5100,5100,0,0,16985,-11885
INJ_502,20230501,3900,3900,0,0,12983,-9083
INJ_502,20230502,7200,7200,0,1,23986,-16786
INJ_502,20230503,7800,7800,0,1,25967,-18167
INJ_502,20230504,10500,10500,0,3,34961,-24461
INJ_502,20230505,7500,7500,0,1,24965,-17465
INJ_502,20230506,7500,6900,0,1,22971,-16071
INJ_502,20230508,7200,7200,0,0,23984,-16784
INJ_502,20230509,10300,9000,0,1,33971,-24971
INJ_502,20230510,11400,11400,0,0,56954,-45554
INJ_502,20230511,11400,11400,0,2,56686,-45286
INJ_502,20230512,9400,8400,-1,-19,41953,-33553
INJ_502,20230513,10400,10400,0,-2,51928,-41528
INJ_502,20230515,4800,4800,0,0,23792,-18992
INJ_502,20230516,5800,5800,0,1,28971,-23171
INJ_502,20230517,10600,10000,0,0,49949,-39949
INJ_502,20230518,5200,5200,0,0,25959,-20759
INJ_502,20230519,12400,10400,0,0,59019,-48619
INJ_502,20230520,6200,6200,0,2,30956,-24756
INJ_502,20230521,13200,13200,0,0,63340,-50140
INJ_502,20230522,12800,10000,0,-1,49610,-39610
INJ_502,20230523,11800,11800,0,-1,50946,-39146
INJ_502,20230524,7800,7800,0,1,38960,-31160
INJ_502,20230525,1600,1200,0,-1,5994,-4794
INJ_502,20230526,8600,8600,0,1,42958,-34358
INJ_502,20230527,11400,10600,0,2,50950,-40350
INJ_502,20230529,4000,4000,0,2,19981,-15981
INJ_502,20230530,5200,5200,0,0,25976,-20776
INJ_502,20230531,2800,2800,0,1,13982,-11182
INJ_502,20230601,10200,9800,0,0,48930,-39130
INJ_502,20230602,9600,9200,0,1,45947,-36747
INJ_502,20230603,6800,6800,0,0,33947,-27147
INJ_502,20230605,7800,7800,0,0,38963,-31163
INJ_502,20230606,5000,5000,0,-1,24980,-19980
INJ_502,20230607,4800,4800,0,0,23969,-19169
INJ_502,20230608,6200,4800,0,1,23975,-19175
INJ_502,20230609,6100,6100,0,1,33959,-27859
INJ_502,20230610,4100,3800,0,0,37967,-34167
INJ_502,20230612,1800,1600,0,0,14077,-12477
INJ_502,20230613,4000,3100,0,1,30980,-27880
INJ_502,20230614,3600,3400,0,0,34449,-31049
INJ_502,20230615,1600,1600,0,-1,15978,-14378
INJ_502,20230616,5000,5000,0,1,49948,-44948
INJ_502,20230617,4200,4200,0,1,41947,-37747
INJ_502,20230619,300,300,0,-1,2995,-2695
INJ_502,20230620,3100,3100,0,1,30971,-27871
INJ_502,20230621,3200,3200,0,1,31970,-28770
INJ_502,20230622,1700,1700,0,1,16981,-15281
INJ_502,20230623,4500,3500,0,1,34950,-31450
INJ_502,20230624,6300,6300,0,-1,62924,-56624
INJ_502,20230625,300,300,0,-1,2994,-2694
INJ_502,20230626,5600,5600,0,-1,43953,-38353
INJ_502,20230627,5400,5100,0,2,50966,-45866
INJ_502,20230628,7000,6700,0,-1,54936,-48236
INJ_502,20230630,1500,1500,0,0,14978,-13478
INJ_502,20230701,6900,6900,0,0,68912,-62012
INJ_502,20230703,2100,2100,0,0,20971,-18871
INJ_502,20230704,5100,4700,0,1,49425,-44725
INJ_502,20230705,4900,4900,0,1,48951,-44051
INJ_502,20230706,1700,1700,0,-1,16975,-15275
INJ_502,20230707,3100,3100,0,0,30969,-27869
INJ_502,20230708,8100,8100,0,0,80895,-72795
INJ_502,20230710,4500,4300,0,1,42947,-38647
INJ_502,20230711,5100,5100,0,0,41950,-36850
INJ_502,20230712,2000,2000,0,-1,19978,-17978
INJ_502,20230713,24400,3200,0,0,31970,-28770
INJ_502,20230714,3000,3000,0,1,29966,-26966
INJ_502,20230715,6000,4800,0,1,47946,-43146
INJ_502,20230716,1800,1800,0,-1,17983,-16183
INJ_502,20230717,4400,4400,0,0,37961,-33561
INJ_502,20230718,5800,4600,0,-1,45961,-41361
INJ_502,20230719,5000,5000,0,-1,49947,-44947
INJ_503,20210927,19800,19800,0,-2,106936,-87136
INJ_503,20210928,29400,29400,0,1,97942,-68542
INJ_503,20210929,27000,27000,0,-2,83222,-56222
INJ_503,20210930,32400,32400,0,1,107904,-75504
INJ_503,20211001,47100,41100,0,-1,128662,-87562
INJ_503,20211002,25500,25500,0,0,84935,-59435
INJ_503,20211004,32400,32400,0,1,107930,-75530
INJ_503,20211005,27000,25200,0,0,83921,-58721
INJ_503,20211006,36300,30300,0,0,100936,-70636
INJ_503,20211007,27900,27900,0,0,92927,-65027
INJ_503,20211008,18000,18000,0,1,59966,-41966
INJ_503,20211009,51900,44700,0,0,148872,-104172
INJ_503,20211011,32700,32700,0,0,108907,-76207
INJ_503,20211012,24300,24300,0,0,80944,-56644
INJ_503,20211013,7200,7200,17,409,23981,-16781
INJ_503,20211014,84600,4800,0,0,15991,-11191
INJ_503,20211015,20400,2400,0,0,7988,-5588
INJ_503,20211022,39000,36000,1,79,116412,-80412
INJ_503,20211023,36000,36000,0,0,119923,-83923
INJ_503,20211025,12300,10800,0,-1,35974,-25174
INJ_503,20211026,14700,14700,0,0,48967,-34267
INJ_503,20211027,33300,33300,0,1,110928,-77628
INJ_503,20211028,28800,28800,0,0,95919,-67119
INJ_503,20211029,23700,23700,0,0,78962,-55262
INJ_503,20211030,31800,31800,0,0,105923,-74123
INJ_503,20211101,21600,21600,0,1,71940,-50340
INJ_503,20211102,26700,23700,0,1,78948,-55248
INJ_503,20211103,36600,36600,0,0,121922,-85322
INJ_503,20211104,33600,33600,0,-1,111924,-78324
INJ_503,20211105,50400,50400,0,3,167887,-117487
INJ_503,20211106,40500,40500,0,-1,134885,-94385
INJ_503,20211108,46800,43200,0,1,143915,-100715
INJ_503,20211109,22500,22500,0,-1,74945,-52445
INJ_503,20211110,42900,42900,0,1,142896,-99996
INJ_503,20211111,33300,29700,0,1,98943,-69243
INJ_503,20211112,46500,40500,0,2,134904,-94404
INJ_503,20211113,31500,28500,0,0,89254,-60754
INJ_503,20211115,5700,4500,0,0,17825,-13325
INJ_503,20211116,11700,11700,0,0,38972,-27272
INJ_503,20211117,31800,31800,0,-2,105913,-74113
INJ_503,20211118,26700,22200,0,0,68851,-46651
INJ_503,20211119,26100,26100,0,-1,86938,-60838
INJ_503,20211120,34500,34500,0,-1,114913,-80413
INJ_503,20211122,39000,4800,0,-1,15468,-10668
INJ_503,20211124,6000,3000,0,0,1312,1688
INJ_503,20211126,33900,31500,0,1,104921,-73421
INJ_503,20211127,34800,31200,0,1,103931,-72731
INJ_503,20211129,30900,27900,0,0,92934,-65034
INJ_503,20211130,12600,12600,0,1,41969,-29369
INJ_503,20211201,44700,41700,0,-1,138893,-97193
INJ_503,20211202,25500,25500,0,1,84938,-59438
INJ_503,20211203,46500,37500,1,798,134911,-97411
INJ_503,20211204,33000,33000,0,2,109915,-76915
INJ_503,20211206,20400,19500,0,1,54964,-35464
INJ_503,20211207,6600,6600,0,0,21984,-15384
INJ_503,20211208,20400,20400,0,-1,67955,-47555
INJ_503,20211209,12900,12900,0,-1,42973,-30073
INJ_503,20211210,33300,33300,0,1,110917,-77617
INJ_503,20211211,26700,26700,0,1,88936,-62236
INJ_503,20211213,27300,27300,0,0,90942,-63642
INJ_503,20211214,34800,33900,0,0,112923,-79023
INJ_503,20211215,42600,40800,0,-4,135905,-95105
INJ_503,20211216,33300,33300,0,1,101609,-68309
INJ_503,20211217,27000,27000,0,-1,89940,-62940
INJ_503,20211218,38400,36600,0,2,121926,-85326
INJ_503,20211220,15000,3000,0,1,3007,-7
INJ_503,20211221,53700,48300,0,0,160854,-112554
INJ_503,20211222,52200,52200,0,-1,173868,-121668
INJ_503,20211223,25500,22500,0,3,74934,-52434
INJ_503,20211224,18930,18930,0,0,62925,-43995
INJ_503,20211225,9300,8700,0,0,28973,-20273
INJ_503,20211227,34200,34200,0,-1,113911,-79711
INJ_503,20211228,20400,17400,0,0,57951,-40551
INJ_503,20211229,17700,17700,0,-2,58972,-41272
INJ_503,20211230,30000,30000,0,2,99923,-69923
INJ_503,20211231,49200,49200,0,-1,163892,-114692
INJ_503,20220101,28800,28800,0,-1,95932,-67132
INJ_503,20220103,56700,56700,0,-2,188859,-132159
INJ_503,20220104,50400,47400,0,-3,157895,-110495
INJ_503,20220105,19200,12600,0,1,33300,-20700
INJ_503,20220106,9000,3000,0,0,1905,1095
INJ_503,20220108,9000,3000,0,-1,1916,1084
INJ_503,20220126,34800,34800,0,1,115911,-81111
INJ_503,20220127,36600,36600,0,-2,121926,-85326
INJ_503,20220128,40800,40800,0,1,135906,-95106
INJ_503,20220129,65100,56100,0,0,186876,-130776
INJ_503,20220131,39000,39000,0,1,129905,-90905
INJ_503,20220201,45300,43500,0,2,144883,-101383
INJ_503,20220202,38100,38100,0,0,126905,-88805
INJ_503,20220203,36000,36000,0,0,119923,-83923
INJ_503,20220204,44100,40500,0,0,134900,-94400
INJ_503,20220205,47400,47400,0,0,157912,-110512
INJ_503,20220207,57900,55200,0,-2,183884,-128684
INJ_503,20220208,21300,21300,0,0,70945,-49645
INJ_503,20220209,33900,32100,0,0,106929,-74829
INJ_503,20220210,39900,39900,0,-1,132896,-92996
INJ_503,20220211,42900,42900,0,0,142899,-99999
INJ_503,20220212,50100,50100,0,-1,166889,-116789
INJ_503,20220214,49800,47100,0,-1,156901,-109801
INJ_503,20220215,41700,39900,0,2,132895,-92995
INJ_503,20220216,36000,36000,0,0,119788,-83788
INJ_503,20220217,53700,53700,0,-1,178867,-125167
INJ_503,20220218,35400,35400,0,-1,117923,-82523
INJ_503,20220219,52800,22200,0,-3,65168,-42968
INJ_503,20220711,7200,1800,0,0,1881,-81
INJ_503,20220912,250,250,0,1,1997,-1747
INJ_503,20220915,750,750,0,-1,5998,-5248
INJ_503,20220928,250,250,0,1,1999,-1749
INJ_503,20221004,500,500,4,175,3999,-3499
INJ_503,20221010,750,750,0,0,5998,-5248
INJ_503,20221011,500,500,0,0,3996,-3496
INJ_503,20221019,625,625,0,1,5000,-4375
INJ_503,20221024,750,750,0,-1,6000,-5250
INJ_503,20221028,750,750,0,1,5998,-5248
INJ_503,20221029,500,500,0,0,3998,-3498
INJ_503,20221101,375,375,0,-1,2998,-2623
INJ_503,20221104,750,750,0,0,5999,-5249
INJ_503,20221109,500,500,0,0,3998,-3498
INJ_503,20221111,375,375,0,0,2997,-2622
INJ_503,20221112,750,750,0,0,5998,-5248
INJ_503,20221116,250,250,0,0,1998,-1748
INJ_503,20221124,500,250,0,0,1998,-1748
INJ_503,20221202,750,750,0,-1,5996,-5246
INJ_503,20221210,500,500,0,1,4000,-3500
INJ_503,20221224,875,875,0,-1,6998,-6123
INJ_503,20221231,750,750,0,0,5998,-5248
INJ_503,20230104,500,500,0,0,3999,-3499
INJ_503,20230114,500,500,0,0,3998,-3498
INJ_503,20230121,750,750,0,0,6000,-5250
INJ_503,20230202,750,750,0,-1,5997,-5247
INJ_503,20230208,375,375,0,1,3000,-2625
INJ_503,20230209,750,750,0,0,5995,-5245
INJ_503,20230210,750,750,0,1,5998,-5248
INJ_503,20230211,250,250,0,-1,1998,-1748
INJ_503,20230222,625,625,0,0,4998,-4373
INJ_503,20230225,625,625,0,0,4994,-4369
INJ_503,20230227,375,375,0,0,2998,-2623
INJ_503,20230302,250,250,0,0,1998,-1748
INJ_503,20230307,625,625,0,0,5000,-4375
INJ_503,20230308,375,375,0,0,2999,-2624
INJ_503,20230311,1250,1250,0,0,10000,-8750
INJ_503,20230314,5400,4200,0,0,13994,-9794
INJ_503,20230315,750,750,0,0,5997,-5247
INJ_503,20230317,375,375,0,0,3000,-2625
INJ_503,20230318,750,750,0,0,5999,-5249
INJ_503,20230324,750,750,0,0,5999,-5249
INJ_503,20230325,250,250,0,1,1998,-1748
INJ_503,20230405,250,250,0,0,1998,-1748
INJ_503,20230411,250,250,0,0,1997,-1747
INJ_503,20230420,375,375,0,0,2999,-2624
INJ_503,20230426,375,375,0,0,2998,-2623
INJ_503,20230503,625,625,0,0,4996,-4371
INJ_503,20230505,9600,9600,0,1,31995,-22395
INJ_503,20230506,18300,18300,0,0,60985,-42685
INJ_503,20230508,22150,22150,0,-1,74982,-52832
INJ_503,20230509,53800,50530,0,-2,177957,-127427
INJ_503,20230510,45280,45280,0,2,191942,-146662
INJ_503,20230511,37950,35880,0,-1,150588,-114708
INJ_503,20230512,42320,38640,-3,-689,167977,-129337
INJ_503,20230513,54240,54240,0,6,233927,-179687
INJ_503,20230515,35650,33350,0,-1,139888,-106538
INJ_503,20230516,20930,20930,0,2,90978,-70048
INJ_503,20230517,44850,44850,0,1,194963,-150113
INJ_503,20230518,48530,48530,0,2,210966,-162436
INJ_503,20230519,38420,38420,0,0,159120,-120700
INJ_503,20230520,40710,40710,0,-1,176948,-136238
INJ_503,20230522,61410,55200,0,2,234782,-179582
INJ_503,20230523,39520,32160,0,-1,137970,-105810
INJ_503,20230524,23000,23000,0,-1,99974,-76974
INJ_503,20230525,21160,18860,0,0,81990,-63130
INJ_503,20230526,32890,31510,0,-1,136985,-105475
INJ_503,20230527,42550,39330,0,2,170987,-131657
INJ_503,20230529,34270,34270,0,2,148968,-114698
INJ_503,20230530,19090,14950,0,1,63492,-48542
INJ_503,20230531,4600,920,0,0,2847,-1927
INJ_503,20230602,47400,3040,0,0,11996,-8956
INJ_503,20230606,35420,32890,0,-1,140117,-107227
INJ_503,20230607,34040,29440,0,1,127984,-98544
INJ_503,20230608,42550,34730,0,1,150979,-116249
INJ_503,20230609,22670,22670,0,0,123983,-101313
INJ_503,20230610,19400,19100,0,5,196944,-177844
INJ_503,20230612,21600,12200,0,1,112996,-100796
INJ_503,20230613,10000,10000,0,2,99985,-89985
INJ_503,20230614,17200,14700,0,1,150000,-135300
INJ_503,20230615,11400,11400,0,4,113982,-102582
INJ_503,20230616,12600,12300,0,1,122988,-110688
INJ_503,20230617,18880,18280,0,3,171967,-153687
INJ_503,20230619,18300,16400,0,1,163976,-147576
INJ_503,20230620,14600,14600,0,1,145966,-131366
INJ_503,20230621,10000,10000,0,1,99986,-89986
INJ_503,20230622,8200,8200,0,1,81973,-73773
INJ_503,20230624,1100,1100,0,0,10885,-9785
INJ_503,20230626,9100,9100,0,4,90985,-81885
INJ_503,20230627,10300,9300,0,0,92963,-83663
INJ_503,20230628,24390,21990,0,6,200951,-178961
INJ_503,20230630,13400,13100,0,2,130964,-117864
INJ_503,20230701,16950,16950,0,3,153394,-136444
INJ_503,20230703,8200,8200,0,3,81975,-73775
INJ_503,20230704,13100,13100,0,0,130970,-117870
INJ_503,20230705,12700,11700,0,2,116979,-105279
INJ_503,20230706,6800,6800,0,2,67996,-61196
INJ_503,20230707,10400,10400,0,2,103987,-93587
INJ_503,20230708,20200,20200,0,2,201951,-181751
INJ_503,20230710,16950,16050,0,-3,146953,-130903
INJ_503,20230711,33670,16870,0,2,138955,-122085
INJ_503,20230712,9200,9200,0,2,91977,-82777
INJ_503,20230713,15500,13700,0,3,136954,-123254
INJ_503,20230714,6700,6700,0,-2,66975,-60275
INJ_503,20230715,16600,14600,0,5,145967,-131367
INJ_503,20230716,5400,5400,0,1,53994,-48594
INJ_503,20230717,23300,18300,0,1,192801,-174501
INJ_503,20230718,17450,15850,0,5,144970,-129120
INJ_503,20230719,11600,11000,0,-1,109973,-98973
INJ_504,20210927,3200,3200,0,0,61961,-58761
INJ_504,20210928,14900,14900,0,1,106936,-92036
INJ_504,20210929,8200,8200,0,0,71949,-63749
INJ_504,20210930,9800,8200,0,2,81946,-73746
INJ_504,20211001,9300,9300,0,0,76940,-67640
INJ_504,20211002,11200,11200,0,2,101925,-90725
INJ_504,20211004,11100,10600,0,0,85938,-75338
INJ_504,20211005,5800,5800,0,0,45967,-40167
INJ_504,20211006,10100,9300,0,8,80945,-71645
INJ_504,20211007,10700,9900,0,0,78953,-69053
INJ_504,20211008,11400,11400,0,4,113949,-102549
INJ_504,20211009,11400,10600,0,-2,99928,-89328
INJ_504,20211011,14100,14100,0,2,92927,-78827
INJ_504,20211012,8100,8100,0,-2,80946,-72846
INJ_504,20211013,3300,3300,9,935,32977,-29677
INJ_504,20211014,1100,1100,0,0,10991,-9891
INJ_504,20211015,19100,17500,0,1,156907,-139407
INJ_504,20211016,5200,5200,0,-1,51920,-46720
INJ_504,20211018,6200,6200,0,1,61954,-55754
INJ_504,20211019,11100,11100,0,2,84946,-73846
INJ_504,20211020,9000,9000,0,1,83934,-74934
INJ_504,20211021,5400,4900,0,-1,48966,-44066
INJ_504,20211022,6600,6600,0,-1,65954,-59354
INJ_504,20211023,9500,9500,0,2,82946,-73446
INJ_504,20211025,16600,12200,0,-1,97947,-85747
INJ_504,20211026,5400,4400,0,-1,43970,-39570
INJ_504,20211027,6600,6600,0,598,53965,-47365
INJ_504,20211028,9100,9100,0,1,84942,-75842
INJ_504,20211029,7100,6300,0,0,48973,-42673
INJ_504,20211030,11300,11300,0,1,112916,-101616
INJ_504,20211101,9500,9500,0,0,94936,-85436
INJ_504,20211102,6500,6500,0,0,64963,-58463
INJ_504,20211103,10400,10400,0,1,87953,-77553
INJ_504,20211104,14700,14700,0,-2,134922,-120222
INJ_504,20211105,8200,6700,0,605,78933,-72233
INJ_504,20211106,9700,8900,0,-605,64950,-56050
INJ_504,20211108,6300,6300,0,0,62952,-56652
INJ_504,20211109,5500,5500,0,2,54968,-49468
INJ_504,20211110,7100,7100,0,-1,70954,-63854
INJ_504,20211111,10800,10800,0,0,77954,-67154
INJ_504,20211112,19800,19000,0,-1,189870,-170870
INJ_504,20211113,9600,9600,0,597,89940,-80340
INJ_504,20211115,15900,15600,0,2,143905,-128305
INJ_504,20211116,7900,7900,0,1,78944,-71044
INJ_504,20211117,8300,7500,0,0,68950,-61450
INJ_504,20211118,8800,6400,0,0,63958,-57558
INJ_504,20211119,12000,10200,0,-1,75937,-65737
INJ_504,20211120,7300,6300,0,1,62953,-56653
INJ_504,20211122,7300,7300,0,1,72950,-65650
INJ_504,20211123,12800,12200,0,1,95927,-83727
INJ_504,20211124,13800,13800,0,1,89936,-76136
INJ_504,20211125,9600,9600,0,3,83958,-74358
INJ_504,20211126,7800,7800,0,0,67958,-60158
INJ_504,20211127,7900,6700,0,1,66957,-60257
INJ_504,20211129,13900,9100,0,2,70950,-61850
INJ_504,20211130,8400,8400,0,0,73957,-65557
INJ_504,20211201,7500,7500,0,2,74948,-67448
INJ_504,20211202,8800,8800,0,0,75946,-67146
INJ_504,20211203,6200,6200,0,0,49966,-43766
INJ_504,20211204,4900,4900,0,1,48969,-44069
INJ_504,20211206,10700,10100,0,-1,94928,-84828
INJ_504,20211207,10600,10600,0,1,99944,-89344
INJ_504,20211208,11900,11100,0,1,100930,-89830
INJ_504,20211209,12900,11700,0,1,120924,-109224
INJ_504,20211210,18700,18700,0,0,142787,-124087
INJ_504,20211211,12500,12500,0,1,114926,-102426
INJ_504,20211213,9200,9200,0,2,81950,-72750
INJ_504,20211214,8200,7600,0,0,65961,-58361
INJ_504,20211215,13800,13000,0,1,111929,-98929
INJ_504,20211216,10500,10500,0,0,104922,-94422
INJ_504,20211217,6500,6500,0,0,64952,-58452
INJ_504,20211218,10100,10100,0,-1,100936,-90836
INJ_504,20211220,8000,8000,0,1,67946,-59946
INJ_504,20211221,7400,6400,0,2,57953,-51553
INJ_504,20211222,10200,10200,0,2,79945,-69745
INJ_504,20211223,12600,12600,0,1,95913,-83313
INJ_504,20211224,12700,12700,0,0,120910,-108210
INJ_504,20211225,3000,3000,0,1,29973,-26973
INJ_504,20211227,17700,16400,0,1,129917,-113517
INJ_504,20211228,7350,7350,0,1,73413,-66063
INJ_504,20211229,5800,5800,0,0,57963,-52163
INJ_504,20211230,10200,9200,0,7,83949,-74749
INJ_504,20211231,13000,12200,0,1,95943,-83743
INJ_504,20220101,9300,9300,0,0,92948,-83648
INJ_504,20220103,4900,4900,0,2,36973,-32073
INJ_504,20220104,9600,9600,0,1,79947,-70347
INJ_504,20220105,13100,12300,0,-1,92930,-80630
INJ_504,20220106,11600,11600,0,0,95939,-84339
INJ_504,20220107,12000,11200,0,-1,99931,-88731
INJ_504,20220108,11100,10600,0,0,99932,-89332
INJ_504,20220110,12400,12400,0,0,105926,-93526
INJ_504,20220111,14300,13500,0,3,128900,-115400
INJ_504,20220112,14700,12100,0,1,94102,-82002
INJ_504,20220113,10600,10600,0,-2,89728,-79128
INJ_504,20220114,7900,7900,0,1,78950,-71050
INJ_504,20220115,8700,7900,0,3,78949,-71049
INJ_504,20220117,10100,9500,0,2,94952,-85452
INJ_504,20220118,8891,8891,0,0,74948,-66057
INJ_504,20220119,8100,8100,0,0,80950,-72850
INJ_504,20220120,5300,4700,0,2,46956,-42256
INJ_504,20220121,12200,12200,0,-2,95937,-83737
INJ_504,20220122,16900,15900,0,4,136911,-121011
INJ_504,20220124,10700,10700,0,3,106917,-96217
INJ_504,20220125,9600,9600,0,-1,95936,-86336
INJ_504,20220126,12900,12900,0,1,115096,-102196
INJ_504,20220127,2700,2700,0,-1,26979,-24279
INJ_504,20220128,11800,11000,0,5,97940,-86940
INJ_504,20220129,11700,11100,0,0,98925,-87825
INJ_504,20220131,8600,8600,0,0,67954,-59354
INJ_504,20220201,11800,11800,0,1,101941,-90141
INJ_504,20220202,18100,17600,0,1,155890,-138290
INJ_504,20220203,13600,13600,0,2,109761,-96161
INJ_504,20220204,8100,8100,0,1,80948,-72848
INJ_504,20220205,6200,6200,0,0,51966,-45766
INJ_504,20220207,4700,4700,0,0,46975,-42275
INJ_504,20220208,10800,8400,0,3,77950,-69550
INJ_504,20220209,9200,9200,0,1,75945,-66745
INJ_504,20220210,10800,10800,0,-1,89934,-79134
INJ_504,20220211,4500,4500,0,-1,44967,-40467
INJ_504,20220212,9900,9300,0,-2,86944,-77644
INJ_504,20220214,10000,9700,0,1,96947,-87247
INJ_504,20220215,7400,7400,0,0,63954,-56554
INJ_504,20220216,1400,1400,0,-1,13990,-12590
INJ_504,20220217,10400,9800,0,4,75939,-66139
INJ_504,20220218,10200,9400,0,1,87932,-78532
INJ_504,20220219,10300,9500,0,0,94933,-85433
INJ_504,20220221,11400,9900,0,1,88943,-79043
INJ_504,20220222,9000,7000,0,-1,63860,-56860
INJ_504,20220223,11100,10100,0,-2,100937,-90837
INJ_504,20220224,14800,14000,0,4,127901,-113901
INJ_504,20220225,14200,11700,0,0,116915,-105215
INJ_504,20220226,7700,7700,0,0,66943,-59243
INJ_504,20220228,5000,5000,0,1,49973,-44973
INJ_504,20220301,10800,10200,0,1,79951,-69751
INJ_504,20220302,11900,9800,0,0,91941,-82141
INJ_504,20220303,6300,6300,0,-1,62961,-56661
INJ_504,20220304,6000,6000,0,0,59958,-53958
INJ_504,20220305,15200,13200,0,1,100930,-87730
INJ_504,20220307,9100,8500,0,0,84947,-76447
INJ_504,20220308,11600,11600,0,2,115937,-104337
INJ_504,20220309,4500,4500,0,0,32968,-28468
INJ_504,20220310,9600,9600,0,-2,95928,-86328
INJ_504,20220311,12200,10100,0,1,100919,-90819
INJ_504,20220312,6700,6700,0,0,56965,-50265
INJ_504,20220314,14400,14400,0,3,131447,-117047
INJ_504,20220315,16200,15400,0,2,133905,-118505
INJ_504,20220316,10900,10900,0,1,108929,-98029
INJ_504,20220317,8600,5400,0,0,53973,-48573
INJ_504,20220318,12000,10600,0,1,93938,-83338
INJ_504,20220319,7300,7300,0,-1,66950,-59650
INJ_504,20220321,9100,8600,0,0,77952,-69352
INJ_504,20220322,4400,4400,0,2,33977,-29577
INJ_504,20220323,7800,7800,0,-3,77954,-70154
INJ_504,20220324,6800,6800,0,0,67961,-61161
INJ_504,20220325,4900,4900,0,-1,48981,-44081
INJ_504,20220326,9200,9200,0,0,91944,-82744
INJ_504,20220328,8600,8600,0,2,77943,-69343
INJ_504,20220329,8100,7300,0,1,64963,-57663
INJ_504,20220330,12700,11100,0,0,98938,-87838
INJ_504,20220331,10200,10200,0,2,101930,-91730
INJ_504,20220401,11100,11100,0,1,100949,-89849
INJ_504,20220402,8900,8900,0,2,76948,-68048
INJ_504,20220404,8100,8100,0,1,80943,-72843
INJ_504,20220405,9600,9600,0,-1,95948,-86348
INJ_504,20220406,13700,13100,0,3,114925,-101825
INJ_504,20220407,7100,7100,0,0,70949,-63849
INJ_504,20220408,5100,4500,0,-1,44972,-40472
INJ_504,20220409,18700,18200,0,3,173858,-155658
INJ_504,20220411,10900,10100,0,14,100922,-90822
INJ_504,20220412,7300,7300,0,-1,62953,-55653
INJ_504,20220413,8000,8000,0,-1,79940,-71940
INJ_504,20220414,9100,9100,0,2,90920,-81820
INJ_504,20220415,16900,16100,0,-3,160876,-144776
INJ_504,20220416,9200,8400,0,0,75951,-67551
INJ_504,20220418,13600,12800,0,-1,109910,-97110
INJ_504,20220419,7600,7600,0,0,75946,-68346
INJ_504,20220420,6700,6700,0,1,60378,-53678
INJ_504,20220421,15700,15700,0,30,156883,-141183
INJ_504,20220422,9700,9700,0,2,96935,-87235
INJ_504,20220424,8700,8700,0,0,86941,-78241
INJ_504,20220425,6500,6500,0,-1,64961,-58461
INJ_504,20220426,6400,5900,0,1,58956,-53056
INJ_504,20220427,13400,11600,0,2,109930,-98330
INJ_504,20220428,9800,9200,0,3,91939,-82739
INJ_504,20220429,15300,13800,0,2,125918,-112118
INJ_504,20220503,6800,6800,0,0,61953,-55153
INJ_504,20220504,6800,6800,0,9,57964,-51164
INJ_504,20220505,11600,11600,0,0,115929,-104329
INJ_504,20220506,17010,16210,0,4,141970,-125760
INJ_504,20220507,14400,14400,0,2,131919,-117519
INJ_504,20220509,11400,11100,0,-1,103936,-92836
INJ_504,20220510,5900,5900,0,1,58957,-53057
INJ_504,20220511,14100,13200,0,2,101912,-88712
INJ_504,20220512,6600,6600,0,0,65957,-59357
INJ_504,20220513,18000,18000,0,-1,173887,-155887
INJ_504,20220514,13800,13800,0,4,125926,-112126
INJ_504,20220516,9000,8200,0,1,81950,-73750
INJ_504,20220517,13200,13200,0,-2,121900,-108700
INJ_504,20220518,15000,15000,0,0,133892,-118892
INJ_504,20220519,17600,14400,0,2,135904,-121504
INJ_504,20220520,16350,16350,0,3,146884,-130534
INJ_504,20220521,6600,6000,0,1,59952,-53952
INJ_504,20220523,12400,10800,0,0,107909,-97109
INJ_504,20220524,9392,8592,0,20,80929,-72337
INJ_504,20220525,14150,14150,0,0,133898,-119748
INJ_504,20220526,8500,8500,0,-1,84942,-76442
INJ_504,20220527,4500,4500,0,2,44973,-40473
INJ_504,20220528,8500,8500,0,2,84939,-76439
INJ_504,20220530,7750,6950,0,-1,64960,-58010
INJ_504,20220531,10100,8900,0,0,88940,-80040
INJ_504,20220601,6400,6400,0,1,63956,-57556
INJ_504,20220602,13050,11950,0,2,114913,-102963
INJ_504,20220603,11200,11200,0,1,102931,-91731
INJ_504,20220604,3300,3300,0,1,32978,-29678
INJ_504,20220606,5800,5800,0,0,45970,-40170
INJ_504,20220607,13850,13850,0,3,133913,-120063
INJ_504,20220608,11600,9600,0,0,95937,-86337
INJ_504,20220609,4900,4900,0,1,48962,-44062
INJ_504,20220610,12400,12400,0,3,117917,-105517
INJ_504,20220611,6300,6300,0,-1,62955,-56655
INJ_504,20220613,9400,9400,0,2,93930,-84530
INJ_504,20220614,10200,10200,0,-2,101929,-91729
INJ_504,20220615,16700,13300,0,2,132724,-119424
INJ_504,20220616,6300,6300,0,-1,62954,-56654
INJ_504,20220617,9300,9300,0,1,92947,-83647
INJ_504,20220618,9600,9600,0,0,95932,-86332
INJ_504,20220620,8200,6400,0,3,57926,-51526
INJ_504,20220621,8750,8750,0,2,76946,-68196
INJ_504,20220622,3800,3800,0,4,37873,-34073
INJ_504,20220623,6500,5700,0,-1,56964,-51264
INJ_504,20220624,7550,7550,0,1,70950,-63400
INJ_504,20220625,8250,8250,0,-2,77949,-69699
INJ_504,20220627,2600,2600,0,0,16989,-14389
INJ_504,20220701,5650,5650,0,0,48969,-43319
INJ_504,20220702,12300,12300,0,1,122919,-110619
INJ_504,20220704,11700,10100,0,0,85934,-75834
INJ_504,20220705,4600,4600,0,9,45966,-41366
INJ_504,20220706,8250,8250,0,2,74945,-66695
INJ_504,20220707,11900,11300,0,1,112911,-101611
INJ_504,20220708,12000,11400,0,-2,104929,-93529
INJ_504,20220709,2300,2300,0,-1,22983,-20683
INJ_504,20220711,4400,4400,0,0,34984,-30584
INJ_504,20220712,5950,5950,0,1,54961,-49011
INJ_504,20220713,4200,4200,0,0,41969,-37769
INJ_504,20220714,1600,1600,0,2,15993,-14393
INJ_504,20220715,9400,9400,0,0,93932,-84532
INJ_504,20220716,8300,7700,0,1,76959,-69259
INJ_504,20220718,11400,11400,0,-1,101931,-90531
INJ_504,20220719,6400,6400,0,9,63956,-57556
INJ_504,20220720,10600,10600,0,1,96956,-86356
INJ_504,20220721,12200,11900,0,2,103929,-92029
INJ_504,20220722,11450,9750,0,1,92932,-83182
INJ_504,20220723,14600,13400,0,1,133907,-120507
INJ_504,20220725,12100,11500,0,2,96930,-85430
INJ_504,20220726,5800,5800,0,0,57955,-52155
INJ_504,20220727,12600,11000,0,0,109932,-98932
INJ_504,20220728,11600,10800,0,0,107948,-97148
INJ_504,20220729,11250,9750,0,0,92936,-83186
INJ_504,20220730,14700,14700,0,-1,128918,-114218
INJ_504,20220801,10300,10300,0,-1,84940,-74640
INJ_504,20220802,11600,11600,0,1,109915,-98315
INJ_504,20220803,8350,8350,0,3,78940,-70590
INJ_504,20220804,15050,13750,0,2,129903,-116153
INJ_504,20220805,13100,13100,0,1,130925,-117825
INJ_504,20220806,15700,15700,0,0,147895,-132195
INJ_504,20220808,12650,10250,0,1,76955,-66705
INJ_504,20220809,13200,12400,0,4,102931,-90531
INJ_504,20220810,14700,14700,0,9,122909,-108209
INJ_504,20220811,6300,6300,0,1,62955,-56655
INJ_504,20220812,8800,7200,0,-1,71946,-64746
INJ_504,20220813,9550,9550,0,3,78935,-69385
INJ_504,20220815,9500,9000,0,0,89932,-80932
INJ_504,20220816,16850,15250,0,-1,144900,-129650
INJ_504,20220817,9300,9300,0,3,92944,-83644
INJ_504,20220818,5100,5100,0,0,50969,-45869
INJ_504,20220819,9600,8200,0,1,81950,-73750
INJ_504,20220820,17100,17100,0,1,158899,-141799
INJ_504,20220822,12900,12900,0,0,119903,-107003
INJ_504,20220823,14300,14300,0,0,133916,-119616
INJ_504,20220824,10600,10600,0,2,105946,-95346
INJ_504,20220825,3400,3400,0,0,33976,-30576
INJ_504,20220826,8450,8450,0,0,76950,-68500
INJ_504,20220827,9050,8450,0,1,79942,-71492
INJ_504,20220829,11300,11300,0,-1,112924,-101624
INJ_504,20220830,7950,7950,0,-1,74948,-66998
INJ_504,20220831,12800,11200,0,2,111931,-100731
INJ_504,20220901,8450,7450,0,-2,69950,-62500
INJ_504,20220902,6000,1000,0,3,4871,-3871
INJ_504,20220903,11200,800,0,-2,7997,-7197
INJ_504,20220908,2400,1600,0,0,2210,-610
INJ_504,20220909,12200,12200,0,1,121922,-109722
INJ_504,20220910,11800,9800,0,2,91928,-82128
INJ_504,20220912,11150,10350,0,-2,98922,-88572
INJ_504,20220913,8850,8850,0,1,80942,-72092
INJ_504,20220914,10500,10500,0,1,95939,-85439
INJ_504,20220915,8900,8900,0,4,88934,-80034
INJ_504,20220916,6500,6500,0,2,64956,-58456
INJ_504,20220917,9850,9250,0,-1,87860,-78610
INJ_504,20220919,5050,5050,0,0,45972,-40922
INJ_504,20220920,7600,7600,0,3,75946,-68346
INJ_504,20220921,9900,9100,0,1,90930,-81830
INJ_504,20220922,10150,10150,0,2,96940,-86790
INJ_504,20220923,8200,8200,0,2,81934,-73734
INJ_504,20220924,1300,1300,0,1,12994,-11694
INJ_504,20220926,6700,6100,0,4,60957,-54857
INJ_504,20220927,7200,6400,0,-1,63953,-57553
INJ_504,20220928,6800,6000,0,0,59963,-53963
INJ_504,20220929,4900,4900,0,2,42967,-38067
INJ_504,20220930,9750,9750,0,2,89944,-80194
INJ_504,20221001,2800,1600,0,0,15992,-14392
INJ_504,20221004,13450,13450,1,565,129908,-116458
INJ_504,20221005,12450,12450,0,0,119918,-107468
INJ_504,20221006,12600,12000,0,2,113922,-101922
INJ_504,20221007,6850,6850,0,528,77947,-71097
INJ_504,20221008,8050,8050,0,-1,61945,-53895
INJ_504,20221010,3000,3000,0,1,29987,-26987
INJ_504,20221011,7100,7100,0,0,61945,-54845
INJ_504,20221012,11950,11950,0,0,111931,-99981
INJ_504,20221013,11400,10800,0,2,107941,-97141
INJ_504,20221014,11300,10900,0,1,112926,-102026
INJ_504,20221015,14750,14750,0,2,139901,-125151
INJ_504,20221017,9300,8500,0,1,84929,-76429
INJ_504,20221018,8400,8000,0,-1,79945,-71945
INJ_504,20221019,7600,6000,0,0,59952,-53952
INJ_504,20221020,1400,1400,0,0,13984,-12584
INJ_504,20221021,4200,4200,0,1,41976,-37776
INJ_504,20221022,8950,7550,0,-1,67945,-60395
INJ_504,20221024,5500,5500,0,1,54960,-49460
INJ_504,20221025,6710,6410,0,1,63935,-57525
INJ_504,20221026,8400,8400,0,1,83949,-75549
INJ_504,20221027,8300,7700,0,2,76946,-69246
INJ_504,20221028,10950,10950,0,4,92943,-81993
INJ_504,20221029,3700,3000,0,-1,36983,-33983
INJ_504,20221031,4200,4200,0,2,32988,-28788
INJ_504,20221101,8500,8500,0,-1,84946,-76446
INJ_504,20221102,11450,11450,0,0,106922,-95472
INJ_504,20221103,5800,5800,0,0,57966,-52166
INJ_504,20221104,5600,5600,0,2,55963,-50363
INJ_504,20221105,4600,4600,0,-1,45969,-41369
INJ_504,20221107,3700,3700,0,2,36975,-33275
INJ_504,20221108,9600,9300,0,0,92931,-83631
INJ_504,20221109,3300,3300,0,0,32979,-29679
INJ_504,20221110,6300,6300,0,1,62951,-56651
INJ_504,20221111,6500,6500,0,-1,64956,-58456
INJ_504,20221112,7900,7900,0,1,78950,-71050
INJ_504,20221114,7200,4800,0,1,47958,-43158
INJ_504,20221115,3300,3300,0,0,32979,-29679
INJ_504,20221116,4800,4800,0,0,47962,-43162
INJ_504,20221117,8000,8000,0,-1,79940,-71940
INJ_504,20221118,10900,10900,0,2,108925,-98025
INJ_504,20221119,3650,3650,0,0,31975,-28325
INJ_504,20221121,3300,2700,0,0,26989,-24289
INJ_504,20221122,15100,12300,0,3,122923,-110623
INJ_504,20221123,3600,3600,0,-1,35982,-32382
INJ_504,20221124,8100,7000,0,1,80920,-73920
INJ_504,20221125,8950,8350,0,2,78946,-70596
INJ_504,20221126,6900,6900,0,1,68953,-62053
INJ_504,20221128,8100,8100,0,1,80950,-72850
INJ_504,20221129,8300,8300,0,0,82930,-74630
INJ_504,20221130,7200,6700,0,0,66950,-60250
INJ_504,20221201,6700,6700,0,2,66959,-60259
INJ_504,20221202,5100,5100,0,1,50970,-45870
INJ_504,20221203,5100,4500,0,0,44959,-40459
INJ_504,20221205,9900,8300,0,1,82933,-74633
INJ_504,20221206,9650,8850,0,2,80940,-72090
INJ_504,20221207,3500,3500,0,0,34961,-31461
INJ_504,20221208,9300,8700,0,0,86939,-78239
INJ_504,20221209,9750,7450,0,0,63364,-55914
INJ_504,20221210,9600,9600,0,0,95941,-86341
INJ_504,20221212,10610,7710,0,2,77024,-69314
INJ_504,20221213,5100,5100,0,-1,50957,-45857
INJ_504,20221214,5000,5000,0,-1,49965,-44965
INJ_504,20221215,9150,9150,0,0,83941,-74791
INJ_504,20221216,9600,8900,0,-1,79952,-71052
INJ_504,20221217,11200,10600,0,3,99928,-89328
INJ_504,20221219,5750,5750,0,1,52958,-47208
INJ_504,20221220,8100,6300,0,2,62951,-56651
INJ_504,20221221,7700,7700,0,-2,76947,-69247
INJ_504,20221222,4800,4800,0,0,47965,-43165
INJ_504,20221223,7300,6100,0,2,60958,-54858
INJ_504,20221224,6200,6200,0,3,61958,-55758
INJ_504,20221226,4700,4700,0,0,46965,-42265
INJ_504,20221227,2050,2050,0,0,12993,-10943
INJ_504,20221228,11000,11000,0,1,100919,-89919
INJ_504,20221229,9050,9050,0,0,82944,-73894
INJ_504,20221230,10500,9700,0,-2,96928,-87228
INJ_504,20221231,4400,4400,0,-1,43972,-39572
INJ_504,20230102,9400,9400,0,0,84931,-75531
INJ_504,20230103,6200,6200,0,1,61946,-55746
INJ_504,20230104,6410,6410,0,1,63958,-57548
INJ_504,20230105,11050,11050,0,0,105919,-94869
INJ_504,20230106,3750,3750,0,0,32980,-29230
INJ_504,20230107,7600,7600,0,2,60958,-53358
INJ_504,20230109,8350,8350,0,0,69954,-61604
INJ_504,20230110,4400,4400,0,1,43975,-39575
INJ_504,20230111,9950,9150,0,1,86940,-77790
INJ_504,20230112,8900,8900,0,-1,79943,-71043
INJ_504,20230117,1900,1900,0,0,18991,-17091
INJ_504,20230118,6450,6450,0,2,59975,-53525
INJ_504,20230119,7550,7550,0,-1,67946,-60396
INJ_504,20230120,8650,7050,0,-2,62960,-55910
INJ_504,20230121,7700,6500,0,-1,64949,-58449
INJ_504,20230123,10200,10200,0,0,101922,-91722
INJ_504,20230124,3300,3300,0,-1,32978,-29678
INJ_504,20230125,7100,7100,0,1,61961,-54861
INJ_504,20230126,13800,12700,0,4,117910,-105210
INJ_504,20230127,4650,4050,0,-1,32974,-28924
INJ_504,20230128,6600,6100,0,0,60961,-54861
INJ_504,20230130,3800,3800,0,0,37969,-34169
INJ_504,20230131,7200,7200,0,1,71938,-64738
INJ_504,20230201,8100,8100,0,-1,68951,-60851
INJ_504,20230202,7150,7150,0,0,63961,-56811
INJ_504,20230203,5300,5300,0,0,43966,-38666
INJ_504,20230204,5800,5800,0,-2,57946,-52146
INJ_504,20230206,7250,7250,0,1,67949,-60699
INJ_504,20230207,10700,10700,0,1,106927,-96227
INJ_504,20230208,7050,7050,0,0,65950,-58900
INJ_504,20230209,5550,5550,0,-1,47962,-42412
INJ_504,20230210,6800,6800,0,2,58953,-52153
INJ_504,20230211,5800,5200,0,-1,51959,-46759
INJ_504,20230213,5500,5500,0,1,54958,-49458
INJ_504,20230214,40500,7400,0,0,73938,-66538
INJ_504,20230215,4700,4700,0,2,46972,-42272
INJ_504,20230216,4800,4800,0,-1,38968,-34168
INJ_504,20230217,6450,5850,0,1,53972,-48122
INJ_504,20230218,5500,5500,0,1,45967,-40467
INJ_504,20230220,4300,4300,0,-1,42973,-38673
INJ_504,20230221,8150,8150,0,1,76949,-68799
INJ_504,20230222,9800,9200,0,1,91944,-82744
INJ_504,20230223,10400,10400,0,0,94933,-84533
INJ_504,20230224,6450,6450,0,1,47962,-41512
INJ_504,20230225,6650,6650,0,0,58954,-52304
INJ_504,20230227,12100,4400,0,1,34988,-30588
INJ_504,20230228,6050,6050,0,-1,55964,-49914
INJ_504,20230301,5450,5450,0,-1,49972,-44522
INJ_504,20230302,8000,8000,0,0,79950,-71950
INJ_504,20230303,8550,7550,0,-1,74943,-67393
INJ_504,20230304,9250,9250,0,0,87941,-78691
INJ_504,20230306,6100,6100,0,1,48966,-42866
INJ_504,20230307,6700,6700,0,0,66967,-60267
INJ_504,20230308,4500,4500,0,-1,44969,-40469
INJ_504,20230309,6600,6600,0,1,65956,-59356
INJ_504,20230310,11640,11040,0,0,100949,-89909
INJ_504,20230311,6100,6100,0,0,48973,-42873
INJ_504,20230314,1400,1400,0,0,13991,-12591
INJ_504,20230315,13600,13600,0,0,111933,-98333
INJ_504,20230316,21350,20750,0,-1,154900,-134150
INJ_504,20230317,16150,16150,0,2,117932,-101782
INJ_504,20230318,10650,10650,0,0,74949,-64299
INJ_504,20230320,12350,10950,0,0,86941,-75991
INJ_504,20230321,5300,5300,0,1,52968,-47668
INJ_504,20230322,19100,16600,0,0,84945,-68345
INJ_504,20230323,12400,12400,0,-2,93953,-81553
INJ_504,20230324,13600,13600,0,0,108944,-95344
INJ_504,20230325,9550,9550,0,0,63955,-54405
INJ_504,20230327,13450,12650,0,0,76952,-64302
INJ_504,20230328,3300,3300,0,1,32979,-29679
INJ_504,20230329,3000,3000,0,0,29984,-26984
INJ_504,20230330,7700,7700,0,0,55962,-48262
INJ_504,20230331,13000,13000,0,0,93936,-80936
INJ_504,20230401,9000,9000,0,2,59954,-50954
INJ_504,20230402,3750,3750,0,0,14991,-11241
INJ_504,20230403,4200,4200,0,0,41969,-37769
INJ_504,20230404,12850,12850,0,2,99941,-87091
INJ_504,20230405,71900,5600,0,0,43976,-38376
INJ_504,20230406,8350,8350,0,5,75941,-67591
INJ_504,20230407,5600,5600,0,0,46965,-41365
INJ_504,20230408,4900,4200,0,1,42775,-38575
INJ_504,20230410,12900,9400,0,3,74781,-65381
INJ_504,20230411,10100,8100,0,2,80953,-72853
INJ_504,20230412,2900,2900,0,0,28986,-26086
INJ_504,20230413,5950,5350,0,-1,30983,-25633
INJ_504,20230414,13900,13100,0,1,97960,-84860
INJ_504,20230415,3000,3000,0,2,29975,-26975
INJ_504,20230417,13550,13550,0,-2,112926,-99376
INJ_504,20230418,2700,2700,0,-1,26980,-24280
INJ_504,20230419,5250,5250,0,0,20987,-15737
INJ_504,20230420,12050,11450,0,1,91956,-80506
INJ_504,20230421,9900,9900,0,1,80955,-71055
INJ_504,20230424,3200,3200,0,1,31973,-28773
INJ_504,20230425,6000,6000,0,1,59964,-53964
INJ_504,20230426,2400,2400,0,0,23990,-21590
INJ_504,20230427,5800,5800,0,0,48970,-43170
INJ_504,20230428,9100,8600,0,-1,61956,-53356
INJ_504,20230429,8600,8600,0,-1,85953,-77353
INJ_504,20230430,3250,3250,0,0,12991,-9741
INJ_504,20230501,10850,10450,0,-1,96952,-86502
INJ_504,20230502,5400,4600,0,1,45970,-41370
INJ_504,20230503,4700,4700,0,-1,46976,-42276
INJ_504,20230504,8050,8050,0,-1,57959,-49909
INJ_504,20230505,19950,19950,0,2,131910,-111960
INJ_504,20230506,11000,11000,0,2,100928,-89928
INJ_504,20230508,9150,9150,0,2,65966,-56816
INJ_504,20230509,10650,9950,0,1,94950,-85000
INJ_504,20230510,6700,6100,0,2,60970,-54870
INJ_504,20230511,11600,11600,0,0,85967,-74367
INJ_504,20230512,10750,10750,0,1,60964,-50214
INJ_504,20230513,5850,5850,0,0,50977,-45127
INJ_504,20230515,7550,7550,0,2,70966,-63416
INJ_504,20230516,7300,7300,0,0,48967,-41667
INJ_504,20230517,17500,16800,0,1,116939,-100139
INJ_504,20230518,4200,4200,0,3,35989,-31789
INJ_504,20230519,8150,7550,0,-1,70415,-62865
INJ_504,20230520,9600,9600,0,1,62959,-53359
INJ_504,20230522,5400,5400,0,1,26984,-21584
INJ_504,20230523,8350,8350,0,0,60964,-52614
INJ_504,20230524,5850,5850,0,1,50969,-45119
INJ_504,20230525,14650,12650,0,0,91966,-79316
INJ_504,20230526,9800,9800,0,0,73966,-64166
INJ_504,20230527,7800,7800,0,2,77965,-70165
INJ_504,20230529,11450,10650,0,1,59979,-49329
INJ_504,20230530,13100,9850,0,-1,60961,-51111
INJ_504,20230531,900,900,0,1,8990,-8090
INJ_504,20230601,3300,3300,0,2,32990,-29690
INJ_504,20230602,3850,3850,0,1,30981,-27131
INJ_504,20230603,5800,5800,0,-1,45962,-40162
INJ_504,20230605,1700,1700,0,0,16987,-15287
INJ_504,20230606,11800,11800,0,1,66962,-55162
INJ_504,20230607,9050,9050,0,-1,67972,-58922
INJ_504,20230608,7700,7700,0,0,46982,-39282
INJ_504,20230609,13600,13600,0,5,99945,-86345
INJ_504,20230610,8200,7400,0,0,49970,-42570
INJ_504,20230612,16750,16150,0,1,102936,-86786
INJ_504,20230613,9250,9250,0,4,66965,-57715
INJ_504,20230614,8400,7500,0,1,74959,-67459
INJ_504,20230615,14800,14800,0,0,93942,-79142
INJ_504,20230616,12150,11650,0,1,90953,-79303
INJ_504,20230617,11750,11750,0,1,73955,-62205
INJ_504,20230619,4100,4100,0,2,40983,-36883
INJ_504,20230620,13650,12850,0,1,84946,-72096
INJ_504,20230621,12350,12350,0,3,76962,-64612
INJ_504,20230622,11700,11700,0,2,95945,-84245
INJ_504,20230623,12650,12650,0,-1,76952,-64302
INJ_504,20230624,16400,9850,0,0,92778,-82928
INJ_504,20230626,31950,22100,0,5,166581,-144481
INJ_504,20230627,23900,18600,0,1,126138,-107538
INJ_504,20230628,14350,10950,0,3,115416,-104466
INJ_504,20230630,5600,4700,0,1,48492,-43792
INJ_504,20230701,13400,10200,0,4,73040,-62840
INJ_504,20230703,18800,14100,0,5,127284,-113184
INJ_504,20230704,16450,11300,0,2,126236,-114936
INJ_504,20230705,6050,5250,0,1,50186,-44936
INJ_504,20230706,10400,6850,0,-2,76929,-70079
INJ_504,20230707,1900,1100,0,0,17264,-16164
INJ_504,20230708,6300,5400,0,-1,49027,-43627
INJ_504,20230710,5100,3700,0,2,40790,-37090
INJ_504,20230711,11850,8550,0,0,79176,-70626
INJ_504,20230712,30400,23450,0,2,198367,-174917
INJ_504,20230713,118300,7100,0,3,88448,-81348
INJ_504,20230714,104050,10700,0,2,78160,-67460
INJ_504,20230715,39100,3300,0,0,32985,-29685
INJ_504,20230717,90900,7300,0,2,53693,-46393
INJ_504,20230718,38800,12800,0,0,125297,-112497
INJ_504,20230719,7050,4700,0,-1,56227,-51527
INJ_505,20210927,3375,3375,0,-1,17984,-14609
INJ_505,20210928,9000,9000,0,0,23985,-14985
INJ_505,20210929,1125,1125,0,2,2997,-1872
INJ_505,20210930,5250,4125,0,0,10990,-6865
INJ_505,20211001,3000,3000,0,0,7992,-4992
INJ_505,20211002,4875,4875,0,1,12989,-8114
INJ_505,20211004,10500,8250,0,0,21978,-13728
INJ_505,20211005,12375,3375,0,0,8994,-5619
INJ_505,20211006,3375,3375,0,0,8993,-5618
INJ_505,20211007,4875,4875,0,0,12989,-8114
INJ_505,20211008,7500,7500,0,0,19986,-12486
INJ_505,20211009,8250,8250,0,0,21974,-13724
INJ_505,20211011,3375,3375,0,0,8993,-5618
INJ_505,20211012,1875,1875,0,0,4998,-3123
INJ_505,20211013,3750,3750,5,617,9994,-6244
INJ_505,20211014,1500,1500,0,0,1284,216
INJ_505,20211015,11625,7875,0,1,20979,-13104
INJ_505,20211016,3375,3375,0,-1,8989,-5614
INJ_505,20211018,4875,4875,0,2,12993,-8118
INJ_505,20211019,4875,4875,0,3,12988,-8113
INJ_505,20211020,7500,7500,0,0,19984,-12484
INJ_505,20211021,1875,1875,0,0,4996,-3121
INJ_505,20211022,3375,3375,0,0,8993,-5618
INJ_505,20211023,3000,3000,0,0,7995,-4995
INJ_505,20211025,15750,9375,0,-1,24981,-15606
INJ_505,20211026,3000,3000,0,-1,7996,-4996
INJ_505,20211027,5625,5625,0,0,14990,-9365
INJ_505,20211028,3375,3375,0,0,8990,-5615
INJ_505,20211029,1125,1125,0,0,2995,-1870
INJ_505,20211030,7125,7125,0,0,18978,-11853
INJ_505,20211101,4875,4875,0,-1,12986,-8111
INJ_505,20211102,1875,1875,0,0,4995,-3120
INJ_505,20211103,3000,3000,0,0,7992,-4992
INJ_505,20211104,2625,2625,0,1,6987,-4362
INJ_505,20211105,4125,4125,0,-1,13989,-9864
INJ_505,20211106,2625,2625,0,1,3997,-1372
INJ_505,20211108,1875,1875,0,-1,4995,-3120
INJ_505,20211110,1125,1125,0,1,2994,-1869
INJ_505,20211111,4875,4875,0,-1,12990,-8115
INJ_505,20211112,10875,9375,0,2,24977,-15602
INJ_505,20211113,4875,4875,0,-1,12991,-8116
INJ_505,20211115,4875,4875,0,1,12987,-8112
INJ_505,20211116,4125,4125,0,-1,10992,-6867
INJ_505,20211117,2250,1125,0,0,2994,-1869
INJ_505,20211118,3750,3750,0,0,9994,-6244
INJ_505,20211119,6750,6750,0,0,17988,-11238
INJ_505,20211120,5250,3750,0,0,9993,-6243
INJ_505,20211122,3000,3000,0,1,7993,-4993
INJ_505,20211123,4125,2625,0,0,6995,-4370
INJ_505,20211124,9000,9000,0,0,23981,-14981
INJ_505,20211125,4500,4500,0,0,11988,-7488
INJ_505,20211126,2625,2625,0,-1,6993,-4368
INJ_505,20211127,5625,2625,0,0,6991,-4366
INJ_505,20211129,1500,1500,0,0,3997,-2497
INJ_505,20211130,1125,1125,0,0,2997,-1872
INJ_505,20211201,1125,1125,0,1,2996,-1871
INJ_505,20211202,4875,4875,0,-1,12987,-8112
INJ_505,20211206,5625,5625,0,0,14982,-9357
INJ_505,20211207,6750,6750,0,0,17983,-11233
INJ_505,20211208,1875,1875,0,0,4997,-3122
INJ_505,20211209,7875,6000,0,0,15985,-9985
INJ_505,20211210,4875,4875,0,0,12988,-8113
INJ_505,20211211,7875,7875,0,1,20979,-13104
INJ_505,20211213,4125,4125,0,0,10987,-6862
INJ_505,20211214,1875,1875,0,0,4997,-3122
INJ_505,20211215,7500,7500,0,0,19982,-12482
INJ_505,20211216,1875,1875,0,0,4997,-3122
INJ_505,20211217,2663,2663,0,0,7087,-4424
INJ_505,20211218,1125,1125,0,-1,2997,-1872
INJ_505,20211220,1875,1875,0,1,4997,-3122
INJ_505,20211221,4875,4875,0,8,12988,-8113
INJ_505,20211222,6000,6000,0,1,15987,-9987
INJ_505,20211223,4875,4875,0,0,12985,-8110
INJ_505,20211224,3750,3750,0,1,9989,-6239
INJ_505,20211225,1125,1125,0,0,2995,-1870
INJ_505,20211227,16875,12750,0,0,33967,-21217
INJ_505,20211229,3375,3375,0,-1,8990,-5615
INJ_505,20211230,3375,3375,0,1,8991,-5616
INJ_505,20211231,7500,6000,0,-1,15982,-9982
INJ_505,20220101,5250,5250,0,0,13988,-8738
INJ_505,20220104,4125,4125,0,0,10989,-6864
INJ_505,20220105,7500,5250,0,1,13986,-8736
INJ_505,20220106,2250,2250,0,0,5995,-3745
INJ_505,20220107,7875,7875,0,1,20986,-13111
INJ_505,20220108,8625,6375,0,0,16989,-10614
INJ_505,20220110,4875,4875,0,0,12991,-8116
INJ_505,20220111,5625,5625,0,1,14989,-9364
INJ_505,20220112,11250,8625,0,0,20818,-12193
INJ_505,20220113,6000,6000,0,0,15984,-9984
INJ_505,20220114,4500,4500,0,1,11991,-7491
INJ_505,20220115,3413,3413,0,-1,9002,-5589
INJ_505,20220117,3000,3000,0,0,7994,-4994
INJ_505,20220118,6750,6750,0,3,17985,-11235
INJ_505,20220120,5625,5625,0,0,14985,-9360
INJ_505,20220121,6000,6000,0,0,15981,-9981
INJ_505,20220122,4500,4500,0,0,11988,-7488
INJ_505,20220124,3750,3750,0,0,9990,-6240
INJ_505,20220125,1500,1500,0,0,3997,-2497
INJ_505,20220126,4125,4125,0,2,10985,-6860
INJ_505,20220127,5625,5625,0,0,14987,-9362
INJ_505,20220128,5625,5625,0,1,14985,-9360
INJ_505,20220129,3000,3000,0,-1,7991,-4991
INJ_505,20220201,4500,4500,0,0,11987,-7487
INJ_505,20220202,6875,6875,0,0,16982,-10107
INJ_505,20220203,9000,9000,0,-1,23981,-14981
INJ_505,20220204,1125,1125,0,0,2997,-1872
INJ_505,20220205,1875,1875,0,0,4996,-3121
INJ_505,20220207,3375,3375,0,0,8994,-5619
INJ_505,20220208,3750,3750,0,0,9991,-6241
INJ_505,20220209,4125,4125,0,0,10988,-6863
INJ_505,20220210,6750,6750,0,2,17983,-11233
INJ_505,20220211,7125,7125,0,0,18983,-11858
INJ_505,20220212,3375,3375,0,0,8991,-5616
INJ_505,20220214,5250,5250,0,1,13985,-8735
INJ_505,20220215,5250,5250,0,0,13990,-8740
INJ_505,20220216,3000,3000,0,0,7994,-4994
INJ_505,20220217,5250,3750,0,0,9994,-6244
INJ_505,20220218,1875,1875,0,-1,4998,-3123
INJ_505,20220219,6750,6750,0,0,17983,-11233
INJ_505,20220221,3000,3000,0,0,7992,-4992
INJ_505,20220222,2288,1163,0,-1,3023,-1860
INJ_505,20220223,3375,3375,0,0,8991,-5616
INJ_505,20220224,8625,6750,0,0,17985,-11235
INJ_505,20220225,8250,6750,0,-1,17985,-11235
INJ_505,20220226,3750,3750,0,0,9994,-6244
INJ_505,20220228,3375,3375,0,0,8993,-5618
INJ_505,20220301,5288,5288,0,0,14015,-8727
INJ_505,20220302,6038,6038,0,0,16020,-9982
INJ_505,20220303,4125,4125,0,0,10991,-6866
INJ_505,20220304,5250,5250,0,0,13987,-8737
INJ_505,20220305,6375,6375,0,0,16984,-10609
INJ_505,20220307,4500,4500,0,-1,11987,-7487
INJ_505,20220308,3375,3375,0,1,8991,-5616
INJ_505,20220309,3750,3750,0,-1,9988,-6238
INJ_505,20220310,5250,5250,0,0,13989,-8739
INJ_505,20220311,7125,5625,0,-1,14987,-9362
INJ_505,20220312,7875,7875,0,0,20983,-13108
INJ_505,20220314,7500,7500,0,0,19977,-12477
INJ_505,20220315,5625,4500,0,0,11983,-7483
INJ_505,20220316,8250,8250,0,0,21971,-13721
INJ_505,20220317,7500,3000,0,0,7993,-4993
INJ_505,20220318,4875,4875,0,0,12985,-8110
INJ_505,20220319,4875,4875,0,1,12986,-8111
INJ_505,20220321,4125,4125,0,0,10986,-6861
INJ_505,20220322,2250,2250,0,1,5998,-3748
INJ_505,20220323,6750,6750,0,0,17980,-11230
INJ_505,20220324,6750,6750,0,0,17982,-11232
INJ_505,20220325,1875,1875,0,0,4997,-3122
INJ_505,20220326,4875,4875,0,1,12988,-8113
INJ_505,20220328,6375,6375,0,0,16983,-10608
INJ_505,20220329,6750,6750,0,-1,17984,-11234
INJ_505,20220330,7125,7125,0,-1,18978,-11853
INJ_505,20220331,6375,6375,0,-1,16986,-10611
INJ_505,20220401,8250,8250,0,-1,21987,-13737
INJ_505,20220402,4500,4500,0,0,11990,-7490
INJ_505,20220405,5250,5250,0,-1,13992,-8742
INJ_505,20220406,5250,5250,0,0,13991,-8741
INJ_505,20220407,1125,1125,0,0,2995,-1870
INJ_505,20220408,7125,5250,0,-1,13986,-8736
INJ_505,20220409,3750,3750,0,0,9988,-6238
INJ_505,20220411,3000,3000,0,1,7992,-4992
INJ_505,20220412,2625,2625,0,0,6994,-4369
INJ_505,20220413,2500,2500,0,0,4997,-2497
INJ_505,20220414,6000,6000,0,-1,15987,-9987
INJ_505,20220415,6375,6375,0,1,16984,-10609
INJ_505,20220416,3750,3750,0,1,9984,-6234
INJ_505,20220418,7500,7500,0,1,19988,-12488
INJ_505,20220419,6375,6375,0,0,16985,-10610
INJ_505,20220420,5625,5625,0,-1,14987,-9362
INJ_505,20220421,9750,9750,0,0,25985,-16235
INJ_505,20220422,4875,4875,0,-1,12984,-8109
INJ_505,20220424,2625,2625,0,0,6990,-4365
INJ_505,20220425,3000,3000,0,-1,7992,-4992
INJ_505,20220426,5250,5250,0,0,13985,-8735
INJ_505,20220427,7125,5625,0,1,14984,-9359
INJ_505,20220428,8625,8625,0,0,22977,-14352
INJ_505,20220429,4500,4500,0,0,11988,-7488
INJ_505,20220503,1875,1875,0,0,4997,-3122
INJ_505,20220504,6000,6000,0,6,15991,-9991
INJ_505,20220505,8625,8625,0,0,22982,-14357
INJ_505,20220506,10125,10125,0,1,26971,-16846
INJ_505,20220507,15375,15375,0,-1,40966,-25591
INJ_505,20220509,4125,4125,0,4,10986,-6861
INJ_505,20220510,8250,8250,0,0,21984,-13734
INJ_505,20220511,11625,11625,0,0,30976,-19351
INJ_505,20220512,3000,3000,0,0,7992,-4992
INJ_505,20220513,13875,13875,0,0,36964,-23089
INJ_505,20220514,6750,6750,0,0,17986,-11236
INJ_505,20220516,5250,5250,0,2,13867,-8617
INJ_505,20220517,13500,10875,0,1,28981,-18106
INJ_505,20220518,3375,3375,0,-1,8993,-5618
INJ_505,20220519,10350,8550,0,1,23985,-15435
INJ_505,20220520,4500,4500,0,-1,14987,-10487
INJ_505,20220521,6600,5400,0,0,17992,-12592
INJ_505,20220523,10500,7500,0,2,24981,-17481
INJ_505,20220524,1200,1200,0,3,3996,-2796
INJ_505,20220525,10800,10800,0,0,35977,-25177
INJ_505,20220526,1800,1800,0,0,5993,-4193
INJ_505,20220527,900,900,0,0,2997,-2097
INJ_505,20220528,1500,1500,0,0,4995,-3495
INJ_505,20220530,2430,2430,0,0,8059,-5629
INJ_505,20220601,2400,2400,0,1,7989,-5589
INJ_505,20220602,6300,6300,0,-1,20985,-14685
INJ_505,20220603,3600,3600,0,0,11988,-8388
INJ_505,20220604,1200,1200,0,0,3997,-2797
INJ_505,20220606,3900,3900,0,0,12988,-9088
INJ_505,20220607,5700,5700,0,1,18983,-13283
INJ_505,20220608,6000,4800,0,-1,15976,-11176
INJ_505,20220609,2700,2700,0,2,8994,-6294
INJ_505,20220610,3300,3300,0,0,10991,-7691
INJ_505,20220611,900,900,0,0,2995,-2095
INJ_505,20220613,3300,3300,0,1,10992,-7692
INJ_505,20220614,2400,2400,0,1,7992,-5592
INJ_505,20220616,2700,2700,0,0,8995,-6295
INJ_505,20220617,3300,3300,0,0,10994,-7694
INJ_505,20220618,6900,6900,0,1,22981,-16081
INJ_505,20220620,2700,2700,0,0,8981,-6281
INJ_505,20220621,3600,3600,0,1,11988,-8388
INJ_505,20220622,1200,1200,0,0,3996,-2796
INJ_505,20220623,5400,4200,0,-1,13988,-9788
INJ_505,20220624,2100,2100,0,0,6990,-4890
INJ_505,20220625,2400,2400,0,0,7989,-5589
INJ_505,20220701,2700,2700,0,-1,8992,-6292
INJ_505,20220702,6900,6900,0,0,22982,-16082
INJ_505,20220704,5700,4200,0,0,13992,-9792
INJ_505,20220705,2400,2400,0,5,7992,-5592
INJ_505,20220706,3900,3900,0,0,12988,-9088
INJ_505,20220707,7200,7200,0,1,23983,-16783
INJ_505,20220708,6000,4500,0,-1,14989,-10489
INJ_505,20220709,4650,4650,0,0,11988,-7338
INJ_505,20220711,1200,1200,0,-1,3997,-2797
INJ_505,20220712,6000,6000,0,1,19977,-13977
INJ_505,20220713,900,900,0,-1,2997,-2097
INJ_505,20220715,9000,9000,0,1,29972,-20972
INJ_505,20220716,3600,3600,0,1,11985,-8385
INJ_505,20220718,6900,6900,0,0,22976,-16076
INJ_505,20220719,3450,3450,0,-1,7995,-4545
INJ_505,20220720,10800,10800,0,1,35970,-25170
INJ_505,20220721,5400,5400,0,0,17986,-12586
INJ_505,20220722,5100,5100,0,1,16985,-11885
INJ_505,20220723,12900,11700,0,1,38967,-27267
INJ_505,20220725,3800,3800,0,0,7988,-4188
INJ_505,20220726,1800,1800,0,0,5995,-4195
INJ_505,20220727,8700,6900,0,0,22978,-16078
INJ_505,20220728,8400,7200,0,0,23978,-16778
INJ_505,20220729,11100,11100,0,0,36970,-25870
INJ_505,20220730,3900,3900,0,0,12986,-9086
INJ_505,20220801,6600,6600,0,-1,21981,-15381
INJ_505,20220802,8100,8100,0,0,26976,-18876
INJ_505,20220803,3900,3900,0,-1,12988,-9088
INJ_505,20220804,12300,10800,0,1,35972,-25172
INJ_505,20220805,10800,10800,0,2,35969,-25169
INJ_505,20220806,7500,7500,0,1,24977,-17477
INJ_505,20220808,9300,8100,0,0,19985,-11885
INJ_505,20220809,6300,6300,0,0,20981,-14681
INJ_505,20220810,6900,6900,0,0,22975,-16075
INJ_505,20220811,2400,2400,0,-1,7991,-5591
INJ_505,20220812,7200,5400,0,1,17980,-12580
INJ_505,20220813,3900,3900,0,0,12984,-9084
INJ_505,20220815,4800,4800,0,-1,15987,-11187
INJ_505,20220816,14400,13200,0,-1,43969,-30769
INJ_505,20220817,4500,4500,0,4,14989,-10489
INJ_505,20220818,3000,3000,0,-1,9991,-6991
INJ_505,20220819,4200,4200,0,1,13984,-9784
INJ_505,20220820,12800,12800,0,-1,37968,-25168
INJ_505,20220822,7500,7500,0,1,24979,-17479
INJ_505,20220823,8100,8100,0,1,26973,-18873
INJ_505,20220824,6900,6900,0,-1,22979,-16079
INJ_505,20220825,2400,2400,0,0,7991,-5591
INJ_505,20220826,5400,5400,0,0,17981,-12581
INJ_505,20220827,2400,2400,0,0,7989,-5589
INJ_505,20220829,6000,6000,0,0,19986,-13986
INJ_505,20220830,3900,3900,0,1,12985,-9085
INJ_505,20220831,3600,3600,0,0,11991,-8391
INJ_505,20220901,2400,1200,0,0,3995,-2795
INJ_505,20220902,1500,1500,0,1,4996,-3496
INJ_505,20220903,4200,4200,0,0,13987,-9787
INJ_505,20220905,7200,7200,0,0,23970,-16770
INJ_505,20220907,2400,2400,0,2,7998,-5598
INJ_505,20220908,900,900,0,0,2997,-2097
INJ_505,20220909,7800,7800,0,0,25979,-18179
INJ_505,20220910,9600,6600,0,0,21982,-15382
INJ_505,20220912,4500,3300,0,0,10987,-7687
INJ_505,20220913,2400,2400,0,0,7993,-5593
INJ_505,20220914,3000,3000,0,0,9992,-6992
INJ_505,20220915,1800,1800,0,1,5995,-4195
INJ_505,20220916,1200,1200,0,0,3995,-2795
INJ_505,20220917,8100,8100,0,1,26975,-18875
INJ_505,20220919,2700,2700,0,1,8992,-6292
INJ_505,20220920,5700,5700,0,-1,18986,-13286
INJ_505,20220921,6600,6600,0,0,21981,-15381
INJ_505,20220922,6300,6300,0,0,20985,-14685
INJ_505,20220923,9000,9000,0,0,29978,-20978
INJ_505,20220924,3000,3000,0,0,9995,-6995
INJ_505,20220926,6600,5400,0,1,17985,-12585
INJ_505,20220927,1200,1200,0,0,3996,-2796
INJ_505,20220928,3000,2100,0,1,6995,-4895
INJ_505,20220929,6450,6450,0,-2,17993,-11543
INJ_505,20220930,8100,8100,0,0,26979,-18879
INJ_505,20221004,3000,3000,0,0,9988,-6988
INJ_505,20221008,1500,1500,0,0,4997,-3497
INJ_505,20221011,1500,1500,0,0,4996,-3496
INJ_505,20221012,6000,6000,0,1,19982,-13982
INJ_505,20221013,16400,13400,0,2,45064,-31664
INJ_505,20221014,4500,4500,0,0,14992,-10492
INJ_505,20221015,5700,5700,0,0,18985,-13285
INJ_505,20221018,900,900,0,0,2996,-2096
INJ_505,20221019,2100,2100,0,0,6990,-4890
INJ_505,20221021,3300,3300,0,0,10990,-7690
INJ_505,20221022,1500,1500,0,0,4997,-3497
INJ_505,20221024,6900,6900,0,-1,22984,-16084
INJ_505,20221025,900,900,0,0,2998,-2098
INJ_505,20221026,2700,2700,0,1,8993,-6293
INJ_505,20221027,7500,7500,0,0,24982,-17482
INJ_505,20221028,4200,4200,0,0,13990,-9790
INJ_505,20221029,2100,2100,0,0,6994,-4894
INJ_505,20221102,4200,4200,0,0,13985,-9785
INJ_505,20221103,3000,3000,0,1,9986,-6986
INJ_505,20221104,2400,2400,0,0,7990,-5590
INJ_505,20221105,1800,1800,0,0,5997,-4197
INJ_505,20221107,3600,3600,0,1,11994,-8394
INJ_505,20221108,8700,7200,0,1,23978,-16778
INJ_505,20221110,7500,5100,0,0,16991,-11891
INJ_505,20221111,2100,2100,0,0,6993,-4893
INJ_505,20221112,1500,1500,0,1,4996,-3496
INJ_505,20221114,3900,2100,0,0,6992,-4892
INJ_505,20221116,3600,3600,0,0,11996,-8396
INJ_505,20221117,4200,4200,0,1,13989,-9789
INJ_505,20221118,7200,7200,0,0,23986,-16786
INJ_505,20221119,900,900,0,0,2998,-2098
INJ_505,20221121,3000,3000,0,0,9989,-6989
INJ_505,20221122,4200,4200,0,0,13995,-9795
INJ_505,20221124,2100,2100,0,0,6993,-4893
INJ_505,20221125,9300,9300,0,0,30973,-21673
INJ_505,20221126,900,900,0,0,2995,-2095
INJ_505,20221129,1500,1500,0,0,4996,-3496
INJ_505,20221201,900,900,0,1,2996,-2096
INJ_505,20221202,1500,1500,0,0,4997,-3497
INJ_505,20221205,14700,9900,0,0,32965,-23065
INJ_505,20221206,7650,7650,0,0,21984,-14334
INJ_505,20221207,2700,2700,0,1,8993,-6293
INJ_505,20221208,7800,6300,0,0,20983,-14683
INJ_505,20221209,7800,3600,0,0,6674,-3074
INJ_505,20221210,5400,5400,0,0,17986,-12586
INJ_505,20221212,2700,2700,0,0,8991,-6291
INJ_505,20221213,3450,3450,0,1,7991,-4541
INJ_505,20221214,1500,1500,0,1,4996,-3496
INJ_505,20221215,4800,4800,0,0,15989,-11189
INJ_505,20221216,3600,3600,0,0,11989,-8389
INJ_505,20221217,10800,9300,0,0,30980,-21680
INJ_505,20221219,3600,3600,0,1,11988,-8388
INJ_505,20221220,13200,8700,0,0,28976,-20276
INJ_505,20221221,1800,1800,0,0,5993,-4193
INJ_505,20221222,1200,1200,0,0,3996,-2796
INJ_505,20221223,3300,3300,0,0,10994,-7694
INJ_505,20221224,5100,5100,0,0,16988,-11888
INJ_505,20221226,2400,2400,0,0,7992,-5592
INJ_505,20221227,3000,3000,0,0,9994,-6994
INJ_505,20221228,4200,4200,0,1,13989,-9789
INJ_505,20221229,4800,4800,0,1,15986,-11186
INJ_505,20221230,6600,5100,0,0,16981,-11881
INJ_505,20221231,2400,2400,0,0,7991,-5591
INJ_505,20230102,6900,6900,0,1,22985,-16085
INJ_505,20230103,5100,5100,0,0,16984,-11884
INJ_505,20230104,1500,1500,0,0,4997,-3497
INJ_505,20230105,6600,6600,0,0,21978,-15378
INJ_505,20230106,1500,1500,0,-1,4998,-3498
INJ_505,20230107,3600,3600,0,0,11993,-8393
INJ_505,20230109,6600,6600,0,0,21977,-15377
INJ_505,20230110,5850,5850,0,0,15992,-10142
INJ_505,20230111,5700,5700,0,0,18986,-13286
INJ_505,20230112,2700,2700,0,0,8990,-6290
INJ_505,20230113,1200,1200,0,0,3996,-2796
INJ_505,20230114,1500,1500,0,0,4995,-3495
INJ_505,20230116,5700,5700,0,0,18982,-13282
INJ_505,20230118,4800,4800,0,-1,15989,-11189
INJ_505,20230119,2100,2100,0,0,6991,-4891
INJ_505,20230120,5400,3000,0,0,9995,-6995
INJ_505,20230121,1200,1200,0,0,3994,-2794
INJ_505,20230123,5400,5400,0,0,17986,-12586
INJ_505,20230124,1200,1200,0,0,3995,-2795
INJ_505,20230125,3900,3900,0,1,12992,-9092
INJ_505,20230126,9900,9900,0,-1,32980,-23080
INJ_505,20230127,9900,9900,0,0,32977,-23077
INJ_505,20230128,4800,3600,0,0,11994,-8394
INJ_505,20230130,6300,6300,0,0,20985,-14685
INJ_505,20230202,7050,7050,0,-1,19982,-12932
INJ_505,20230203,3600,3600,0,0,11989,-8389
INJ_505,20230204,3900,3900,0,-1,12992,-9092
INJ_505,20230206,2100,2100,0,1,6993,-4893
INJ_505,20230207,5600,5600,0,0,13985,-8385
INJ_505,20230208,2700,2700,0,0,8992,-6292
INJ_505,20230209,2400,2400,0,0,7992,-5592
INJ_505,20230210,2400,2400,0,-1,7993,-5593
INJ_505,20230211,900,900,0,0,2996,-2096
INJ_505,20230213,5100,5100,0,0,16985,-11885
INJ_505,20230214,2100,2100,0,0,6995,-4895
INJ_505,20230215,1500,1500,0,0,4995,-3495
INJ_505,20230216,1200,1200,0,0,3995,-2795
INJ_505,20230217,7200,7200,0,0,23981,-16781
INJ_505,20230218,2400,2400,0,0,7991,-5591
INJ_505,20230220,3600,3600,0,0,11986,-8386
INJ_505,20230221,6300,6300,0,0,20988,-14688
INJ_505,20230222,4800,4800,0,0,15982,-11182
INJ_505,20230223,5700,5700,0,-1,18988,-13288
INJ_505,20230224,2100,2100,0,1,6993,-4893
INJ_505,20230225,3000,3000,0,0,9990,-6990
INJ_505,20230227,900,900,0,-1,2997,-2097
INJ_505,20230228,7800,7800,0,0,25978,-18178
INJ_505,20230301,2700,2700,1,955,8991,-6291
INJ_505,20230302,4800,4800,0,0,15987,-11187
INJ_505,20230303,5400,5400,0,599,17978,-12578
INJ_505,20230304,8400,8400,0,0,27981,-19581
INJ_505,20230306,4800,3600,0,0,11986,-8386
INJ_505,20230307,2700,2700,2,104,8989,-6289
INJ_505,20230308,6600,6600,0,749,21982,-15382
INJ_505,20230309,4500,4500,1,348,14987,-10487
INJ_505,20230310,8400,8400,1,201,27967,-19567
INJ_505,20230311,5400,5400,0,0,17983,-12583
INJ_505,20230314,900,900,0,-1,2995,-2095
INJ_505,20230315,6600,6600,0,453,21982,-15382
INJ_505,20230316,6900,6900,1,202,22983,-16083
INJ_505,20230317,6900,6900,0,452,22979,-16079
INJ_505,20230318,3600,3600,0,902,11991,-8391
INJ_505,20230320,2100,2100,0,601,6996,-4896
INJ_505,20230321,6750,6750,0,1,18979,-12229
INJ_505,20230323,5100,5100,1,501,16980,-11880
INJ_505,20230324,9300,9300,0,602,30982,-21682
INJ_505,20230325,3900,3900,0,0,12988,-9088
INJ_505,20230327,3900,3900,0,449,12990,-9090
INJ_505,20230328,1800,1800,0,1,5996,-4196
INJ_505,20230329,2400,2400,0,0,7992,-5592
INJ_505,20230330,5100,5100,0,903,16983,-11883
INJ_505,20230331,2400,2400,0,597,7991,-5591
INJ_505,20230401,6000,4500,0,748,14988,-10488
INJ_505,20230403,1500,1500,0,0,4994,-3494
INJ_505,20230404,7500,7500,0,751,24981,-17481
INJ_505,20230405,92850,8550,0,0,17985,-9435
INJ_505,20230406,2400,2400,0,0,7997,-5597
INJ_505,20230407,1200,1200,0,0,3996,-2796
INJ_505,20230408,3300,3300,0,0,10991,-7691
INJ_505,20230410,1500,1500,0,-1,4996,-3496
INJ_505,20230411,2400,2400,0,0,7991,-5591
INJ_505,20230412,3000,3000,0,0,9990,-6990
INJ_505,20230414,2400,2400,0,600,7994,-5594
INJ_505,20230415,1500,1500,0,0,4995,-3495
INJ_505,20230417,8100,8100,0,749,26978,-18878
INJ_505,20230418,4500,4500,0,-1,14990,-10490
INJ_505,20230420,6900,6000,0,751,19984,-13984
INJ_505,20230421,8700,7500,0,0,24973,-17473
INJ_505,20230424,900,900,0,0,2996,-2096
INJ_505,20230425,5700,5700,0,-1,18984,-13284
INJ_505,20230426,4200,4200,0,1,13986,-9786
INJ_505,20230427,1500,1500,0,0,4995,-3495
INJ_505,20230428,2400,2400,0,599,7993,-5593
INJ_505,20230429,9000,9000,0,1,29976,-20976
INJ_505,20230501,4200,4200,0,0,13990,-9790
INJ_505,20230502,7800,7800,0,-1,25979,-18179
INJ_505,20230503,1800,1800,0,0,5993,-4193
INJ_505,20230504,1500,1500,0,900,4995,-3495
INJ_505,20230505,5400,5400,3,450,17986,-12586
INJ_505,20230506,2700,2700,0,0,8996,-6296
INJ_505,20230508,2400,2400,0,750,7994,-5594
INJ_505,20230509,3600,3600,0,0,11990,-8390
INJ_505,20230510,2400,2400,0,0,7994,-5594
INJ_505,20230512,2400,2400,1,46,7991,-5591
INJ_505,20230513,1200,1200,0,0,3994,-2794
INJ_505,20230515,5700,5700,0,-1,18983,-13283
INJ_505,20230517,1800,1800,0,601,5996,-4196
INJ_505,20230519,9900,9900,0,0,32986,-23086
INJ_505,20230520,1200,1200,0,450,3996,-2796
INJ_505,20230524,7200,7200,0,0,23987,-16787
INJ_505,20230525,3600,3600,0,598,11994,-8394
INJ_505,20230526,5700,5700,0,0,18989,-13289
INJ_505,20230527,3600,3600,0,0,11990,-8390
INJ_505,20230529,5100,3300,1,648,10993,-7693
INJ_505,20230530,1500,1500,1,204,4995,-3495
INJ_505,20230531,4500,4500,0,-1,14995,-10495
INJ_505,20230602,3300,3300,0,1,10993,-7693
INJ_505,20230603,3900,3900,0,0,12989,-9089
INJ_505,20230605,1500,1500,0,0,4998,-3498
INJ_505,20230608,2400,2400,0,451,7992,-5592
INJ_505,20230609,4200,4200,3,156,13987,-9787
INJ_505,20230612,3000,3000,1,502,9991,-6991
INJ_505,20230614,4200,4200,0,1,13986,-9786
INJ_505,20230615,2700,2700,0,453,8992,-6292
INJ_505,20230616,5100,5100,0,451,16989,-11889
INJ_505,20230617,3000,3000,1,654,9987,-6987
INJ_505,20230619,3300,3300,0,0,10992,-7692
INJ_505,20230621,6550,6550,1,46,15989,-9439
INJ_505,20230622,5400,5400,1,205,17988,-12588
INJ_505,20230623,2100,2100,1,51,6991,-4891
INJ_505,20230624,6600,4500,0,450,14991,-10491
INJ_505,20230626,7800,7800,1,500,25978,-18178
INJ_505,20230627,4200,4200,1,50,13990,-9790
INJ_505,20230628,6900,6900,0,1,22982,-16082
INJ_505,20230630,1500,1500,0,-1,4994,-3494
INJ_505,20230701,2400,2400,0,752,7994,-5594
INJ_505,20230703,2400,2400,0,748,7993,-5593
INJ_505,20230704,5100,5100,0,0,16980,-11880
INJ_505,20230705,1800,1800,0,0,5996,-4196
INJ_505,20230706,3000,3000,0,0,9989,-6989
INJ_505,20230707,4200,4200,0,0,13990,-9790
INJ_505,20230708,2400,2400,0,0,7996,-5596
INJ_505,20230710,9600,6300,0,0,20988,-14688
INJ_505,20230711,2700,2700,0,-1,8992,-6292
INJ_505,20230712,2700,2700,1,55,8992,-6292
INJ_505,20230713,26400,4200,0,-1,13990,-9790
INJ_505,20230714,29100,4200,0,749,13986,-9786
INJ_505,20230717,81900,6900,0,1,22982,-16082
INJ_505,20230718,12300,9900,1,54,32973,-23073
INJ_505,20230719,900,900,0,0,2997,-2097
INJ_506,20210927,4300,4300,0,2,51965,-47665
INJ_506,20210928,12000,12000,1,607,99928,-87928
INJ_506,20210929,6500,6500,0,4,56954,-50454
INJ_506,20210930,8700,8000,0,2,71936,-63936
INJ_506,20211001,9600,9600,0,20,79934,-70334
INJ_506,20211002,10100,10100,0,-1,82922,-72822
INJ_506,20211004,8500,7300,0,10,56945,-49645
INJ_506,20211005,4400,4400,0,0,43972,-39572
INJ_506,20211006,8900,8300,0,-2,74943,-66643
INJ_506,20211007,8000,7300,0,49,72950,-65650
INJ_506,20211008,12300,12300,0,31,96935,-84635
INJ_506,20211009,9800,9800,0,12,75928,-66128
INJ_506,20211011,8300,8300,0,7,68947,-60647
INJ_506,20211012,9500,9500,0,14,78934,-69434
INJ_506,20211013,3100,3100,12,182,22988,-19888
INJ_506,20211014,1000,1000,13,718,9991,-8991
INJ_506,20211015,17000,15500,0,-3,118887,-103387
INJ_506,20211016,5800,5200,0,0,37961,-32761
INJ_506,20211018,7400,6700,0,0,56954,-50254
INJ_506,20211019,7500,7500,0,1,66947,-59447
INJ_506,20211020,11900,11200,0,-1,93913,-82713
INJ_506,20211021,5200,4500,0,10,44969,-40469
INJ_506,20211022,7200,6500,0,19,56957,-50457
INJ_506,20211023,8200,8200,0,1,73939,-65739
INJ_506,20211025,12600,8900,0,9,74942,-66042
INJ_506,20211026,6700,6300,0,46,46962,-40662
INJ_506,20211027,5700,5700,0,24,56959,-51259
INJ_506,20211028,9300,9300,0,15,70954,-61654
INJ_506,20211029,5400,4700,0,2,46969,-42269
INJ_506,20211030,13300,13300,0,18,98922,-85622
INJ_506,20211101,11000,11000,0,-2,89916,-78916
INJ_506,20211102,7000,7000,0,33,61947,-54947
INJ_506,20211103,7700,7700,0,2,68940,-61240
INJ_506,20211104,13000,13000,0,1,121907,-108907
INJ_506,20211105,8500,7600,1,532,60955,-53355
INJ_506,20211106,7700,7000,0,25,62949,-55949
INJ_506,20211108,8200,8200,0,-2,63949,-55749
INJ_506,20211109,6200,6200,0,20,43961,-37761
INJ_506,20211110,7600,7600,0,-1,57951,-50351
INJ_506,20211111,7400,7400,0,18,73944,-66544
INJ_506,20211112,23000,22300,0,21,180853,-158553
INJ_506,20211113,8700,8700,0,824,80942,-72242
INJ_506,20211115,18000,17600,0,3,139899,-122299
INJ_506,20211116,8700,8300,0,6,74934,-66634
INJ_506,20211117,7100,6600,0,-1,59953,-53353
INJ_506,20211118,7200,6600,0,1,57955,-51355
INJ_506,20211119,8900,7900,0,2,70935,-63035
INJ_506,20211120,7200,6700,0,0,58954,-52254
INJ_506,20211122,10800,10800,0,0,83930,-73130
INJ_506,20211123,10200,9500,0,2,94923,-85423
INJ_506,20211124,9800,9800,0,0,83941,-74141
INJ_506,20211125,8300,8300,0,0,68948,-60648
INJ_506,20211126,5700,5700,0,0,56955,-51255
INJ_506,20211127,8000,6600,0,3,57970,-51370
INJ_506,20211129,7700,6700,0,-1,56951,-50251
INJ_506,20211130,5500,5500,0,-1,54946,-49446
INJ_506,20211201,7600,7600,0,21,53948,-46348
INJ_506,20211202,5900,5900,0,0,42955,-37055
INJ_506,20211203,6100,6100,0,6,40968,-34868
INJ_506,20211204,5000,5000,0,1,49960,-44960
INJ_506,20211206,10700,10400,0,10,87928,-77528
INJ_506,20211207,10400,10400,0,3,79943,-69543
INJ_506,20211208,11700,11000,0,6,91943,-80943
INJ_506,20211209,11000,10400,0,30,93923,-83523
INJ_506,20211210,12600,12600,0,-1,107918,-95318
INJ_506,20211211,10900,10900,0,0,94923,-84023
INJ_506,20211213,9000,9000,0,-1,71944,-62944
INJ_506,20211214,6100,6100,0,17,60924,-54824
INJ_506,20211215,12600,12100,0,0,98910,-86810
INJ_506,20211216,9100,8800,0,-1,87915,-79115
INJ_506,20211217,9000,7800,0,4,59953,-52153
INJ_506,20211218,12000,12000,0,44,93922,-81922
INJ_506,20211220,6700,6700,0,-1,58933,-52233
INJ_506,20211221,8100,7700,0,52,60939,-53239
INJ_506,20211222,6900,6900,0,58,68951,-62051
INJ_506,20211223,8900,8900,0,1,88917,-80017
INJ_506,20211224,11000,11000,0,2,99898,-88898
INJ_506,20211225,3300,3300,0,17,32973,-29673
INJ_506,20211227,12900,11400,0,-2,99913,-88513
INJ_506,20211228,6500,6500,0,0,58460,-51960
INJ_506,20211229,7500,7500,0,1,64943,-57443
INJ_506,20211230,8800,8000,0,2,71940,-63940
INJ_506,20211231,10200,9600,0,1,85937,-76337
INJ_506,20220101,10100,10100,0,2,90935,-80835
INJ_506,20220103,2900,2900,0,0,28976,-26076
INJ_506,20220104,9400,9400,0,60,73941,-64541
INJ_506,20220105,11600,10900,0,-1,90928,-80028
INJ_506,20220106,9600,9600,0,0,95937,-86337
INJ_506,20220107,10400,9700,0,11,76932,-67232
INJ_506,20220108,9500,8700,0,-1,80942,-72242
INJ_506,20220110,12600,12600,0,19,111897,-99297
INJ_506,20220111,14400,14400,0,22,119901,-105501
INJ_506,20220112,12600,11800,0,4,85508,-73708
INJ_506,20220113,10400,10000,0,-3,91933,-81933
INJ_506,20220114,9200,9200,0,11,73948,-64748
INJ_506,20220115,10200,9500,0,10,76935,-67435
INJ_506,20220117,11000,10500,0,2,94927,-84427
INJ_506,20220118,8000,8000,0,1,71940,-63940
INJ_506,20220119,8800,8400,0,1,83935,-75535
INJ_506,20220120,6600,6100,0,-1,36968,-30868
INJ_506,20220121,11100,10200,0,7,85919,-75719
INJ_506,20220122,15300,14100,0,-2,114906,-100806
INJ_506,20220124,9100,9100,0,11,80934,-71834
INJ_506,20220125,9800,9800,0,-2,97931,-88131
INJ_506,20220126,12700,12700,0,10,105045,-92345
INJ_506,20220127,3200,3200,0,18,23986,-20786
INJ_506,20220128,9100,8500,0,45,84927,-76427
INJ_506,20220129,9900,9100,0,12,90936,-81836
INJ_506,20220131,7000,7000,0,19,63952,-56952
INJ_506,20220201,10800,10800,0,13,83942,-73142
INJ_506,20220202,13700,13400,0,2,123893,-110493
INJ_506,20220203,10000,9700,0,0,96922,-87222
INJ_506,20220204,9900,9900,0,1,80939,-71039
INJ_506,20220205,5000,5000,0,1,41960,-36960
INJ_506,20220207,5500,5500,0,-1,42964,-37464
INJ_506,20220208,9200,8300,0,65,76759,-68459
INJ_506,20220209,8600,8600,0,31,77938,-69338
INJ_506,20220210,10800,10800,0,14,89926,-79126
INJ_506,20220211,3500,3500,0,1,34974,-31474
INJ_506,20220212,6900,6900,0,1,68952,-62052
INJ_506,20220214,9300,9300,0,-1,86940,-77640
INJ_506,20220215,6900,6200,0,0,53944,-47744
INJ_506,20220216,2100,2100,0,-1,14984,-12884
INJ_506,20220217,9400,8700,0,0,78924,-70224
INJ_506,20220218,7900,7200,0,0,71936,-64736
INJ_506,20220219,11500,11100,0,0,84920,-73820
INJ_506,20220221,7600,7600,0,0,67940,-60340
INJ_506,20220222,8600,7100,0,8,60946,-53846
INJ_506,20220223,8800,8800,0,1,87931,-79131
INJ_506,20220224,11800,11800,0,2,117880,-106080
INJ_506,20220225,13000,11000,0,-2,95903,-84903
INJ_506,20220226,5500,5500,0,24,54937,-49437
INJ_506,20220228,4800,4800,0,1,39955,-35155
INJ_506,20220301,10000,8700,0,-1,70938,-62238
INJ_506,20220302,12200,9800,0,0,89932,-80132
INJ_506,20220303,6400,6400,0,-1,57950,-51550
INJ_506,20220304,7000,7000,0,10,57946,-50946
INJ_506,20220305,11300,9700,0,8,79932,-70232
INJ_506,20220307,7800,7800,0,1,67745,-59945
INJ_506,20220308,11400,11400,0,-1,105906,-94506
INJ_506,20220309,3100,3100,0,0,22981,-19881
INJ_506,20220310,9600,9600,0,2,87915,-78315
INJ_506,20220311,11000,10000,0,2,81936,-71936
INJ_506,20220312,6400,6400,0,2,53952,-47552
INJ_506,20220314,12000,12000,0,0,111898,-99898
INJ_506,20220315,13300,12600,0,0,117894,-105294
INJ_506,20220316,10600,10600,0,0,99930,-89330
INJ_506,20220317,7300,4500,0,1,36971,-32471
INJ_506,20220318,13600,10700,0,-1,90937,-80237
INJ_506,20220319,6000,6000,0,1,51959,-45959
INJ_506,20220321,8300,7600,0,2,75939,-68339
INJ_506,20220322,2600,2600,0,-1,25976,-23376
INJ_506,20220323,7700,7700,0,-1,68949,-61249
INJ_506,20220324,8900,8900,0,-1,78942,-70042
INJ_506,20220325,5300,5300,0,2,44969,-39669
INJ_506,20220326,10300,10300,0,16,92917,-82617
INJ_506,20220328,7800,7800,0,3,69937,-62137
INJ_506,20220329,5700,5700,0,1,48928,-43228
INJ_506,20220330,8800,8000,0,-2,79941,-71941
INJ_506,20220331,9700,9700,0,18,78935,-69235
INJ_506,20220401,8300,8300,0,12,74938,-66638
INJ_506,20220402,8800,8800,0,0,75937,-67137
INJ_506,20220404,9500,9500,0,-2,78945,-69445
INJ_506,20220405,9600,9600,0,18,87923,-78323
INJ_506,20220406,11800,11800,0,-2,101927,-90127
INJ_506,20220407,8000,7600,0,1,57942,-50342
INJ_506,20220408,4800,4000,0,-1,39965,-35965
INJ_506,20220409,16400,16400,0,0,145867,-129467
INJ_506,20220411,9700,9700,0,20,88915,-79215
INJ_506,20220412,6200,6200,0,19,61951,-55751
INJ_506,20220413,8000,8000,0,0,79936,-71936
INJ_506,20220414,10900,10900,0,-2,90916,-80016
INJ_506,20220415,16700,16200,0,0,151856,-135656
INJ_506,20220416,8900,8900,0,31,78921,-70021
INJ_506,20220418,11700,10100,0,0,100912,-90812
INJ_506,20220419,7200,7200,0,0,71939,-64739
INJ_506,20220420,6460,6460,0,0,56377,-49917
INJ_506,20220421,17300,17300,0,1,146872,-129572
INJ_506,20220422,12000,12000,0,9,87941,-75941
INJ_506,20220424,7100,7100,0,-1,70944,-63844
INJ_506,20220425,5900,5900,0,-1,58951,-53051
INJ_506,20220426,6900,6900,0,-2,58959,-52059
INJ_506,20220427,12400,11600,0,3,105921,-94321
INJ_506,20220428,8300,8300,0,0,82955,-74655
INJ_506,20220429,9300,9300,0,15,92921,-83621
INJ_506,20220503,9100,9100,0,-1,64946,-55846
INJ_506,20220504,8800,8800,0,41,57939,-49139
INJ_506,20220505,11600,11600,0,2,91927,-80327
INJ_506,20220506,14100,13400,0,0,127901,-114501
INJ_506,20220507,14000,14000,0,14,123898,-109898
INJ_506,20220509,8600,8600,0,34,82933,-74333
INJ_506,20220510,6900,6900,0,0,50956,-44056
INJ_506,20220511,11800,9800,0,1,97919,-88119
INJ_506,20220512,7400,7400,0,29,57943,-50543
INJ_506,20220513,19700,19700,0,0,164862,-145162
INJ_506,20220514,12700,12000,0,1,119903,-107903
INJ_506,20220516,9600,8900,0,-1,68955,-60055
INJ_506,20220517,15300,15300,0,2,112886,-97586
INJ_506,20220518,12100,12100,0,19,120887,-108787
INJ_506,20220519,16100,14300,0,18,136874,-122574
INJ_506,20220520,16100,16100,0,41,134882,-118782
INJ_506,20220521,6850,6150,0,2,53959,-47809
INJ_506,20220523,11200,10400,0,1,97878,-87478
INJ_506,20220524,9250,8450,0,1,79938,-71488
INJ_506,20220525,15550,15550,0,3,126905,-111355
INJ_506,20220526,8600,8600,0,2,73943,-65343
INJ_506,20220527,5700,5700,0,2,50959,-45259
INJ_506,20220528,7500,7500,0,1,74931,-67431
INJ_506,20220530,7950,7550,0,21,58953,-51403
INJ_506,20220531,9800,8200,0,0,75939,-67739
INJ_506,20220601,6000,6000,0,0,59945,-53945
INJ_506,20220602,9900,9500,0,1,94912,-85412
INJ_506,20220603,8900,8900,0,61,82937,-74037
INJ_506,20220604,2900,2900,0,36,28968,-26068
INJ_506,20220606,4000,4000,0,3,39972,-35972
INJ_506,20220607,11850,11850,0,1,110921,-99071
INJ_506,20220608,10900,8600,0,1,85935,-77335
INJ_506,20220609,4700,4700,0,48,40969,-36269
INJ_506,20220610,10650,10650,0,0,101915,-91265
INJ_506,20220611,6600,6600,0,2,65952,-59352
INJ_506,20220613,10500,10500,0,0,92918,-82418
INJ_506,20220614,9250,9250,0,-1,87927,-78677
INJ_506,20220615,16600,13700,0,23,130894,-117194
INJ_506,20220616,6000,6000,0,41,59958,-53958
INJ_506,20220617,10000,10000,0,0,93933,-83933
INJ_506,20220618,9200,9200,0,-1,91914,-82714
INJ_506,20220620,4800,4500,0,4,44885,-40385
INJ_506,20220621,8300,7600,0,-1,75945,-68345
INJ_506,20220622,3700,3700,0,4,36764,-33064
INJ_506,20220623,7500,7000,0,-2,60777,-53777
INJ_506,20220624,6000,6000,0,20,53965,-47965
INJ_506,20220625,6650,6650,0,-1,58948,-52298
INJ_506,20220627,1600,1600,0,0,15987,-14387
INJ_506,20220701,4550,4550,0,0,40996,-36446
INJ_506,20220702,12400,12400,0,-2,117958,-105558
INJ_506,20220704,4200,3200,0,1,31987,-28787
INJ_506,20220705,4500,4500,0,-1,44979,-40479
INJ_506,20220706,9950,9950,0,1,76975,-67025
INJ_506,20220707,11150,11150,0,1,106968,-95818
INJ_506,20220708,14400,14400,0,63,110968,-96568
INJ_506,20220709,3100,3100,0,16,30991,-27891
INJ_506,20220711,3150,3150,0,-1,26997,-23847
INJ_506,20220712,5700,5700,0,0,56981,-51281
INJ_506,20220713,3400,3400,0,11,33989,-30589
INJ_506,20220714,1700,1700,0,-1,16995,-15295
INJ_506,20220715,8450,8450,0,-1,73983,-65533
INJ_506,20220716,7600,7600,0,-1,75979,-68379
INJ_506,20220718,12550,12550,0,1,105981,-93431
INJ_506,20220719,6750,6750,0,0,59996,-53246
INJ_506,20220720,11750,11750,0,0,97985,-86235
INJ_506,20220721,13550,13150,0,0,108989,-95839
INJ_506,20220722,11600,9400,0,83,87982,-78582
INJ_506,20220723,14300,13600,0,1,123958,-110358
INJ_506,20220725,14000,13500,0,1,92975,-79475
INJ_506,20220726,5700,5700,0,1,47984,-42284
INJ_506,20220727,12350,11450,0,-3,97978,-86528
INJ_506,20220728,11650,10950,0,0,98982,-88032
INJ_506,20220729,11950,11150,0,0,100978,-89828
INJ_506,20220730,16250,16250,0,0,121976,-105726
INJ_506,20220801,12550,12550,0,25,90988,-78438
INJ_506,20220802,11250,10450,0,1,93969,-83519
INJ_506,20220803,8200,8200,0,0,72979,-64779
INJ_506,20220804,19100,16100,0,0,130958,-114858
INJ_506,20220805,15850,15850,0,2,129976,-114126
INJ_506,20220806,18400,18400,0,-1,156955,-138555
INJ_506,20220808,8100,6800,0,-3,67992,-61192
INJ_506,20220809,11850,11150,0,1,106967,-95817
INJ_506,20220810,10100,9800,0,2,97966,-88166
INJ_506,20220811,6550,6550,0,1,60977,-54427
INJ_506,20220812,11550,9600,0,0,74974,-65374
INJ_506,20220813,7900,7900,0,1,72979,-65079
INJ_506,20220815,11250,10850,0,3,91968,-81118
INJ_506,20220816,15500,14700,0,24,140970,-126270
INJ_506,20220817,11100,11100,0,0,89973,-78873
INJ_506,20220818,4400,4400,0,0,37990,-33590
INJ_506,20220819,9500,8800,0,1,81981,-73181
INJ_506,20220820,17200,17200,0,0,165951,-148751
INJ_506,20220822,12650,12650,0,62,118963,-106313
INJ_506,20220823,14950,14950,0,-1,135951,-121001
INJ_506,20220824,10800,10800,0,-1,101967,-91167
INJ_506,20220825,2400,2400,0,0,23996,-21596
INJ_506,20220826,7000,7000,0,0,69984,-62984
INJ_506,20220827,9950,9950,0,1,76973,-67023
INJ_506,20220829,12900,12900,0,-1,110975,-98075
INJ_506,20220830,7700,7700,0,-3,76985,-69285
INJ_506,20220831,13200,11900,0,15,106974,-95074
INJ_506,20220901,8400,7600,0,-1,57977,-50377
INJ_506,20220902,2800,400,0,0,3999,-3599
INJ_506,20220903,15700,1700,0,0,10997,-9297
INJ_506,20220908,2100,1400,0,2,2470,-1070
INJ_506,20220909,12950,12950,0,-2,115977,-103027
INJ_506,20220910,11000,9000,0,-1,83977,-74977
INJ_506,20220912,13100,12500,0,0,100979,-88479
INJ_506,20220913,9500,9500,0,-1,88989,-79489
INJ_506,20220914,9800,9800,0,-1,91976,-82176
INJ_506,20220915,9700,9500,0,3,82965,-73465
INJ_506,20220916,6300,6300,0,1,62981,-56681
INJ_506,20220917,9350,9350,0,-1,82976,-73626
INJ_506,20220919,4850,4850,0,0,43988,-39138
INJ_506,20220920,7750,7750,0,-1,69982,-62232
INJ_506,20220921,9650,8950,0,-1,84976,-76026
INJ_506,20220922,9150,8450,0,-1,79980,-71530
INJ_506,20220923,9350,9350,0,-1,85969,-76619
INJ_506,20220924,1000,1000,0,0,9998,-8998
INJ_506,20220926,8100,6350,0,-1,52992,-46642
INJ_506,20220927,6400,6400,0,1,63985,-57585
INJ_506,20220928,7500,6500,3,478,64997,-58497
INJ_506,20220929,3800,3800,0,10,37991,-34191
INJ_506,20220930,8700,8700,0,0,80979,-72279
INJ_506,20221001,3300,1700,22,744,16995,-15295
INJ_506,20221004,12400,12400,22,252,123969,-111569
INJ_506,20221005,9900,9900,1,649,98985,-89085
INJ_506,20221006,10550,10150,0,-1,93971,-83821
INJ_506,20221007,6400,6400,4,97,77972,-71572
INJ_506,20221008,8100,7300,0,24,58981,-51681
INJ_506,20221010,3900,3900,0,2,32990,-29090
INJ_506,20221011,5850,5850,0,1,53989,-48139
INJ_506,20221012,10800,10800,0,-2,95975,-85175
INJ_506,20221013,11100,10600,0,0,93988,-83388
INJ_506,20221014,11100,10700,0,98,102977,-92277
INJ_506,20221015,15150,15150,0,23,137949,-122799
INJ_506,20221017,8200,7600,0,0,75976,-68376
INJ_506,20221018,8200,6600,0,-1,65979,-59379
INJ_506,20221019,7200,6500,0,0,64980,-58480
INJ_506,20221020,1900,1900,1,653,18996,-17096
INJ_506,20221021,4600,4600,0,15,45997,-41397
INJ_506,20221022,6500,6500,0,-1,58970,-52470
INJ_506,20221024,7050,7050,0,0,53981,-46931
INJ_506,20221025,6500,6500,0,0,64984,-58484
INJ_506,20221026,7200,7200,0,3,71981,-64781
INJ_506,20221027,7900,6900,0,-2,62973,-56073
INJ_506,20221028,9100,9100,0,1,90975,-81875
INJ_506,20221029,2900,2900,0,0,21997,-19097
INJ_506,20221031,3300,3300,0,3,32996,-29696
INJ_506,20221101,8000,8000,0,-1,79976,-71976
INJ_506,20221102,11600,11600,0,1,109974,-98374
INJ_506,20221103,6400,6400,0,0,63982,-57582
INJ_506,20221104,8150,8150,0,1,67993,-59843
INJ_506,20221105,5450,5450,0,-2,46988,-41538
INJ_506,20221107,5000,5000,0,0,49992,-44992
INJ_506,20221108,9100,8700,0,12,80982,-72282
INJ_506,20221109,3300,3300,0,1,32991,-29691
INJ_506,20221110,5200,5200,0,-1,51989,-46789
INJ_506,20221111,6750,6750,0,2,59977,-53227
INJ_506,20221112,8100,8100,0,-1,80981,-72881
INJ_506,20221114,5400,4400,0,0,43988,-39588
INJ_506,20221115,4050,4050,0,0,32988,-28938
INJ_506,20221116,3900,3900,0,1,38989,-35089
INJ_506,20221117,7700,7700,0,0,70979,-63279
INJ_506,20221118,10550,10250,0,0,97976,-87726
INJ_506,20221119,3100,3100,0,0,30994,-27894
INJ_506,20221121,3800,3800,0,12,28985,-25185
INJ_506,20221122,12700,11000,0,1,103986,-92986
INJ_506,20221123,3000,3000,0,0,30004,-27004
INJ_506,20221124,9700,9200,0,1,77003,-67803
INJ_506,20221125,9850,9850,0,2,87921,-78071
INJ_506,20221126,6000,6000,0,-2,59986,-53986
INJ_506,20221128,8100,8100,0,5,74985,-66885
INJ_506,20221129,7150,7150,0,1,66970,-59820
INJ_506,20221130,6500,6500,0,1,64997,-58497
INJ_506,20221201,6200,6200,0,1,61996,-55796
INJ_506,20221202,5050,5050,0,0,42993,-37943
INJ_506,20221203,6200,5400,0,-1,53983,-48583
INJ_506,20221205,10650,9250,0,2,81957,-72707
INJ_506,20221206,11650,10550,0,-4,94974,-84424
INJ_506,20221207,2200,2200,0,2,21989,-19789
INJ_506,20221208,11750,10950,0,1,89980,-79030
INJ_506,20221209,9700,7400,0,1,68544,-61144
INJ_506,20221210,10000,9600,0,1,83989,-74389
INJ_506,20221212,9300,7900,0,-2,78908,-71008
INJ_506,20221213,4000,4000,0,-1,39989,-35989
INJ_506,20221214,4850,4850,0,0,43984,-39134
INJ_506,20221215,9200,9200,0,0,85985,-76785
INJ_506,20221216,8150,7350,0,2,68987,-61637
INJ_506,20221217,8800,8800,0,2,87986,-79186
INJ_506,20221219,6700,6700,0,-2,66987,-60287
INJ_506,20221220,10150,7750,0,1,72984,-65234
INJ_506,20221221,8200,8200,0,2,81980,-73780
INJ_506,20221222,4700,4700,0,0,46992,-42292
INJ_506,20221223,6300,6000,0,-1,59995,-53995
INJ_506,20221224,5750,5750,0,0,52995,-47245
INJ_506,20221226,4850,4850,0,0,44001,-39151
INJ_506,20221227,1000,1000,0,526,9999,-8999
INJ_506,20221228,9500,9500,0,0,82984,-73484
INJ_506,20221229,7650,7650,0,0,65984,-58334
INJ_506,20221230,10050,9450,0,5,83980,-74530
INJ_506,20221231,5300,5300,0,1,46991,-41691
INJ_506,20230102,9000,9000,0,0,89981,-80981
INJ_506,20230103,7100,7100,0,0,52992,-45892
INJ_506,20230104,7700,6900,0,2,62986,-56086
INJ_506,20230105,10900,10900,0,-1,102979,-92079
INJ_506,20230106,2800,2800,0,0,27996,-25196
INJ_506,20230107,5900,5900,0,-1,58995,-53095
INJ_506,20230109,7300,7300,0,6,72995,-65695
INJ_506,20230110,4500,4500,0,1,38993,-34493
INJ_506,20230111,12400,11000,0,0,91997,-80997
INJ_506,20230112,8050,8050,0,0,75998,-67948
INJ_506,20230113,4050,3350,0,0,28992,-25642
INJ_506,20230114,6100,6100,0,-1,60987,-54887
INJ_506,20230116,9250,8450,0,0,79988,-71538
INJ_506,20230117,1400,1400,0,0,14000,-12600
INJ_506,20230118,6800,6800,0,2,55998,-49198
INJ_506,20230119,6450,6150,0,0,56986,-50836
INJ_506,20230120,7750,5600,0,1,58990,-53390
INJ_506,20230121,9050,8250,0,1,62984,-54734
INJ_506,20230123,12750,12750,0,1,110974,-98224
INJ_506,20230124,2900,2900,0,0,28997,-26097
INJ_506,20230125,6850,6150,0,0,56993,-50843
INJ_506,20230126,14450,13650,0,0,116993,-103343
INJ_506,20230127,3600,3300,0,0,32997,-29697
INJ_506,20230128,6200,5900,0,0,58987,-53087
INJ_506,20230130,4000,4000,0,0,39991,-35991
INJ_506,20230131,6000,6000,0,1,59977,-53977
INJ_506,20230201,8300,6900,0,-2,62981,-56081
INJ_506,20230202,5850,5850,0,0,47982,-42132
INJ_506,20230203,4900,4900,0,1,42992,-38092
INJ_506,20230204,7300,7300,0,1,60983,-53683
INJ_506,20230206,6300,6300,0,0,56994,-50694
INJ_506,20230207,12050,12050,0,-2,109969,-97919
INJ_506,20230208,6150,6150,0,-2,56991,-50841
INJ_506,20230209,5800,5800,0,-1,42988,-37188
INJ_506,20230210,6500,6500,0,-1,64985,-58485
INJ_506,20230211,4900,4400,0,-1,43985,-39585
INJ_506,20230213,6000,6000,0,-1,59982,-53982
INJ_506,20230214,40400,7000,0,1,69988,-62988
INJ_506,20230215,5300,5300,0,-1,46986,-41686
INJ_506,20230216,5000,5000,0,0,49990,-44990
INJ_506,20230217,5400,5400,0,-1,53991,-48591
INJ_506,20230218,5250,5250,0,1,44993,-39743
INJ_506,20230220,4400,4400,0,0,43991,-39591
INJ_506,20230221,7300,7300,0,2,66994,-59694
INJ_506,20230222,10350,10350,0,1,89992,-79642
INJ_506,20230223,8850,8850,0,0,83985,-75135
INJ_506,20230224,5150,5150,0,-1,43987,-38837
INJ_506,20230225,7500,7500,0,3,62981,-55481
INJ_506,20230227,9500,2800,0,-1,28006,-25206
INJ_506,20230228,5000,5000,0,2,49986,-44986
INJ_506,20230301,4450,4450,0,0,39989,-35539
INJ_506,20230302,9150,9150,0,4,68985,-59835
INJ_506,20230303,8200,8200,0,1,71988,-63788
INJ_506,20230304,9400,9400,0,2,81997,-72597
INJ_506,20230306,4550,4550,0,0,37989,-33439
INJ_506,20230307,7100,7100,0,-1,55984,-48884
INJ_506,20230308,4300,4300,0,2,36992,-32692
INJ_506,20230309,5550,5550,0,2,50987,-45437
INJ_506,20230310,13200,10800,0,2,101986,-91186
INJ_506,20230311,3700,3700,0,-1,36995,-33295
INJ_506,20230314,1600,1600,0,-1,15997,-14397
INJ_506,20230315,12550,12550,0,2,93976,-81426
INJ_506,20230316,19550,18750,0,2,143960,-125210
INJ_506,20230317,14850,14850,0,1,119971,-105121
INJ_506,20230318,9600,9600,0,1,71973,-62373
INJ_506,20230320,10000,10000,0,0,66970,-56970
INJ_506,20230321,6000,6000,0,0,59983,-53983
INJ_506,20230322,15400,13400,0,1,70976,-57576
INJ_506,20230323,9350,9350,0,-1,76983,-67633
INJ_506,20230324,10800,10800,0,0,86986,-76186
INJ_506,20230325,8950,8950,0,2,54978,-46028
INJ_506,20230327,13450,12750,0,0,71990,-59240
INJ_506,20230328,3300,3300,0,0,26995,-23695
INJ_506,20230329,4000,4000,0,-1,27992,-23992
INJ_506,20230330,7250,7250,0,0,52983,-45733
INJ_506,20230331,11300,11300,0,1,91964,-80664
INJ_506,20230401,6300,6300,0,0,51985,-45685
INJ_506,20230402,3750,3750,0,0,14996,-11246
INJ_506,20230403,6600,5800,0,-1,51982,-46182
INJ_506,20230404,12350,12350,0,1,100976,-88626
INJ_506,20230405,62900,5200,0,0,36991,-31791
INJ_506,20230406,8100,8100,0,2,80886,-72786
INJ_506,20230407,4800,4800,0,0,47995,-43195
INJ_506,20230408,2500,2500,0,1,12198,-9698
INJ_506,20230410,1900,1900,0,-1,18993,-17093
INJ_506,20230411,9800,7600,0,2,75989,-68389
INJ_506,20230412,2700,2700,0,1,26999,-24299
INJ_506,20230413,5450,4950,0,1,29991,-25041
INJ_506,20230414,12100,12100,0,1,87996,-75896
INJ_506,20230415,3100,3100,0,0,30989,-27889
INJ_506,20230417,12050,12050,0,-1,85973,-73923
INJ_506,20230418,2400,2400,0,0,23994,-21594
INJ_506,20230419,1750,1750,0,0,6996,-5246
INJ_506,20230420,12800,12000,0,2,80980,-68980
INJ_506,20230421,6500,6500,0,1,58979,-52479
INJ_506,20230424,3700,3700,0,1,30995,-27295
INJ_506,20230425,6350,6350,0,0,52986,-46636
INJ_506,20230426,2800,2800,0,0,27990,-25190
INJ_506,20230427,5100,5100,0,2,44991,-39891
INJ_506,20230428,9950,8950,0,1,57989,-49039
INJ_506,20230429,8200,8200,0,-1,81984,-73784
INJ_506,20230430,3750,3750,0,2,15001,-11251
INJ_506,20230501,10200,9900,0,2,86982,-77082
INJ_506,20230502,4000,3300,0,0,26996,-23696
INJ_506,20230503,5200,5200,0,1,45987,-40787
INJ_506,20230504,8100,8100,0,2,62981,-54881
INJ_506,20230505,20000,19600,0,1,123953,-104353
INJ_506,20230506,10150,10150,0,-1,87965,-77815
INJ_506,20230508,8150,8150,0,4,52981,-44831
INJ_506,20230509,9950,9550,0,0,90981,-81431
INJ_506,20230510,6300,6300,0,1,62988,-56688
INJ_506,20230511,10450,10450,0,-1,78979,-68529
INJ_506,20230512,11000,11000,0,1,55988,-44988
INJ_506,20230513,4400,4400,0,0,43987,-39587
INJ_506,20230515,7500,7500,0,1,74975,-67475
INJ_506,20230516,8150,8150,0,0,49989,-41839
INJ_506,20230517,15650,15650,0,5,103967,-88317
INJ_506,20230518,4200,4200,0,1,29995,-25795
INJ_506,20230519,7450,6850,0,0,61532,-54682
INJ_506,20230520,8300,8300,0,1,61977,-53677
INJ_506,20230522,5650,5650,0,3,33989,-28339
INJ_506,20230523,7800,7800,0,0,62983,-55183
INJ_506,20230524,4950,4650,0,0,41991,-37341
INJ_506,20230525,11100,11100,0,-1,89985,-78885
INJ_506,20230526,9750,9750,0,0,71990,-62240
INJ_506,20230527,9450,9450,0,1,74986,-65536
INJ_506,20230529,12500,9800,0,0,49999,-40199
INJ_506,20230530,10750,10750,0,1,57981,-47231
INJ_506,20230531,900,900,0,0,8995,-8095
INJ_506,20230601,3900,3900,0,1,32991,-29091
INJ_506,20230602,2400,2400,0,0,23993,-21593
INJ_506,20230603,4000,4000,0,-1,39994,-35994
INJ_506,20230605,1550,1550,0,0,10995,-9445
INJ_506,20230606,9800,9800,0,0,58996,-49196
INJ_506,20230607,8100,8100,0,-1,59994,-51894
INJ_506,20230608,6050,6050,0,0,40997,-34947
INJ_506,20230609,13950,13950,0,2,95987,-82037
INJ_506,20230610,6200,6200,0,2,43995,-37795
INJ_506,20230612,26500,10500,0,0,74987,-64487
INJ_506,20230613,8900,8900,0,0,61987,-53087
INJ_506,20230614,8900,8200,0,2,75984,-67784
INJ_506,20230615,14750,14750,0,2,91977,-77227
INJ_506,20230616,12300,11100,0,0,86989,-75889
INJ_506,20230617,14400,11650,0,2,69982,-58332
INJ_506,20230619,5450,5450,0,0,46997,-41547
INJ_506,20230620,12250,11550,0,1,71980,-60430
INJ_506,20230621,11300,11300,0,3,64990,-53690
INJ_506,20230622,10900,10900,0,0,75972,-65072
INJ_506,20230623,11750,11750,0,2,73976,-62226
INJ_506,20230624,25300,7250,0,0,21144,-13894
INJ_506,20230626,44100,8500,0,0,28313,-19813
INJ_506,20230627,30700,5700,0,0,17762,-12062
INJ_506,20230628,22200,4600,0,0,26500,-21900
INJ_506,20230630,16300,2000,0,0,12468,-10468
INJ_506,20230701,27500,3200,0,0,12899,-9699
INJ_506,20230703,39400,6200,0,0,24634,-18434
INJ_506,20230704,31200,5150,0,0,21669,-16519
INJ_506,20230705,9200,1200,0,0,9774,-8574
INJ_506,20230706,19400,3550,0,0,12027,-8477
INJ_506,20230707,1600,800,0,0,1725,-925
INJ_506,20230708,5800,1300,0,0,8932,-7632
INJ_506,20230710,3500,1400,0,0,4185,-2785
INJ_506,20230711,9800,2100,0,0,10702,-8602
INJ_506,20230712,25450,7350,0,0,16488,-9138
INJ_506,20230713,84900,9750,0,0,53256,-43506
INJ_506,20230714,107000,9000,0,0,67766,-58766
INJ_506,20230715,45100,3900,0,0,32997,-29097
INJ_506,20230717,89200,9150,0,0,55267,-46117
INJ_506,20230718,40300,6900,0,0,32605,-25705
INJ_506,20230719,10350,2350,0,0,6730,-4380
INJ_507,20210929,9500,7750,0,4,30981,-23231
INJ_507,20210930,4500,4500,0,0,17986,-13486
INJ_507,20211001,4500,4500,0,-1,17990,-13490
INJ_507,20211002,3750,3750,0,0,14989,-11239
INJ_507,20211004,3750,3750,0,0,14990,-11240
INJ_507,20211005,4250,4250,0,1,16990,-12740
INJ_507,20211006,7250,7250,0,-1,28973,-21723
INJ_507,20211007,7250,7250,0,1,28980,-21730
INJ_507,20211008,6500,6500,0,1,25988,-19488
INJ_507,20211009,3750,3750,0,1,14991,-11241
INJ_507,20211012,3250,3250,0,0,12991,-9741
INJ_507,20211015,10250,7250,0,0,28981,-21731
INJ_507,20211016,4750,4750,0,1,18989,-14239
INJ_507,20211018,6750,4250,0,1,16988,-12738
INJ_507,20211019,3250,3250,0,0,12987,-9737
INJ_507,20211021,4250,4250,0,0,16991,-12741
INJ_507,20211027,4000,4000,0,0,15988,-11988
INJ_507,20211028,7500,2500,0,0,8594,-6094
INJ_507,20211030,4500,4500,0,1,17991,-13491
INJ_507,20211101,4000,4000,0,0,15988,-11988
INJ_507,20211104,8250,8250,0,1,32981,-24731
INJ_507,20211106,4000,4000,0,0,15987,-11987
INJ_507,20211110,7750,7750,0,-1,30977,-23227
INJ_507,20211111,3500,3500,0,1,13985,-10485
INJ_507,20211112,7500,7500,0,0,29983,-22483
INJ_507,20211113,7000,4500,0,1,17986,-13486
INJ_507,20211115,3750,3750,0,-1,14989,-11239
INJ_507,20211117,7000,4500,0,1,17992,-13492
INJ_507,20211119,3750,3750,0,0,14992,-11242
INJ_507,20211122,4750,4750,0,2,18987,-14237
INJ_507,20211124,3750,3750,0,-1,14992,-11242
INJ_507,20211126,4250,4250,0,1,16986,-12736
INJ_507,20211127,7500,7500,0,0,29982,-22482
INJ_507,20211130,3500,3500,0,6,13986,-10486
INJ_507,20211201,14500,12000,0,0,47961,-35961
INJ_507,20211202,7500,7500,0,1,29981,-22481
INJ_507,20211203,7500,7500,0,0,29976,-22476
INJ_507,20211204,3750,3750,0,-1,14988,-11238
INJ_507,20211206,3750,3750,0,1,14993,-11243
INJ_507,20211207,3750,3750,0,0,14990,-11240
INJ_507,20211208,15000,11500,0,0,45974,-34474
INJ_507,20211209,7250,6250,0,0,24987,-18737
INJ_507,20211211,3750,3750,0,0,14989,-11239
INJ_507,20211214,3750,3750,0,0,14989,-11239
INJ_507,20211215,4000,4000,0,-1,15986,-11986
INJ_507,20211218,9250,9250,0,2,36983,-27733
INJ_507,20211220,12500,11500,0,-1,45967,-34467
INJ_507,20211221,13750,13750,0,3,54952,-41202
INJ_507,20211222,8750,8750,0,-1,34976,-26226
INJ_507,20211223,13000,13000,0,1,51968,-38968
INJ_507,20211224,6750,4250,0,-1,16990,-12740
INJ_507,20211225,6750,6750,0,0,26975,-20225
INJ_507,20211227,8500,7250,0,1,28981,-21731
INJ_507,20211228,7500,7500,0,0,29977,-22477
INJ_507,20211229,5750,4000,0,-1,15983,-11983
INJ_507,20211230,7000,7000,0,2,27982,-20982
INJ_507,20211231,4250,4250,0,0,16992,-12742
INJ_507,20220101,4750,4750,0,-1,18991,-14241
INJ_507,20220103,7750,7750,0,1,30975,-23225
INJ_507,20220104,5750,5750,0,1,22982,-17232
INJ_507,20220106,3750,3750,0,0,14993,-11243
INJ_507,20220107,8250,8250,0,0,32975,-24725
INJ_507,20220110,3750,3750,0,0,14986,-11236
INJ_507,20220111,8500,8500,0,1,33977,-25477
INJ_507,20220112,7750,7750,0,0,30970,-23220
INJ_507,20220114,15500,15500,0,2,61955,-46455
INJ_507,20220115,7750,7750,0,0,30980,-23230
INJ_507,20220118,12000,12000,0,3,47969,-35969
INJ_507,20220120,7750,7750,0,1,30977,-23227
INJ_507,20220121,4000,4000,0,1,15988,-11988
INJ_507,20220122,3000,3000,0,0,11992,-8992
INJ_507,20220124,4250,4250,0,0,16990,-12740
INJ_507,20220126,4750,4750,0,0,18989,-14239
INJ_507,20220127,3750,3750,0,0,14989,-11239
INJ_507,20220128,8750,8750,0,0,34975,-26225
INJ_507,20220129,4000,4000,0,0,15986,-11986
INJ_507,20220131,7000,7000,0,0,27984,-20984
INJ_507,20220201,3250,3250,0,0,12990,-9740
INJ_507,20220202,3750,3750,0,0,14985,-11235
INJ_507,20220203,20000,16500,0,2,65951,-49451
INJ_507,20220204,8750,7000,0,1,27982,-20982
INJ_507,20220205,4250,4250,0,-1,16986,-12736
INJ_507,20220208,13000,11500,0,3,45978,-34478
INJ_507,20220209,8000,8000,0,0,31982,-23982
INJ_507,20220210,4000,4000,0,0,15987,-11987
INJ_507,20220212,7750,7750,0,0,30979,-23229
INJ_507,20220214,8250,8250,0,0,32986,-24736
INJ_507,20220215,3000,3000,0,1,11993,-8993
INJ_507,20220216,16500,15000,0,1,59959,-44959
INJ_507,20220218,9000,9000,0,0,35972,-26972
INJ_507,20220222,12000,12000,0,0,47972,-35972
INJ_507,20220223,8250,8250,0,1,32977,-24727
INJ_507,20220225,3750,3750,0,-1,14991,-11241
INJ_507,20220226,4000,4000,0,0,15988,-11988
INJ_507,20220228,4000,4000,0,0,15987,-11987
INJ_507,20220301,4250,4250,0,0,16986,-12736
INJ_507,20220302,5750,3250,0,0,12993,-9743
INJ_507,20220303,4000,4000,0,0,15993,-11993
INJ_507,20220304,12750,12750,0,3,50964,-38214
INJ_507,20220305,2750,2750,0,1,10992,-8242
INJ_507,20220307,4500,4500,0,0,17988,-13488
INJ_507,20220308,4000,4000,0,1,15985,-11985
INJ_507,20220309,3750,3750,0,0,14988,-11238
INJ_507,20220310,3500,3500,0,0,13987,-10487
INJ_507,20220311,3750,3750,0,0,14991,-11241
INJ_507,20220312,9250,4250,0,1,16987,-12737
INJ_507,20220314,3750,3750,0,0,14983,-11233
INJ_507,20220315,11500,11500,0,1,45966,-34466
INJ_507,20220316,3250,3250,0,0,12991,-9741
INJ_507,20220317,2500,2500,0,2,9989,-7489
INJ_507,20220318,7000,7000,0,-1,27983,-20983
INJ_507,20220319,6500,6500,0,2,25983,-19483
INJ_507,20220321,11000,11000,0,0,43968,-32968
INJ_507,20220322,4000,4000,0,0,15988,-11988
INJ_507,20220323,4000,4000,0,-1,15989,-11989
INJ_507,20220324,3500,3500,0,0,13988,-10488
INJ_507,20220325,4500,4500,0,0,17991,-13491
INJ_507,20220326,7500,7500,0,2,29979,-22479
INJ_507,20220328,4000,4000,0,-1,15991,-11991
INJ_507,20220329,13000,13000,0,2,51963,-38963
INJ_507,20220330,11750,11750,0,0,46964,-35214
INJ_507,20220331,4000,4000,0,0,15987,-11987
INJ_507,20220401,4000,4000,0,-1,15989,-11989
INJ_507,20220402,9750,8000,0,3,31974,-23974
INJ_507,20220404,8250,8250,0,1,32978,-24728
INJ_507,20220405,15750,15750,0,4,62954,-47204
INJ_507,20220408,3250,3250,0,0,12990,-9740
INJ_507,20220409,7750,7750,0,3,30974,-23224
INJ_507,20220411,4000,4000,0,0,15985,-11985
INJ_507,20220412,3000,3000,0,1,11988,-8988
INJ_507,20220415,4000,4000,0,0,15985,-11985
INJ_507,20220416,10750,10750,0,0,42975,-32225
INJ_507,20220418,3250,3250,0,0,12990,-9740
INJ_507,20220420,2500,2500,0,1,9991,-7491
INJ_507,20220421,18750,18750,0,-1,74938,-56188
INJ_507,20220422,3750,3750,0,1,14991,-11241
INJ_507,20220423,16250,3750,0,-1,14990,-11240
INJ_507,20220424,3250,3250,0,1,12986,-9736
INJ_507,20220425,8000,8000,0,-1,31971,-23971
INJ_507,20220426,3750,3750,0,0,14987,-11237
INJ_507,20220427,8000,8000,0,1,31982,-23982
INJ_507,20220428,8250,8250,0,0,32982,-24732
INJ_507,20220429,11250,11250,0,2,44968,-33718
INJ_507,20220503,3500,3500,0,-1,13990,-10490
INJ_507,20220504,10250,10250,0,0,40976,-30726
INJ_507,20220505,8000,8000,0,0,31973,-23973
INJ_507,20220506,4250,4250,0,0,16991,-12741
INJ_507,20220507,3750,3750,0,1,14988,-11238
INJ_507,20220509,7500,7500,0,0,29976,-22476
INJ_507,20220510,5750,5750,0,0,22985,-17235
INJ_507,20220511,9750,9750,0,1,38970,-29220
INJ_507,20220512,9250,7500,0,2,29977,-22477
INJ_507,20220514,11250,3750,0,0,14996,-11246
INJ_507,20220516,12250,12250,0,0,48960,-36710
INJ_507,20220517,6500,6500,0,0,25973,-19473
INJ_507,20220518,6500,6500,0,-1,25981,-19481
INJ_507,20220519,3750,3750,0,0,14992,-11242
INJ_507,20220520,7000,7000,0,0,27980,-20980
INJ_507,20220521,7750,7750,0,1,30977,-23227
INJ_507,20220523,11500,11500,0,0,45962,-34462
INJ_507,20220524,15000,15000,0,1,59954,-44954
INJ_507,20220525,4500,4500,0,0,17991,-13491
INJ_507,20220526,4250,4250,0,0,16984,-12734
INJ_507,20220527,8500,8500,0,1,33973,-25473
INJ_507,20220528,3750,3750,0,-1,14990,-11240
INJ_507,20220530,3500,3500,0,-1,13990,-10490
INJ_507,20220531,7250,7250,0,0,28976,-21726
INJ_507,20220602,3500,3500,0,1,13984,-10484
INJ_507,20220603,11500,11500,0,-1,45959,-34459
INJ_507,20220604,8750,6250,0,-1,24982,-18732
INJ_507,20220606,2500,2500,0,0,9989,-7489
INJ_507,20220607,4000,4000,0,0,15989,-11989
INJ_507,20220608,3750,3750,0,-1,14991,-11241
INJ_507,20220609,10000,8250,0,1,32972,-24722
INJ_507,20220610,7500,7500,0,0,29975,-22475
INJ_507,20220611,3250,3250,0,0,12994,-9744
INJ_507,20220614,5000,5000,0,0,19989,-14989
INJ_507,20220615,7000,7000,0,0,27971,-20971
INJ_507,20220616,2750,2750,0,1,10990,-8240
INJ_507,20220620,7500,6000,0,0,23977,-17977
INJ_507,20220621,11750,10250,0,-1,40964,-30714
INJ_507,20220622,9750,8500,0,3,33974,-25474
INJ_507,20220623,7750,7750,0,1,30976,-23226
INJ_507,20220624,7500,7500,0,0,29984,-22484
INJ_507,20220625,3250,3250,0,0,12991,-9741
INJ_507,20220627,4000,4000,0,0,15920,-11920
INJ_507,20220702,8000,8000,0,2,31979,-23979
INJ_507,20220704,6750,6750,0,0,26987,-20237
INJ_507,20220705,7500,6500,0,1,25970,-19470
INJ_507,20220706,3250,3250,0,1,12989,-9739
INJ_507,20220707,8000,6250,0,1,24979,-18729
INJ_507,20220708,12750,12750,0,0,50972,-38222
INJ_507,20220709,3750,3750,0,0,14992,-11242
INJ_507,20220712,9250,9250,0,-2,36979,-27729
INJ_507,20220713,3750,3750,0,0,14993,-11243
INJ_507,20220715,7000,4000,0,-1,15988,-11988
INJ_507,20220718,6500,6500,0,1,25990,-19490
INJ_507,20220719,11500,11500,0,0,45974,-34474
INJ_507,20220720,3250,3250,0,0,12992,-9742
INJ_507,20220722,15500,11750,0,0,46966,-35216
INJ_507,20220723,3250,3250,0,-1,12989,-9739
INJ_507,20220725,4000,4000,0,1,15985,-11985
INJ_507,20220726,5000,5000,0,1,19978,-14978
INJ_507,20220727,7750,7750,0,-1,30986,-23236
INJ_507,20220728,4250,4250,0,1,16991,-12741
INJ_507,20220729,4000,4000,0,0,15988,-11988
INJ_507,20220730,5750,4000,0,-1,15987,-11987
INJ_507,20220801,13000,11250,0,2,44965,-33715
INJ_507,20220802,4500,4500,0,-1,17986,-13486
INJ_507,20220803,7250,7250,0,1,28970,-21720
INJ_507,20220804,7750,7750,0,1,30968,-23218
INJ_507,20220805,4000,4000,0,1,15986,-11986
INJ_507,20220806,3250,3250,0,1,12991,-9741
INJ_507,20220808,3250,3250,0,3,12989,-9739
INJ_507,20220809,19250,11750,0,-1,46967,-35217
INJ_507,20220810,10500,10500,0,1,41965,-31465
INJ_507,20220811,5750,5750,0,0,22983,-17233
INJ_507,20220813,3750,3750,0,0,14988,-11238
INJ_507,20220815,3250,3250,0,0,12994,-9744
INJ_507,20220816,4000,4000,0,1,15989,-11989
INJ_507,20220817,2250,2250,0,0,8992,-6742
INJ_507,20220818,7000,7000,0,0,27983,-20983
INJ_507,20220819,12500,11750,0,0,46965,-35215
INJ_507,20220820,8750,8750,0,0,34971,-26221
INJ_507,20220822,11000,11000,0,-1,43960,-32960
INJ_507,20220823,4000,4000,0,0,15991,-11991
INJ_507,20220824,4000,4000,0,0,15984,-11984
INJ_507,20220825,15250,13750,0,-2,54951,-41201
INJ_507,20220826,3250,3250,0,0,12992,-9742
INJ_507,20220830,10250,10250,0,1,40961,-30711
INJ_507,20220831,7750,7750,0,0,30979,-23229
INJ_507,20220902,4000,4000,0,2,15987,-11987
INJ_507,20220903,11500,11500,0,2,45966,-34466
INJ_507,20220905,14500,14500,0,0,57949,-43449
INJ_507,20220907,8000,8000,0,1,31971,-23971
INJ_507,20220908,9750,9750,0,1,38975,-29225
INJ_507,20220909,3750,3750,0,0,14988,-11238
INJ_507,20220910,7750,7750,0,1,30976,-23226
INJ_507,20220912,4000,4000,0,2,15987,-11987
INJ_507,20220913,7750,7750,0,-1,30979,-23229
INJ_507,20220914,2750,2750,0,0,10995,-8245
INJ_507,20220915,3250,3250,0,-1,12989,-9739
INJ_507,20220917,13750,11000,0,0,43965,-32965
INJ_507,20220918,3000,3000,0,0,11990,-8990
INJ_507,20220919,7250,7250,0,-1,28978,-21728
INJ_507,20220920,13250,13250,0,0,52958,-39708
INJ_507,20220921,7250,7250,0,-1,28981,-21731
INJ_507,20220922,7000,7000,0,0,27982,-20982
INJ_507,20220924,3750,3750,0,0,14990,-11240
INJ_507,20220926,9000,7750,0,1,30977,-23227
INJ_507,20220927,7250,7250,0,0,28978,-21728
INJ_507,20220929,3250,3250,0,0,12991,-9741
INJ_507,20220930,3250,3250,0,0,12989,-9739
INJ_507,20221001,3750,3750,17,511,14995,-11245
INJ_507,20221004,11500,6500,0,2,25987,-19487
INJ_507,20221005,3250,3250,3,765,12987,-9737
INJ_507,20221006,10000,10000,0,-1,39963,-29963
INJ_507,20221008,8500,8500,0,1,33975,-25475
INJ_507,20221010,4250,4250,0,0,16991,-12741
INJ_507,20221012,7000,7000,0,2,27979,-20979
INJ_507,20221013,3750,3750,0,0,14988,-11238
INJ_507,20221014,13250,13250,0,1,52960,-39710
INJ_507,20221015,4000,4000,0,-1,15987,-11987
INJ_507,20221019,4000,4000,0,-1,15987,-11987
INJ_507,20221021,7500,7500,0,-1,29979,-22479
INJ_507,20221022,2750,2750,0,2,10992,-8242
INJ_507,20221024,8750,7500,0,-1,29956,-22456
INJ_507,20221025,3750,3750,0,0,14992,-11242
INJ_507,20221026,5750,5750,0,-1,22986,-17236
INJ_507,20221027,4500,4500,0,0,17991,-13491
INJ_507,20221028,8000,8000,0,0,31977,-23977
INJ_507,20221029,7750,7750,0,-1,30980,-23230
INJ_507,20221031,12500,11750,0,2,46966,-35216
INJ_507,20221101,3250,3250,0,0,12992,-9742
INJ_507,20221102,3000,3000,0,-1,11993,-8993
INJ_507,20221103,7500,7500,0,1,29977,-22477
INJ_507,20221105,3750,3750,0,1,14990,-11240
INJ_507,20221107,7750,7750,0,-1,30974,-23224
INJ_507,20221108,6250,6250,0,1,24981,-18731
INJ_507,20221109,8000,8000,0,1,31976,-23976
INJ_507,20221110,4000,4000,0,0,15985,-11985
INJ_507,20221111,6500,6500,0,0,25985,-19485
INJ_507,20221112,3250,3250,0,0,12991,-9741
INJ_507,20221114,3750,3750,0,-1,14990,-11240
INJ_507,20221115,4500,4500,0,-1,17984,-13484
INJ_507,20221116,10500,10500,0,1,41974,-31474
INJ_507,20221117,7000,7000,0,0,27976,-20976
INJ_507,20221118,7000,7000,0,0,27986,-20986
INJ_507,20221119,4250,4250,0,0,16986,-12736
INJ_507,20221121,14500,14500,0,-1,57959,-43459
INJ_507,20221122,2500,2500,0,-1,9994,-7494
INJ_507,20221124,23500,23500,0,4,93931,-70431
INJ_507,20221125,3500,3500,0,0,13989,-10489
INJ_507,20221126,3250,3250,0,0,12985,-9735
INJ_507,20221128,3250,3250,0,0,12992,-9742
INJ_507,20221129,12500,12500,0,1,49964,-37464
INJ_507,20221130,8000,8000,0,0,31981,-23981
INJ_507,20221201,3000,3000,0,0,11992,-8992
INJ_507,20221202,3750,3750,0,2,14990,-11240
INJ_507,20221203,14750,14750,0,1,58958,-44208
INJ_507,20221205,12750,10250,0,2,40904,-30654
INJ_507,20221206,3750,3750,0,0,14991,-11241
INJ_507,20221207,6500,6500,0,0,25977,-19477
INJ_507,20221209,3750,3750,0,1,14993,-11243
INJ_507,20221210,3750,3750,0,0,14993,-11243
INJ_507,20221212,3250,3250,0,1,12992,-9742
INJ_507,20221213,6250,6250,0,0,24979,-18729
INJ_507,20221215,4000,4000,0,0,15988,-11988
INJ_507,20221216,8750,8750,0,0,34971,-26221
INJ_507,20221217,9250,9250,0,1,36981,-27731
INJ_507,20221219,3750,3750,0,0,14994,-11244
INJ_507,20221220,9250,9250,0,2,36971,-27721
INJ_507,20221221,6250,6250,0,0,24978,-18728
INJ_507,20221222,4000,4000,0,1,15986,-11986
INJ_507,20221223,7750,7750,0,1,30980,-23230
INJ_507,20221224,3250,3250,0,0,12991,-9741
INJ_507,20221227,4750,4750,1,265,18985,-14235
INJ_507,20221228,4500,4500,0,0,17984,-13484
INJ_507,20221229,9500,9500,0,1,37976,-28476
INJ_507,20221230,4000,4000,0,-1,13602,-9602
INJ_507,20221231,3500,3500,0,0,13986,-10486
INJ_507,20230103,7250,7250,0,0,28974,-21724
INJ_507,20230104,8750,8750,0,0,34979,-26229
INJ_507,20230105,8000,8000,0,0,31974,-23974
INJ_507,20230109,3250,3250,0,-1,12992,-9742
INJ_507,20230112,3750,3750,0,1,14991,-11241
INJ_507,20230118,3250,3250,0,-1,12991,-9741
INJ_507,20230120,5250,4250,0,0,16987,-12737
INJ_507,20230121,2500,2500,0,0,9996,-7496
INJ_507,20230301,54500,5750,0,1,17720,-11970
INJ_507,20230307,47000,4000,0,0,15985,-11985
INJ_508,20210929,1200,1200,0,0,7994,-6794
INJ_508,20210930,600,600,0,0,3997,-3397
INJ_508,20211002,600,600,0,25,3994,-3394
INJ_508,20211004,600,600,0,0,3998,-3398
INJ_508,20211006,1350,1350,0,-1,8994,-7644
INJ_508,20211007,1200,1200,0,15,7993,-6793
INJ_508,20211008,1800,1800,0,0,11990,-10190
INJ_508,20211015,1200,1200,0,0,7989,-6789
INJ_508,20211018,1500,750,0,-1,4994,-4244
INJ_508,20211019,750,750,0,0,4994,-4244
INJ_508,20211021,450,450,0,0,2994,-2544
INJ_508,20211027,600,600,0,0,3994,-3394
INJ_508,20211104,450,450,0,0,2993,-2543
INJ_508,20211106,600,600,0,0,3997,-3397
INJ_508,20211110,1050,1050,0,0,6993,-5943
INJ_508,20211111,900,900,0,1,5998,-5098
INJ_508,20211112,1200,1200,0,-1,7987,-6787
INJ_508,20211115,1200,1200,0,17,7998,-6798
INJ_508,20211117,1200,600,0,-1,3997,-3397
INJ_508,20211119,600,600,0,0,3998,-3398
INJ_508,20211122,450,450,0,0,2997,-2547
INJ_508,20211126,450,450,0,0,2995,-2545
INJ_508,20211127,1350,1350,0,1,8991,-7641
INJ_508,20211130,750,750,0,-1,4998,-4248
INJ_508,20211201,1500,1500,0,0,9991,-8491
INJ_508,20211206,750,750,0,-1,4992,-4242
INJ_508,20211207,450,450,0,0,2996,-2546
INJ_508,20211208,2250,1800,0,0,11984,-10184
INJ_508,20211209,3300,1800,0,-1,11985,-10185
INJ_508,20211214,600,600,0,0,3996,-3396
INJ_508,20211218,900,900,0,0,5995,-5095
INJ_508,20211220,2100,2100,0,-1,13989,-11889
INJ_508,20211221,1950,1950,0,0,12989,-11039
INJ_508,20211222,750,750,0,-1,4995,-4245
INJ_508,20211223,1650,1650,0,29,10991,-9341
INJ_508,20211224,750,750,0,0,4996,-4246
INJ_508,20211225,1800,1800,0,0,11990,-10190
INJ_508,20211227,1350,1350,0,0,8989,-7639
INJ_508,20211228,600,600,0,0,3995,-3395
INJ_508,20211229,2250,1650,0,1,10993,-9343
INJ_508,20211230,900,900,0,0,5990,-5090
INJ_508,20211231,450,450,0,0,2996,-2546
INJ_508,20220101,450,450,0,0,2995,-2545
INJ_508,20220103,750,750,0,1,4993,-4243
INJ_508,20220104,2100,2100,0,-1,13988,-11888
INJ_508,20220106,900,900,0,1,5991,-5091
INJ_508,20220107,1050,1050,0,0,6995,-5945
INJ_508,20220111,1050,1050,0,1,6993,-5943
INJ_508,20220112,600,600,0,0,3996,-3396
INJ_508,20220114,2400,2400,0,0,15988,-13588
INJ_508,20220115,1350,1350,0,1,8995,-7645
INJ_508,20220118,900,900,0,0,5993,-5093
INJ_508,20220120,1650,1650,0,3,10992,-9342
INJ_508,20220121,600,600,0,-1,3996,-3396
INJ_508,20220122,1200,1200,0,1,7992,-6792
INJ_508,20220126,450,450,0,0,2996,-2546
INJ_508,20220127,600,600,0,0,3997,-3397
INJ_508,20220131,1050,1050,0,0,6991,-5941
INJ_508,20220201,450,450,0,0,2996,-2546
INJ_508,20220202,600,600,0,0,3996,-3396
INJ_508,20220203,1800,1800,0,0,11990,-10190
INJ_508,20220204,1350,1350,0,6,8993,-7643
INJ_508,20220208,2550,2550,0,-1,16985,-14435
INJ_508,20220209,450,450,0,-1,2995,-2545
INJ_508,20220210,450,450,0,0,2996,-2546
INJ_508,20220212,1350,1350,0,0,8990,-7640
INJ_508,20220214,450,450,0,16,2996,-2546
INJ_508,20220215,1500,1500,0,0,9994,-8494
INJ_508,20220216,3900,2850,0,-1,18985,-16135
INJ_508,20220218,1950,1950,0,19,12989,-11039
INJ_508,20220222,1950,1950,0,0,12985,-11035
INJ_508,20220223,1050,1050,0,0,6993,-5943
INJ_508,20220225,600,600,0,0,3996,-3396
INJ_508,20220228,900,900,0,11,5995,-5095
INJ_508,20220301,450,450,0,4,2996,-2546
INJ_508,20220302,1065,1065,0,-1,7003,-5938
INJ_508,20220303,900,900,0,23,5997,-5097
INJ_508,20220304,900,900,0,1,5990,-5090
INJ_508,20220305,1350,1350,0,1,8990,-7640
INJ_508,20220307,600,600,0,-1,3997,-3397
INJ_508,20220308,450,450,0,0,2996,-2546
INJ_508,20220309,600,600,0,22,3997,-3397
INJ_508,20220310,600,600,0,0,3997,-3397
INJ_508,20220311,600,600,0,0,3994,-3394
INJ_508,20220312,1350,450,0,-1,2996,-2546
INJ_508,20220314,600,600,0,22,3995,-3395
INJ_508,20220315,2100,2100,0,-1,13982,-11882
INJ_508,20220316,1050,1050,0,21,6990,-5940
INJ_508,20220317,1200,1200,0,0,7987,-6787
INJ_508,20220318,1350,1350,0,0,8992,-7642
INJ_508,20220319,1950,1950,0,-1,12987,-11037
INJ_508,20220321,2850,2250,0,0,14984,-12734
INJ_508,20220323,450,450,0,-1,2996,-2546
INJ_508,20220324,600,600,0,0,3995,-3395
INJ_508,20220326,1500,1500,0,0,9994,-8494
INJ_508,20220328,600,600,0,0,3997,-3397
INJ_508,20220329,900,900,0,0,5989,-5089
INJ_508,20220330,1050,1050,0,0,6994,-5944
INJ_508,20220402,450,450,0,0,2997,-2547
INJ_508,20220405,2100,2100,0,1,13990,-11890
INJ_508,20220408,750,750,0,0,4996,-4246
INJ_508,20220409,1050,1050,0,14,6995,-5945
INJ_508,20220411,600,600,0,1,3996,-3396
INJ_508,20220412,900,900,0,0,5997,-5097
INJ_508,20220416,2100,2100,0,0,13985,-11885
INJ_508,20220418,750,750,0,0,4997,-4247
INJ_508,20220420,1200,1200,0,0,7992,-6792
INJ_508,20220421,3150,3150,0,0,20976,-17826
INJ_508,20220423,750,750,0,0,4998,-4248
INJ_508,20220425,450,450,0,0,2996,-2546
INJ_508,20220426,600,600,0,0,3996,-3396
INJ_508,20220427,1350,1350,0,23,8994,-7644
INJ_508,20220428,1050,1050,0,15,6993,-5943
INJ_508,20220429,1800,1800,0,0,11987,-10187
INJ_508,20220503,750,750,0,0,4998,-4248
INJ_508,20220504,1500,1500,0,0,9989,-8489
INJ_508,20220505,1350,1350,0,0,8992,-7642
INJ_508,20220506,450,450,0,0,2997,-2547
INJ_508,20220507,600,600,0,-1,3996,-3396
INJ_508,20220509,1050,1050,0,1,6991,-5941
INJ_508,20220510,1500,1500,0,0,9989,-8489
INJ_508,20220511,1650,1650,0,1,10988,-9338
INJ_508,20220512,1650,1050,0,0,6993,-5943
INJ_508,20220514,450,450,0,0,2997,-2547
INJ_508,20220516,1050,1050,0,4,6993,-5943
INJ_508,20220517,2700,2700,0,32,17985,-15285
INJ_508,20220518,900,900,0,1,5993,-5093
INJ_508,20220519,450,450,0,-1,2995,-2545
INJ_508,20220520,1050,1050,0,1,6993,-5943
INJ_508,20220521,1050,1050,0,23,6993,-5943
INJ_508,20220523,1500,1500,0,0,9989,-8489
INJ_508,20220524,2100,2100,0,0,13989,-11889
INJ_508,20220526,450,450,0,0,2995,-2545
INJ_508,20220527,450,450,0,0,2995,-2545
INJ_508,20220530,600,600,0,1,3996,-3396
INJ_508,20220531,600,600,0,0,3993,-3393
INJ_508,20220602,750,750,0,0,4995,-4245
INJ_508,20220603,2250,2250,0,1,14991,-12741
INJ_508,20220604,1500,1500,0,0,9992,-8492
INJ_508,20220606,1500,1500,0,0,9991,-8491
INJ_508,20220607,600,600,0,0,3994,-3394
INJ_508,20220608,750,750,0,0,4991,-4241
INJ_508,20220609,450,450,0,11,2997,-2547
INJ_508,20220610,600,600,0,8,3997,-3397
INJ_508,20220611,450,450,0,0,2997,-2547
INJ_508,20220614,2100,2100,0,-1,13988,-11888
INJ_508,20220615,1200,1200,0,0,7993,-6793
INJ_508,20220616,600,600,0,0,3998,-3398
INJ_508,20220620,2400,1800,0,-1,11986,-10186
INJ_508,20220621,2700,1950,0,0,12988,-11038
INJ_508,20220622,450,450,0,0,2997,-2547
INJ_508,20220623,900,900,0,0,5994,-5094
INJ_508,20220624,1650,1650,0,-1,10986,-9336
INJ_508,20220625,450,450,0,0,2995,-2545
INJ_508,20220627,600,600,0,1,3998,-3398
INJ_508,20220702,900,900,0,-1,5992,-5092
INJ_508,20220704,2250,2250,0,0,14986,-12736
INJ_508,20220705,600,600,0,0,3996,-3396
INJ_508,20220706,450,450,0,1,2998,-2548
INJ_508,20220707,1200,1200,0,0,7796,-6596
INJ_508,20220708,4350,4350,0,-1,28977,-24627
INJ_508,20220709,750,750,0,0,4995,-4245
INJ_508,20220712,3150,3150,0,0,20979,-17829
INJ_508,20220713,450,450,0,-1,2997,-2547
INJ_508,20220715,600,600,0,0,3995,-3395
INJ_508,20220718,1800,1800,0,1,11993,-10193
INJ_508,20220719,600,600,0,0,3995,-3395
INJ_508,20220720,1500,1500,0,0,9993,-8493
INJ_508,20220722,1500,1500,0,-1,9993,-8493
INJ_508,20220723,1200,1200,0,0,7998,-6798
INJ_508,20220725,600,600,0,1,3996,-3396
INJ_508,20220726,3600,3600,0,0,23988,-20388
INJ_508,20220727,750,750,0,0,4997,-4247
INJ_508,20220806,750,750,0,17,4994,-4244
INJ_508,20220810,1950,1950,0,-1,12985,-11035
INJ_508,20220811,2100,2100,0,0,13987,-11887
INJ_508,20220813,450,450,0,0,2995,-2545
INJ_508,20220815,450,450,0,0,2996,-2546
INJ_508,20220816,600,600,0,0,3998,-3398
INJ_508,20220817,1350,1350,0,1,8991,-7641
INJ_508,20220818,1500,1500,0,0,9986,-8486
INJ_508,20220819,4650,3450,0,1,22985,-19535
INJ_508,20220822,1800,1800,0,-1,11997,-10197
INJ_508,20220823,600,600,0,0,3997,-3397
INJ_508,20220825,2700,2100,0,1,13986,-11886
INJ_508,20220826,1050,1050,0,-1,6990,-5940
INJ_508,20220830,2250,2250,0,1,14981,-12731
INJ_508,20220831,600,600,0,0,3997,-3397
INJ_508,20220902,450,450,0,0,2996,-2546
INJ_508,20220903,1200,1200,0,0,7989,-6789
INJ_508,20220905,1800,1800,0,-1,11987,-10187
INJ_508,20220907,600,600,0,0,3995,-3395
INJ_508,20220908,2250,2250,0,0,14981,-12731
INJ_508,20220909,600,600,0,0,3995,-3395
INJ_508,20220910,1050,1050,0,1,6992,-5942
INJ_508,20220912,450,450,0,0,2996,-2546
INJ_508,20220913,1200,1200,0,0,7990,-6790
INJ_508,20220914,750,750,0,20,4996,-4246
INJ_508,20220915,450,450,0,0,2997,-2547
INJ_508,20220917,6450,1050,0,-1,6993,-5943
INJ_508,20220918,15450,1650,0,2,10992,-9342
INJ_508,20220919,2850,1050,0,0,6991,-5941
INJ_508,20220920,12000,2550,0,0,10600,-8050
INJ_508,20220921,2250,450,0,-1,2996,-2546
INJ_508,20220922,5850,1050,0,-1,6990,-5940
INJ_508,20220924,4200,600,0,0,3994,-3394
INJ_508,20220926,4200,600,0,0,3997,-3397
INJ_508,20220927,21450,2700,0,-1,17988,-15288
INJ_508,20220929,2250,450,0,0,2998,-2548
INJ_508,20220930,2250,450,0,0,2995,-2545
INJ_508,20221001,6750,750,0,2,4995,-4245
INJ_508,20221004,2250,450,0,16,2996,-2546
INJ_508,20221006,4200,600,0,1,3995,-3395
INJ_508,20221008,2250,450,0,0,2998,-2548
INJ_508,20221010,2250,450,0,0,2998,-2548
INJ_508,20221012,2250,450,0,1,2997,-2547
INJ_508,20221013,4200,600,0,42,3995,-3395
INJ_508,20221014,15750,1650,0,9,10988,-9338
INJ_508,20221021,2250,450,0,2,2996,-2546
INJ_508,20221022,2250,450,0,0,2995,-2545
INJ_508,20221024,10200,1350,0,24,8990,-7640
INJ_508,20221025,2250,450,0,1,2996,-2546
INJ_508,20221026,12000,1500,0,0,9993,-8493
INJ_508,20221027,4200,600,0,0,3996,-3396
INJ_508,20221029,4200,600,0,0,3997,-3397
INJ_508,20221102,3750,1200,0,-1,7992,-6792
INJ_508,20221103,4200,600,0,0,3998,-3398
INJ_508,20221107,10200,1350,0,-1,8994,-7644
INJ_508,20221108,15600,1200,0,1,7998,-6798
INJ_508,20221109,10200,1350,0,2,8994,-7644
INJ_508,20221112,2250,450,0,0,2996,-2546
INJ_508,20221115,4200,600,0,0,3994,-3394
INJ_508,20221116,11700,1800,0,0,11987,-10187
INJ_508,20221117,3000,1500,0,-1,2203,-703
INJ_508,20221118,9000,900,0,24,5994,-5094
INJ_508,20221121,4500,900,0,1,5994,-5094
INJ_508,20221129,2250,450,0,0,2996,-2546
INJ_508,20221130,17850,1650,0,0,10991,-9341
INJ_508,20221201,2250,450,0,4,2997,-2547
INJ_508,20221202,2250,450,0,5,2996,-2546
INJ_508,20221203,17400,2400,0,2,15982,-13582
INJ_508,20221205,22800,2400,0,4,15989,-13589
INJ_508,20221207,6750,750,0,0,4996,-4246
INJ_508,20221212,4200,600,0,6,3997,-3397
INJ_508,20221213,18000,1800,0,13,11993,-10193
INJ_508,20221215,1200,600,0,0,3998,-3398
INJ_508,20221216,25050,2850,0,5,18984,-16134
INJ_508,20221217,9750,1950,0,2,12992,-11042
INJ_508,20221219,4200,600,0,0,3995,-3395
INJ_508,20221220,9000,1200,0,2,7993,-6793
INJ_508,20221223,4200,600,0,15,3996,-3396
INJ_508,20221224,2265,465,0,1,3052,-2587
INJ_508,20221229,15450,1950,0,1,12988,-11038
INJ_508,20221230,2250,450,0,0,2995,-2545
INJ_508,20230103,2700,450,0,1,2997,-2547
INJ_508,20230105,4200,600,0,34,3997,-3397
INJ_508,20230109,2250,450,0,0,2996,-2546
INJ_508,20230112,4200,600,0,0,3997,-3397
INJ_508,20230113,4200,600,0,0,3996,-3396
INJ_508,20230118,2250,450,0,0,2995,-2545
INJ_508,20230120,2250,450,0,-1,2997,-2547
INJ_508,20230121,6750,750,0,1,4994,-4244
INJ_508,20230301,1950,1950,2,698,12986,-11036
INJ_508,20230303,600,600,5,396,3997,-3397
INJ_508,20230307,2100,2100,2,688,13985,-11885
INJ_508,20230308,750,750,6,601,4994,-4244
INJ_508,20230309,1350,1350,4,499,8991,-7641
INJ_508,20230310,1200,1200,8,392,7989,-6789
INJ_508,20230315,450,450,6,578,2997,-2547
INJ_508,20230316,1200,1200,6,904,7993,-6793
INJ_508,20230317,450,450,6,902,2995,-2545
INJ_508,20230318,900,900,3,605,5992,-5092
INJ_508,20230320,600,600,2,101,3996,-3396
INJ_508,20230322,1650,1650,0,0,10989,-9339
INJ_508,20230323,1500,1500,5,93,9990,-8490
INJ_508,20230324,600,600,9,302,3997,-3397
INJ_508,20230327,450,450,3,899,2997,-2547
INJ_508,20230330,900,900,5,98,5992,-5092
INJ_508,20230331,600,600,2,382,3995,-3395
INJ_508,20230401,750,750,4,507,4997,-4247
INJ_508,20230402,450,450,0,0,2996,-2546
INJ_508,20230404,750,750,7,497,4996,-4246
INJ_508,20230413,750,750,0,0,4996,-4246
INJ_508,20230414,600,600,2,400,3996,-3396
INJ_508,20230417,750,750,8,91,4997,-4247
INJ_508,20230419,750,750,0,1,4996,-4246
INJ_508,20230420,750,750,6,12,4997,-4247
INJ_508,20230428,600,600,2,401,3997,-3397
INJ_508,20230430,750,750,0,0,4995,-4245
INJ_508,20230504,900,900,1,499,5994,-5094
INJ_508,20230505,3450,3450,5,398,22989,-19539
INJ_508,20230508,750,750,2,401,4998,-4248
INJ_508,20230512,1050,1050,2,401,6991,-5941
INJ_508,20230517,600,600,1,800,3995,-3395
INJ_508,20230520,450,450,1,200,2995,-2545
INJ_508,20230522,750,750,0,0,4997,-4247
INJ_508,20230523,1200,1200,0,0,7998,-6798
INJ_508,20230525,600,600,3,597,3995,-3395
INJ_508,20230529,1650,1650,3,317,10990,-9340
INJ_508,20230530,1200,1200,1,500,7994,-6794
INJ_508,20230606,900,900,0,0,5996,-5096
INJ_508,20230607,600,600,0,1,3995,-3395
INJ_508,20230608,450,450,2,386,2998,-2548
INJ_508,20230609,3150,3150,4,201,20990,-17840
INJ_508,20230610,750,750,0,-1,4998,-4248
INJ_508,20230612,1500,1500,3,2,9994,-8494
INJ_508,20230613,450,450,0,0,2994,-2544
INJ_508,20230615,450,450,2,701,2997,-2547
INJ_508,20230616,450,450,5,95,2995,-2545
INJ_508,20230617,1650,1650,3,4,10989,-9339
INJ_508,20230620,1200,1200,0,-1,7992,-6792
INJ_508,20230621,1050,1050,6,570,6992,-5942
INJ_508,20230622,1200,1200,5,397,7989,-6789
INJ_508,20230623,1050,1050,2,99,6994,-5944
INJ_508,20230624,450,450,4,503,2999,-2549
INJ_508,20230626,1500,1500,7,793,9988,-8488
INJ_508,20230627,1050,1050,4,199,6993,-5943
INJ_508,20230701,750,750,2,403,4996,-4246
INJ_508,20230703,750,750,2,398,4996,-4246
INJ_508,20230712,1050,1050,2,700,6989,-5939
INJ_508,20230714,750,750,2,723,4996,-4246
INJ_508,20230718,1050,1050,9,903,6991,-5941
INJ_509,20210929,8500,6750,0,0,26984,-20234
INJ_509,20210930,2750,2750,0,1,10991,-8241
INJ_509,20211001,3750,3750,0,0,14987,-11237
INJ_509,20211002,3500,3500,0,0,13989,-10489
INJ_509,20211004,3500,3500,0,0,13985,-10485
INJ_509,20211005,4000,4000,0,0,15988,-11988
INJ_509,20211006,8500,7000,0,1,27981,-20981
INJ_509,20211007,7250,7250,0,1,28979,-21729
INJ_509,20211008,7500,7500,0,1,29986,-22486
INJ_509,20211009,4500,4500,0,0,17983,-13483
INJ_509,20211012,5000,5000,0,0,19984,-14984
INJ_509,20211015,8000,7250,0,0,28978,-21728
INJ_509,20211016,3500,3500,0,0,13989,-10489
INJ_509,20211018,4750,2750,0,-1,10991,-8241
INJ_509,20211019,3750,3750,0,0,14991,-11241
INJ_509,20211021,3750,3750,0,0,14996,-11246
INJ_509,20211027,3250,3250,0,2,12989,-9739
INJ_509,20211030,3750,3750,0,0,14989,-11239
INJ_509,20211101,4250,4250,0,1,16983,-12733
INJ_509,20211104,7500,7500,0,2,29974,-22474
INJ_509,20211106,3250,3250,0,0,12988,-9738
INJ_509,20211110,7000,7000,0,1,27981,-20981
INJ_509,20211111,2000,2000,0,0,7996,-5996
INJ_509,20211112,7500,7500,0,0,29984,-22484
INJ_509,20211113,5750,3750,0,1,14988,-11238
INJ_509,20211115,2500,2500,0,2,9991,-7491
INJ_509,20211117,4750,2750,0,1,10992,-8242
INJ_509,20211119,3500,3500,0,0,13986,-10486
INJ_509,20211122,2750,2750,0,1,10993,-8243
INJ_509,20211124,4500,4500,0,1,17986,-13486
INJ_509,20211126,3250,3250,0,1,12991,-9741
INJ_509,20211127,7250,7250,0,0,28980,-21730
INJ_509,20211130,3500,3500,0,1,13995,-10495
INJ_509,20211201,12250,10250,0,0,40969,-30719
INJ_509,20211202,7250,7250,0,1,28977,-21727
INJ_509,20211203,6250,6250,0,1,24985,-18735
INJ_509,20211204,4500,4500,0,0,17987,-13487
INJ_509,20211206,3750,3750,0,0,14996,-11246
INJ_509,20211207,3750,3750,0,1,14992,-11242
INJ_509,20211208,12750,10750,0,-2,42986,-32236
INJ_509,20211209,11750,7250,0,1,28986,-21736
INJ_509,20211211,4500,4500,0,2,17989,-13489
INJ_509,20211214,3500,3500,0,0,13990,-10490
INJ_509,20211215,4250,4250,0,2,16984,-12734
INJ_509,20211218,5750,5750,0,2,22987,-17237
INJ_509,20211220,9750,9750,0,-1,38961,-29211
INJ_509,20211221,7750,7750,0,4,30976,-23226
INJ_509,20211222,6500,6500,0,2,25975,-19475
INJ_509,20211223,9000,9000,0,2,35974,-26974
INJ_509,20211224,4750,2750,0,0,10987,-8237
INJ_509,20211225,6750,6750,0,1,26980,-20230
INJ_509,20211227,7750,7000,0,0,27977,-20977
INJ_509,20211228,8000,8000,0,0,31971,-23971
INJ_509,20211229,3000,1500,0,1,5994,-4494
INJ_509,20211230,8000,8000,0,1,31976,-23976
INJ_509,20211231,3750,3750,0,-1,14998,-11248
INJ_509,20220101,2750,2750,0,0,10989,-8239
INJ_509,20220103,7500,7500,0,0,29979,-22479
INJ_509,20220104,7250,7250,0,1,28972,-21722
INJ_509,20220106,3000,3000,0,3,11996,-8996
INJ_509,20220107,6500,6500,0,0,25984,-19484
INJ_509,20220110,4500,4500,0,0,17984,-13484
INJ_509,20220111,6250,6250,0,0,24974,-18724
INJ_509,20220112,7750,7750,0,-1,30978,-23228
INJ_509,20220114,13500,13500,0,0,53942,-40442
INJ_509,20220115,6500,6500,0,1,25987,-19487
INJ_509,20220118,11250,11250,0,-1,44973,-33723
INJ_509,20220120,6000,6000,0,0,23978,-17978
INJ_509,20220121,3250,3250,0,0,12990,-9740
INJ_509,20220122,3750,3750,0,0,14995,-11245
INJ_509,20220124,4000,4000,0,1,15985,-11985
INJ_509,20220126,2750,2750,0,1,10992,-8242
INJ_509,20220127,3500,3500,0,0,13993,-10493
INJ_509,20220128,7750,7750,0,2,30982,-23232
INJ_509,20220129,4250,4250,0,1,16986,-12736
INJ_509,20220131,7500,7500,0,2,29983,-22483
INJ_509,20220201,4250,4250,0,1,16985,-12735
INJ_509,20220202,3500,3500,0,0,13989,-10489
INJ_509,20220203,14750,13500,0,0,53957,-40457
INJ_509,20220204,7250,7250,0,-1,28976,-21726
INJ_509,20220205,4000,4000,0,0,15989,-11989
INJ_509,20220208,11000,9000,0,0,35970,-26970
INJ_509,20220209,7750,7750,0,0,30968,-23218
INJ_509,20220210,3500,3500,0,0,13991,-10491
INJ_509,20220212,9000,7000,0,0,27985,-20985
INJ_509,20220214,8000,8000,0,1,31983,-23983
INJ_509,20220215,2750,2750,0,4,10992,-8242
INJ_509,20220216,14000,13250,0,2,52953,-39703
INJ_509,20220218,7500,7500,0,0,29979,-22479
INJ_509,20220222,9500,9500,0,0,37974,-28474
INJ_509,20220223,6500,6500,0,1,25982,-19482
INJ_509,20220225,3500,3500,0,7,13989,-10489
INJ_509,20220226,4250,4250,0,0,16933,-12683
INJ_509,20220228,2750,2750,0,1,10990,-8240
INJ_509,20220301,3250,3250,0,0,12992,-9742
INJ_509,20220302,7500,3750,0,0,14997,-11247
INJ_509,20220303,2750,2750,0,2,10991,-8241
INJ_509,20220304,10500,10500,0,2,41965,-31465
INJ_509,20220305,3250,3250,0,0,12991,-9741
INJ_509,20220307,2750,2750,0,-1,10990,-8240
INJ_509,20220308,3500,3500,0,0,13993,-10493
INJ_509,20220309,3500,3500,0,0,13990,-10490
INJ_509,20220310,3750,3750,0,0,14990,-11240
INJ_509,20220311,3500,3500,0,1,13994,-10494
INJ_509,20220312,8250,3250,0,1,12989,-9739
INJ_509,20220314,3500,3500,0,0,13990,-10490
INJ_509,20220315,10250,10250,0,2,40973,-30723
INJ_509,20220316,3250,3250,0,3,12992,-9742
INJ_509,20220317,3750,3750,0,0,14990,-11240
INJ_509,20220318,7250,7250,0,2,28976,-21726
INJ_509,20220319,6750,6750,0,2,26985,-20235
INJ_509,20220321,10000,10000,0,0,39975,-29975
INJ_509,20220322,4250,4250,0,1,16988,-12738
INJ_509,20220323,3500,3500,0,1,13991,-10491
INJ_509,20220324,3750,3750,0,1,14991,-11241
INJ_509,20220325,3750,3750,0,1,14988,-11238
INJ_509,20220326,6500,6500,0,2,25980,-19480
INJ_509,20220328,3250,3250,0,0,12991,-9741
INJ_509,20220329,10250,10250,0,-1,40967,-30717
INJ_509,20220330,11250,11250,0,1,44961,-33711
INJ_509,20220331,4250,4250,0,1,16984,-12734
INJ_509,20220401,4250,4250,0,0,16958,-12708
INJ_509,20220402,9500,7750,0,2,30976,-23226
INJ_509,20220404,6000,6000,0,2,23986,-17986
INJ_509,20220405,13750,13750,0,2,54965,-41215
INJ_509,20220408,3750,3750,0,-1,14984,-11234
INJ_509,20220409,7000,7000,0,1,27981,-20981
INJ_509,20220411,3250,3250,0,1,12989,-9739
INJ_509,20220412,3750,3750,0,0,14992,-11242
INJ_509,20220415,4250,4250,0,0,16980,-12730
INJ_509,20220416,11000,11000,0,1,43964,-32964
INJ_509,20220418,3750,3750,0,2,14991,-11241
INJ_509,20220420,3750,3750,0,0,14990,-11240
INJ_509,20220421,17750,17750,0,2,70962,-53212
INJ_509,20220422,4500,4500,0,1,17985,-13485
INJ_509,20220423,15000,3750,0,1,14993,-11243
INJ_509,20220424,5000,5000,0,0,19987,-14987
INJ_509,20220425,7750,7750,0,0,30976,-23226
INJ_509,20220426,3500,3500,0,-1,13991,-10491
INJ_509,20220427,6250,6250,0,7,24985,-18735
INJ_509,20220428,7000,7000,0,5,27984,-20984
INJ_509,20220429,10500,10500,0,-1,41966,-31466
INJ_509,20220503,3500,3500,0,0,13994,-10494
INJ_509,20220504,12500,12500,0,2,49971,-37471
INJ_509,20220505,6750,6750,0,0,26987,-20237
INJ_509,20220506,3750,3750,0,0,14997,-11247
INJ_509,20220507,3500,3500,0,1,13993,-10493
INJ_509,20220509,7250,7250,0,1,28980,-21730
INJ_509,20220510,8750,8750,0,1,34982,-26232
INJ_509,20220511,12250,12250,0,2,48968,-36718
INJ_509,20220512,9250,7250,0,-1,28985,-21735
INJ_509,20220514,9750,3750,0,2,14990,-11240
INJ_509,20220516,10750,10750,0,1,42974,-32224
INJ_509,20220517,5500,5500,0,0,21984,-16484
INJ_509,20220518,8500,8500,0,2,33963,-25463
INJ_509,20220519,3750,3750,0,0,14989,-11239
INJ_509,20220520,7750,7750,0,0,30971,-23221
INJ_509,20220521,7500,7500,0,0,29985,-22485
INJ_509,20220523,10750,10750,0,1,42964,-32214
INJ_509,20220524,14500,14500,0,2,57943,-43443
INJ_509,20220525,3750,3750,0,2,14985,-11235
INJ_509,20220526,3250,3250,0,0,12993,-9743
INJ_509,20220527,7250,7250,0,2,28974,-21724
INJ_509,20220528,4500,4500,0,1,17988,-13488
INJ_509,20220530,3750,3750,0,0,14989,-11239
INJ_509,20220531,8250,8250,0,-1,32982,-24732
INJ_509,20220602,3500,3500,0,1,13989,-10489
INJ_509,20220603,9500,9500,0,-1,37974,-28474
INJ_509,20220604,12000,8250,0,0,32982,-24732
INJ_509,20220606,3250,3250,0,3,12991,-9741
INJ_509,20220607,3250,3250,0,2,12990,-9740
INJ_509,20220608,3750,3750,0,0,14994,-11244
INJ_509,20220609,9250,7500,0,1,29976,-22476
INJ_509,20220610,8500,8500,0,1,33973,-25473
INJ_509,20220611,4250,4250,0,1,16984,-12734
INJ_509,20220614,8000,8000,0,3,31972,-23972
INJ_509,20220615,7500,7500,0,0,29984,-22484
INJ_509,20220616,4500,4500,0,0,17990,-13490
INJ_509,20220620,9250,7500,0,0,29976,-22476
INJ_509,20220621,13000,11250,0,1,44962,-33712
INJ_509,20220622,7250,7250,0,2,28977,-21727
INJ_509,20220623,7250,7250,0,1,28984,-21734
INJ_509,20220624,6250,6250,0,2,24980,-18730
INJ_509,20220625,4250,4250,0,1,16990,-12740
INJ_509,20220627,3250,3250,0,1,12992,-9742
INJ_509,20220702,7000,7000,0,1,28001,-21001
INJ_509,20220704,6500,6500,0,3,25989,-19489
INJ_509,20220705,9000,9000,0,-1,35996,-26996
INJ_509,20220706,4250,4250,0,1,16993,-12743
INJ_509,20220707,10250,8250,0,0,32992,-24742
INJ_509,20220708,14000,14000,0,1,55988,-41988
INJ_509,20220709,3250,3250,0,0,12996,-9746
INJ_509,20220712,10250,10250,0,2,40994,-30744
INJ_509,20220713,3750,3750,0,1,14996,-11246
INJ_509,20220715,4750,3250,0,1,12998,-9748
INJ_509,20220718,7000,7000,0,0,27998,-20998
INJ_509,20220719,12250,12250,0,0,48991,-36741
INJ_509,20220720,2500,2500,0,1,10002,-7502
INJ_509,20220722,10500,10500,0,4,41982,-31482
INJ_509,20220723,3000,3000,0,0,11994,-8994
INJ_509,20220725,3250,3250,0,-1,12992,-9742
INJ_509,20220726,6000,6000,0,1,23996,-17996
INJ_509,20220727,7500,7500,0,1,29994,-22494
INJ_509,20220728,4000,4000,0,-1,15993,-11993
INJ_509,20220729,4250,4250,0,1,16996,-12746
INJ_509,20220730,6000,4250,0,-1,16999,-12749
INJ_509,20220801,15250,13500,0,2,53995,-40495
INJ_509,20220802,3750,3750,0,0,14997,-11247
INJ_509,20220803,9250,9250,0,1,36986,-27736
INJ_509,20220804,8750,8750,0,2,34991,-26241
INJ_509,20220805,4250,4250,0,2,16994,-12744
INJ_509,20220806,3750,3750,0,0,14994,-11244
INJ_509,20220808,5000,5000,0,2,19999,-14999
INJ_509,20220809,19000,13000,0,2,51990,-38990
INJ_509,20220810,11000,11000,0,0,43990,-32990
INJ_509,20220811,7250,7250,0,0,28995,-21745
INJ_509,20220813,3750,3750,0,1,14997,-11247
INJ_509,20220815,4250,4250,0,1,16994,-12744
INJ_509,20220816,3250,3250,0,0,12995,-9745
INJ_509,20220817,3750,3750,0,-1,14999,-11249
INJ_509,20220818,7000,7000,0,1,27992,-20992
INJ_509,20220819,7250,7250,0,-1,28998,-21748
INJ_509,20220820,7750,7750,0,15,30992,-23242
INJ_509,20220822,10750,10750,0,2,42987,-32237
INJ_509,20220823,5250,3250,0,0,12998,-9748
INJ_509,20220824,4250,4250,0,1,16991,-12741
INJ_509,20220825,19250,15750,0,2,62986,-47236
INJ_509,20220826,3250,3250,0,0,12999,-9749
INJ_509,20220830,12500,10750,0,0,42993,-32243
INJ_509,20220831,7750,7750,0,-1,30993,-23243
INJ_509,20220902,3500,3500,0,0,13996,-10496
INJ_509,20220903,11250,11250,0,0,44996,-33746
INJ_509,20220905,13750,13750,0,-1,54985,-41235
INJ_509,20220907,7500,7500,0,0,29997,-22497
INJ_509,20220908,13250,11250,0,1,44991,-33741
INJ_509,20220909,3500,3500,0,1,13998,-10498
INJ_509,20220910,7000,7000,0,0,27997,-20997
INJ_509,20220912,3500,3500,0,0,13996,-10496
INJ_509,20220913,6750,6750,0,-1,26996,-20246
INJ_509,20220914,4250,4250,0,0,16996,-12746
INJ_509,20220915,4250,4250,0,1,16995,-12745
INJ_509,20220917,14500,12000,0,-1,47995,-35995
INJ_509,20220918,2500,2500,0,0,9994,-7494
INJ_509,20220919,7500,7500,0,2,29993,-22493
INJ_509,20220920,13750,13750,0,0,54988,-41238
INJ_509,20220921,8500,8500,0,0,33986,-25486
INJ_509,20220922,7750,7750,0,0,30994,-23244
INJ_509,20220924,3500,3500,0,1,13991,-10491
INJ_509,20220926,7750,7750,0,1,30998,-23248
INJ_509,20220927,13750,12250,0,2,48991,-36741
INJ_509,20220929,4250,4250,0,1,16995,-12745
INJ_509,20220930,4250,4250,0,2,16996,-12746
INJ_509,20221001,3250,3250,0,0,12996,-9746
INJ_509,20221004,10250,8500,0,2,33991,-25491
INJ_509,20221005,3750,3750,0,2,14998,-11248
INJ_509,20221006,11250,11250,0,1,44981,-33731
INJ_509,20221008,13250,13250,0,0,52985,-39735
INJ_509,20221010,3750,3750,0,-1,14997,-11247
INJ_509,20221012,8750,8750,0,2,34996,-26246
INJ_509,20221013,3500,3500,0,2,14002,-10502
INJ_509,20221014,17000,17000,0,4,67988,-50988
INJ_509,20221015,4250,4250,0,1,16991,-12741
INJ_509,20221019,4250,4250,0,0,16992,-12742
INJ_509,20221021,7500,7500,0,2,29996,-22496
INJ_509,20221022,4750,4750,0,0,18993,-14243
INJ_509,20221024,8250,6750,0,2,26990,-20240
INJ_509,20221025,3750,3750,0,0,14996,-11246
INJ_509,20221026,8250,8250,0,3,32991,-24741
INJ_509,20221027,2750,2750,0,-1,10996,-8246
INJ_509,20221028,7000,7000,0,2,27995,-20995
INJ_509,20221029,7750,7750,0,0,30990,-23240
INJ_509,20221031,11500,10000,0,0,39991,-29991
INJ_509,20221101,4250,4250,0,1,16998,-12748
INJ_509,20221102,3750,3750,0,0,15000,-11250
INJ_509,20221103,7000,7000,0,1,27991,-20991
INJ_509,20221105,3500,3500,0,-1,13994,-10494
INJ_509,20221107,6500,6500,0,1,25995,-19495
INJ_509,20221108,8250,8250,0,2,32993,-24743
INJ_509,20221109,6250,6250,0,0,24998,-18748
INJ_509,20221110,3250,3250,0,-1,12995,-9745
INJ_509,20221111,7000,7000,0,2,27992,-20992
INJ_509,20221112,4250,4250,0,1,16996,-12746
INJ_509,20221114,3500,3500,0,0,13999,-10499
INJ_509,20221115,2750,2750,0,0,10997,-8247
INJ_509,20221116,11250,11250,0,0,44991,-33741
INJ_509,20221117,7500,7500,0,1,29994,-22494
INJ_509,20221118,6750,6750,0,1,26989,-20239
INJ_509,20221119,3250,3250,0,1,12996,-9746
INJ_509,20221121,17000,17000,0,1,67988,-50988
INJ_509,20221122,2750,2750,0,0,10997,-8247
INJ_509,20221124,20000,20000,0,2,79979,-59979
INJ_509,20221125,3500,3500,0,-1,13997,-10497
INJ_509,20221126,3750,3750,0,2,14997,-11247
INJ_509,20221128,4250,4250,0,1,16998,-12748
INJ_509,20221129,10750,10750,0,0,42990,-32240
INJ_509,20221130,5750,5750,0,-1,22997,-17247
INJ_509,20221201,4500,4500,0,1,17997,-13497
INJ_509,20221202,3750,3750,0,2,14997,-11247
INJ_509,20221203,15000,15000,0,1,59985,-44985
INJ_509,20221205,9500,9500,0,1,37986,-28486
INJ_509,20221206,3500,3500,0,-1,13999,-10499
INJ_509,20221207,8000,8000,0,3,31996,-23996
INJ_509,20221209,3000,3000,0,0,11996,-8996
INJ_509,20221210,2500,2500,0,0,9997,-7497
INJ_509,20221212,4000,4000,0,0,15999,-11999
INJ_509,20221213,7250,7250,0,1,28988,-21738
INJ_509,20221215,3250,3250,0,0,12997,-9747
INJ_509,20221216,13500,10250,0,1,40992,-30742
INJ_509,20221217,11500,11500,0,0,45994,-34494
INJ_509,20221219,3500,3500,0,0,13997,-10497
INJ_509,20221220,12500,12500,0,1,49986,-37486
INJ_509,20221221,6500,6500,0,-1,25996,-19496
INJ_509,20221222,3250,3250,0,0,12996,-9746
INJ_509,20221223,7000,7000,0,-1,27993,-20993
INJ_509,20221224,4250,4250,0,-1,17000,-12750
INJ_509,20221227,3500,3500,0,0,14000,-10500
INJ_509,20221228,3750,3750,0,1,14995,-11245
INJ_509,20221229,5500,3750,0,0,14996,-11246
INJ_509,20221230,3500,3500,0,0,14000,-10500
INJ_509,20221231,3500,3500,0,-1,13995,-10495
INJ_509,20230103,7500,7500,0,0,29994,-22494
INJ_509,20230104,7750,7750,0,2,30987,-23237
INJ_509,20230105,7500,7500,0,0,29994,-22494
INJ_509,20230109,4250,4250,0,0,17000,-12750
INJ_509,20230112,3500,3500,0,1,13999,-10499
INJ_509,20230113,7250,7250,0,1,28999,-21749
INJ_509,20230118,4250,4250,0,2,16998,-12748
INJ_509,20230120,3250,3250,0,0,12993,-9743
INJ_509,20230121,4500,4500,0,2,17992,-13492
INJ_509,20230301,46000,5000,0,0,14183,-9183
INJ_509,20230307,42500,3250,0,0,12998,-9748
