_id,FOLIO_NUMBER,TANK_CODE,TERMINAL_PRODUCT_NUMBER,NET_QUANTITY,RACK_DISPOSALS,quantity_difference
6633cb8d8f483ae670106c31,20210927,TK-100,8,51,92,-41
6633cb8d8f483ae670106c32,20210928,TK-100,8,115,122,-7
6633cb8d8f483ae670106c33,20210929,TK-100,8,204,216,-12
6633cb8d8f483ae670106c34,20210930,TK-100,8,186,200,-14
6633cb8d8f483ae670106c35,20211001,TK-100,8,181,191,-10
6633cb8d8f483ae670106c36,20211002,TK-100,8,198,212,-14
6633cb8d8f483ae670106c37,20211004,TK-100,8,212,222,-10
6633cb8d8f483ae670106c38,20211005,TK-100,8,162,176,-14
6633cb8d8f483ae670106c39,20211006,TK-100,8,185,194,-9
6633cb8d8f483ae670106c3a,20211007,TK-100,8,206,218,-12
6633cb8d8f483ae670106c3b,20211008,TK-100,8,173,185,-12
6633cb8d8f483ae670106c3c,20211009,TK-100,8,221,238,-17
6633cb8d8f483ae670106c3d,20211011,TK-100,8,193,204,-11
6633cb8d8f483ae670106c3e,20211012,TK-100,8,154,165,-11
6633cb8d8f483ae670106c3f,20211013,TK-100,8,47,50,-3
6633cb8d8f483ae670106c40,20211014,TK-100,8,0,0,0
6633cb8d8f483ae670106c41,20211015,TK-100,8,0,0,0
6633cb8d8f483ae670106c42,20211022,TK-100,8,179,187,-8
6633cb8d8f483ae670106c43,20211023,TK-100,8,200,210,-10
6633cb8d8f483ae670106c44,20211025,TK-100,8,58,61,-3
6633cb8d8f483ae670106c45,20211026,TK-100,8,66,71,-5
6633cb8d8f483ae670106c46,20211027,TK-100,8,169,188,-19
6633cb8d8f483ae670106c47,20211028,TK-100,8,171,175,-4
6633cb8d8f483ae670106c48,20211029,TK-100,8,161,171,-10
6633cb8d8f483ae670106c49,20211030,TK-100,8,298,318,-20
6633cb8d8f483ae670106c4a,20211101,TK-100,8,190,203,-13
6633cb8d8f483ae670106c4b,20211102,TK-100,8,167,178,-11
6633cb8d8f483ae670106c4c,20211103,TK-100,8,188,199,-11
6633cb8d8f483ae670106c4d,20211104,TK-100,8,189,197,-8
6633cb8d8f483ae670106c4e,20211105,TK-100,8,234,247,-13
6633cb8d8f483ae670106c4f,20211106,TK-100,8,174,187,-13
6633cb8d8f483ae670106c50,20211108,TK-100,8,228,240,-12
6633cb8d8f483ae670106c51,20211109,TK-100,8,168,179,-11
6633cb8d8f483ae670106c52,20211110,TK-100,8,225,237,-12
6633cb8d8f483ae670106c53,20211111,TK-100,8,202,215,-13
6633cb8d8f483ae670106c54,20211112,TK-100,8,185,196,-11
6633cb8d8f483ae670106c55,20211113,TK-100,8,208,226,-18
6633cb8d8f483ae670106c56,20211114,TK-100,8,7,7,0
6633cb8d8f483ae670106c57,20211115,TK-100,8,18,13,5
6633cb8d8f483ae670106c58,20211116,TK-100,8,55,59,-4
6633cb8d8f483ae670106c59,20211117,TK-100,8,186,195,-9
6633cb8d8f483ae670106c5a,20211118,TK-100,8,162,175,-13
6633cb8d8f483ae670106c5b,20211119,TK-100,8,164,174,-10
6633cb8d8f483ae670106c5c,20211120,TK-100,8,246,261,-15
6633cb8d8f483ae670106c5d,20211122,TK-100,8,28,30,-2
6633cb8d8f483ae670106c5e,20211124,TK-100,8,0,0,0
6633cb8d8f483ae670106c5f,20211126,TK-100,8,165,179,-14
6633cb8d8f483ae670106c60,20211127,TK-100,8,197,211,-14
6633cb8d8f483ae670106c61,20211129,TK-100,8,148,156,-8
6633cb8d8f483ae670106c62,20211130,TK-100,8,150,159,-9
6633cb8d8f483ae670106c63,20211201,TK-100,8,218,230,-12
6633cb8d8f483ae670106c64,20211202,TK-100,8,190,199,-9
6633cb8d8f483ae670106c65,20211203,TK-100,8,168,186,-18
6633cb8d8f483ae670106c66,20211204,TK-100,8,213,224,-11
6633cb8d8f483ae670106c67,20211206,TK-100,8,178,180,-2
6633cb8d8f483ae670106c68,20211207,TK-100,8,154,162,-8
6633cb8d8f483ae670106c69,20211208,TK-100,8,205,216,-11
6633cb8d8f483ae670106c6a,20211209,TK-100,8,155,167,-12
6633cb8d8f483ae670106c6b,20211210,TK-100,8,206,221,-15
6633cb8d8f483ae670106c6c,20211211,TK-100,8,187,201,-14
6633cb8d8f483ae670106c6d,20211213,TK-100,8,204,218,-14
6633cb8d8f483ae670106c6e,20211214,TK-100,8,169,181,-12
6633cb8d8f483ae670106c6f,20211215,TK-100,8,240,256,-16
6633cb8d8f483ae670106c70,20211216,TK-100,8,150,161,-11
6633cb8d8f483ae670106c71,20211217,TK-100,8,202,213,-11
6633cb8d8f483ae670106c72,20211218,TK-100,8,186,198,-12
6633cb8d8f483ae670106c73,20211220,TK-100,8,0,0,0
6633cb8d8f483ae670106c74,20211221,TK-100,8,232,246,-14
6633cb8d8f483ae670106c75,20211222,TK-100,8,254,269,-15
6633cb8d8f483ae670106c76,20211223,TK-100,8,188,201,-13
6633cb8d8f483ae670106c77,20211224,TK-100,8,195,209,-14
6633cb8d8f483ae670106c78,20211225,TK-100,8,174,182,-8
6633cb8d8f483ae670106c79,20211227,TK-100,8,231,245,-14
6633cb8d8f483ae670106c7a,20211228,TK-100,8,168,179,-11
6633cb8d8f483ae670106c7b,20211229,TK-100,8,228,243,-15
6633cb8d8f483ae670106c7c,20211230,TK-100,8,188,203,-15
6633cb8d8f483ae670106c7d,20211231,TK-100,8,272,289,-17
6633cb8d8f483ae670106c7e,20220101,TK-100,8,207,223,-16
6633cb8d8f483ae670106c7f,20220102,TK-100,8,16,17,-1
6633cb8d8f483ae670106c80,20220103,TK-100,8,254,264,-10
6633cb8d8f483ae670106c81,20220104,TK-100,8,225,240,-15
6633cb8d8f483ae670106c82,20220105,TK-100,8,57,61,-4
6633cb8d8f483ae670106c83,20220106,TK-100,8,0,0,0
6633cb8d8f483ae670106c84,20220108,TK-100,8,0,0,0
6633cb8d8f483ae670106c85,20220110,TK-100,8,0,0,0
6633cb8d8f483ae670106c86,20220122,TK-100,8,0,0,0
6633cb8d8f483ae670106c87,20220126,TK-100,8,178,190,-12
6633cb8d8f483ae670106c88,20220127,TK-100,8,165,175,-10
6633cb8d8f483ae670106c89,20220128,TK-100,8,242,259,-17
6633cb8d8f483ae670106c8a,20220129,TK-100,8,266,283,-17
6633cb8d8f483ae670106c8b,20220131,TK-100,8,225,241,-16
6633cb8d8f483ae670106c8c,20220201,TK-100,8,197,210,-13
6633cb8d8f483ae670106c8d,20220202,TK-100,8,216,231,-15
6633cb8d8f483ae670106c8e,20220203,TK-100,8,175,184,-9
6633cb8d8f483ae670106c8f,20220204,TK-100,8,208,220,-12
6633cb8d8f483ae670106c90,20220205,TK-100,8,268,284,-16
6633cb8d8f483ae670106c91,20220207,TK-100,8,186,199,-13
6633cb8d8f483ae670106c92,20220208,TK-100,8,179,191,-12
6633cb8d8f483ae670106c93,20220209,TK-100,8,190,200,-10
6633cb8d8f483ae670106c94,20220210,TK-100,8,178,185,-7
6633cb8d8f483ae670106c95,20220211,TK-100,8,190,204,-14
6633cb8d8f483ae670106c96,20220212,TK-100,8,253,272,-19
6633cb8d8f483ae670106c97,20220214,TK-100,8,223,234,-11
6633cb8d8f483ae670106c98,20220215,TK-100,8,230,244,-14
6633cb8d8f483ae670106c99,20220216,TK-100,8,249,266,-17
6633cb8d8f483ae670106c9a,20220217,TK-100,8,179,190,-11
6633cb8d8f483ae670106c9b,20220218,TK-100,8,207,219,-12
6633cb8d8f483ae670106c9c,20220219,TK-100,8,68,71,-3
6633cb8d8f483ae670106c9d,20220310,TK-100,8,0,0,0
6633cb8d8f483ae670106c9e,20220711,TK-100,8,0,0,0
6633cb8d8f483ae670106c9f,20220806,TK-100,8,0,0,0
6633cb8d8f483ae670106ca0,20220826,TK-100,8,0,0,0
6633cb8d8f483ae670106ca1,20220912,TK-100,8,0,0,0
6633cb8d8f483ae670106ca2,20220913,TK-100,8,0,0,0
6633cb8d8f483ae670106ca3,20220915,TK-100,8,0,0,0
6633cb8d8f483ae670106ca4,20220916,TK-100,8,0,0,0
6633cb8d8f483ae670106ca5,20220919,TK-100,8,1,2,-1
6633cb8d8f483ae670106ca6,20220921,TK-100,8,0,0,0
6633cb8d8f483ae670106ca7,20220923,TK-100,8,0,0,0
6633cb8d8f483ae670106ca8,20220924,TK-100,8,0,0,0
6633cb8d8f483ae670106ca9,20220926,TK-100,8,0,0,0
6633cb8d8f483ae670106caa,20220927,TK-100,8,0,0,0
6633cb8d8f483ae670106cab,20220928,TK-100,8,1,1,0
6633cb8d8f483ae670106cac,20220930,TK-100,8,0,1,-1
6633cb8d8f483ae670106cad,20221004,TK-100,8,0,1,-1
6633cb8d8f483ae670106cae,20221005,TK-100,8,1,2,-1
6633cb8d8f483ae670106caf,20221006,TK-100,8,0,0,0
6633cb8d8f483ae670106cb0,20221007,TK-100,8,0,0,0
6633cb8d8f483ae670106cb1,20221008,TK-100,8,0,2,-2
6633cb8d8f483ae670106cb2,20221010,TK-100,8,1,1,0
6633cb8d8f483ae670106cb3,20221011,TK-100,8,0,0,0
6633cb8d8f483ae670106cb4,20221012,TK-100,8,0,0,0
6633cb8d8f483ae670106cb5,20221013,TK-100,8,1,1,0
6633cb8d8f483ae670106cb6,20221014,TK-100,8,2,2,0
6633cb8d8f483ae670106cb7,20221015,TK-100,8,1,2,-1
6633cb8d8f483ae670106cb8,20221017,TK-100,8,0,0,0
6633cb8d8f483ae670106cb9,20221019,TK-100,8,0,0,0
6633cb8d8f483ae670106cba,20221021,TK-100,8,0,0,0
6633cb8d8f483ae670106cbb,20221022,TK-100,8,0,0,0
6633cb8d8f483ae670106cbc,20221024,TK-100,8,0,0,0
6633cb8d8f483ae670106cbd,20221025,TK-100,8,0,0,0
6633cb8d8f483ae670106cbe,20221027,TK-100,8,0,0,0
6633cb8d8f483ae670106cbf,20221028,TK-100,8,1,2,-1
6633cb8d8f483ae670106cc0,20221029,TK-100,8,0,0,0
6633cb8d8f483ae670106cc1,20221031,TK-100,8,0,0,0
6633cb8d8f483ae670106cc2,20221101,TK-100,8,0,0,0
6633cb8d8f483ae670106cc3,20221102,TK-100,8,0,0,0
6633cb8d8f483ae670106cc4,20221104,TK-100,8,0,1,-1
6633cb8d8f483ae670106cc5,20221105,TK-100,8,0,0,0
6633cb8d8f483ae670106cc6,20221107,TK-100,8,0,0,0
6633cb8d8f483ae670106cc7,20221108,TK-100,8,0,0,0
6633cb8d8f483ae670106cc8,20221109,TK-100,8,1,1,0
6633cb8d8f483ae670106cc9,20221110,TK-100,8,1,1,0
6633cb8d8f483ae670106cca,20221111,TK-100,8,0,1,-1
6633cb8d8f483ae670106ccb,20221112,TK-100,8,0,1,-1
6633cb8d8f483ae670106ccc,20221114,TK-100,8,0,0,0
6633cb8d8f483ae670106ccd,20221115,TK-100,8,0,0,0
6633cb8d8f483ae670106cce,20221116,TK-100,8,0,0,0
6633cb8d8f483ae670106ccf,20221119,TK-100,8,2,3,-1
6633cb8d8f483ae670106cd0,20221121,TK-100,8,0,0,0
6633cb8d8f483ae670106cd1,20221123,TK-100,8,0,1,-1
6633cb8d8f483ae670106cd2,20221124,TK-100,8,0,1,-1
6633cb8d8f483ae670106cd3,20221129,TK-100,8,0,0,0
6633cb8d8f483ae670106cd4,20221202,TK-100,8,0,1,-1
6633cb8d8f483ae670106cd5,20221203,TK-100,8,0,0,0
6633cb8d8f483ae670106cd6,20221205,TK-100,8,0,0,0
6633cb8d8f483ae670106cd7,20221206,TK-100,8,0,1,-1
6633cb8d8f483ae670106cd8,20221207,TK-100,8,2,2,0
6633cb8d8f483ae670106cd9,20221208,TK-100,8,0,0,0
6633cb8d8f483ae670106cda,20221209,TK-100,8,0,1,-1
6633cb8d8f483ae670106cdb,20221210,TK-100,8,1,3,-2
6633cb8d8f483ae670106cdc,20221212,TK-100,8,0,0,0
6633cb8d8f483ae670106cdd,20221213,TK-100,8,0,0,0
6633cb8d8f483ae670106cde,20221215,TK-100,8,0,0,0
6633cb8d8f483ae670106cdf,20221217,TK-100,8,0,0,0
6633cb8d8f483ae670106ce0,20221219,TK-100,8,0,1,-1
6633cb8d8f483ae670106ce1,20221220,TK-100,8,0,0,0
6633cb8d8f483ae670106ce2,20221222,TK-100,8,0,0,0
6633cb8d8f483ae670106ce3,20221223,TK-100,8,1,1,0
6633cb8d8f483ae670106ce4,20221224,TK-100,8,0,1,-1
6633cb8d8f483ae670106ce5,20221227,TK-100,8,1,1,0
6633cb8d8f483ae670106ce6,20221228,TK-100,8,0,0,0
6633cb8d8f483ae670106ce7,20221230,TK-100,8,0,1,-1
6633cb8d8f483ae670106ce8,20221231,TK-100,8,0,1,-1
6633cb8d8f483ae670106ce9,20230102,TK-100,8,0,0,0
6633cb8d8f483ae670106cea,20230103,TK-100,8,1,2,-1
6633cb8d8f483ae670106ceb,20230104,TK-100,8,0,0,0
6633cb8d8f483ae670106cec,20230106,TK-100,8,1,2,-1
6633cb8d8f483ae670106ced,20230109,TK-100,8,0,0,0
6633cb8d8f483ae670106cee,20230110,TK-100,8,0,0,0
6633cb8d8f483ae670106cef,20230111,TK-100,8,0,0,0
6633cb8d8f483ae670106cf0,20230112,TK-100,8,0,1,-1
6633cb8d8f483ae670106cf1,20230113,TK-100,8,0,0,0
6633cb8d8f483ae670106cf2,20230114,TK-100,8,4,6,-2
6633cb8d8f483ae670106cf3,20230116,TK-100,8,0,0,0
6633cb8d8f483ae670106cf4,20230119,TK-100,8,0,0,0
6633cb8d8f483ae670106cf5,20230120,TK-100,8,1,1,0
6633cb8d8f483ae670106cf6,20230121,TK-100,8,0,0,0
6633cb8d8f483ae670106cf7,20230123,TK-100,8,2,2,0
6633cb8d8f483ae670106cf8,20230124,TK-100,8,0,0,0
6633cb8d8f483ae670106cf9,20230125,TK-100,8,0,0,0
6633cb8d8f483ae670106cfa,20230126,TK-100,8,0,0,0
6633cb8d8f483ae670106cfb,20230128,TK-100,8,0,1,-1
6633cb8d8f483ae670106cfc,20230130,TK-100,8,0,1,-1
6633cb8d8f483ae670106cfd,20230202,TK-100,8,1,1,0
6633cb8d8f483ae670106cfe,20230203,TK-100,8,0,1,-1
6633cb8d8f483ae670106cff,20230204,TK-100,8,0,0,0
6633cb8d8f483ae670106d00,20230206,TK-100,8,0,0,0
6633cb8d8f483ae670106d01,20230207,TK-100,8,0,1,-1
6633cb8d8f483ae670106d02,20230208,TK-100,8,0,0,0
6633cb8d8f483ae670106d03,20230209,TK-100,8,1,1,0
6633cb8d8f483ae670106d04,20230210,TK-100,8,1,3,-2
6633cb8d8f483ae670106d05,20230211,TK-100,8,0,0,0
6633cb8d8f483ae670106d06,20230213,TK-100,8,0,0,0
6633cb8d8f483ae670106d07,20230214,TK-100,8,0,1,-1
6633cb8d8f483ae670106d08,20230215,TK-100,8,0,0,0
6633cb8d8f483ae670106d09,20230216,TK-100,8,0,0,0
6633cb8d8f483ae670106d0a,20230217,TK-100,8,0,0,0
6633cb8d8f483ae670106d0b,20230220,TK-100,8,6,6,0
6633cb8d8f483ae670106d0c,20230221,TK-100,8,1,2,-1
6633cb8d8f483ae670106d0d,20230222,TK-100,8,0,0,0
6633cb8d8f483ae670106d0e,20230223,TK-100,8,0,0,0
6633cb8d8f483ae670106d0f,20230224,TK-100,8,0,0,0
6633cb8d8f483ae670106d10,20230225,TK-100,8,1,2,-1
6633cb8d8f483ae670106d11,20230227,TK-100,8,0,0,0
6633cb8d8f483ae670106d12,20230228,TK-100,8,0,0,0
6633cb8d8f483ae670106d13,20230301,TK-100,8,0,0,0
6633cb8d8f483ae670106d14,20230302,TK-100,8,0,0,0
6633cb8d8f483ae670106d15,20230303,TK-100,8,0,0,0
6633cb8d8f483ae670106d16,20230304,TK-100,8,2,3,-1
6633cb8d8f483ae670106d17,20230306,TK-100,8,0,0,0
6633cb8d8f483ae670106d18,20230307,TK-100,8,0,0,0
6633cb8d8f483ae670106d19,20230308,TK-100,8,0,1,-1
6633cb8d8f483ae670106d1a,20230309,TK-100,8,0,2,-2
6633cb8d8f483ae670106d1b,20230311,TK-100,8,1,1,0
6633cb8d8f483ae670106d1c,20230313,TK-100,8,17,18,-1
6633cb8d8f483ae670106d1d,20230314,TK-100,8,82,88,-6
6633cb8d8f483ae670106d1e,20230315,TK-100,8,0,1,-1
6633cb8d8f483ae670106d1f,20230316,TK-100,8,0,1,-1
6633cb8d8f483ae670106d20,20230317,TK-100,8,1,1,0
6633cb8d8f483ae670106d21,20230318,TK-100,8,0,1,-1
6633cb8d8f483ae670106d22,20230322,TK-100,8,0,0,0
6633cb8d8f483ae670106d23,20230323,TK-100,8,0,0,0
6633cb8d8f483ae670106d24,20230324,TK-100,8,0,1,-1
6633cb8d8f483ae670106d25,20230325,TK-100,8,0,0,0
6633cb8d8f483ae670106d26,20230328,TK-100,8,0,0,0
6633cb8d8f483ae670106d27,20230329,TK-100,8,0,0,0
6633cb8d8f483ae670106d28,20230331,TK-100,8,0,1,-1
6633cb8d8f483ae670106d29,20230403,TK-100,8,0,0,0
6633cb8d8f483ae670106d2a,20230404,TK-100,8,0,0,0
6633cb8d8f483ae670106d2b,20230405,TK-100,8,3,5,-2
6633cb8d8f483ae670106d2c,20230406,TK-100,8,0,1,-1
6633cb8d8f483ae670106d2d,20230407,TK-100,8,0,0,0
6633cb8d8f483ae670106d2e,20230408,TK-100,8,1,1,0
6633cb8d8f483ae670106d2f,20230411,TK-100,8,0,0,0
6633cb8d8f483ae670106d30,20230412,TK-100,8,0,0,0
6633cb8d8f483ae670106d31,20230413,TK-100,8,0,1,-1
6633cb8d8f483ae670106d32,20230414,TK-100,8,9,11,-2
6633cb8d8f483ae670106d33,20230418,TK-100,8,0,0,0
6633cb8d8f483ae670106d34,20230419,TK-100,8,0,2,-2
6633cb8d8f483ae670106d35,20230420,TK-100,8,0,1,-1
6633cb8d8f483ae670106d36,20230421,TK-100,8,0,0,0
6633cb8d8f483ae670106d37,20230423,TK-100,8,0,0,0
6633cb8d8f483ae670106d38,20230424,TK-100,8,0,1,-1
6633cb8d8f483ae670106d39,20230426,TK-100,8,0,0,0
6633cb8d8f483ae670106d3a,20230427,TK-100,8,8,8,0
6633cb8d8f483ae670106d3b,20230428,TK-100,8,0,1,-1
6633cb8d8f483ae670106d3c,20230429,TK-100,8,0,1,-1
6633cb8d8f483ae670106d3d,20230502,TK-100,8,1,1,0
6633cb8d8f483ae670106d3e,20230503,TK-100,8,0,1,-1
6633cb8d8f483ae670106d3f,20230504,TK-100,8,0,1,-1
6633cb8d8f483ae670106d40,20230505,TK-100,8,64,67,-3
6633cb8d8f483ae670106d41,20230506,TK-100,8,61,67,-6
6633cb8d8f483ae670106d42,20230508,TK-100,8,227,244,-17
6633cb8d8f483ae670106d43,20230509,TK-100,8,221,241,-20
6633cb8d8f483ae670106d44,20230510,TK-100,8,205,224,-19
6633cb8d8f483ae670106d45,20230511,TK-100,8,167,183,-16
6633cb8d8f483ae670106d46,20230512,TK-100,8,193,211,-18
6633cb8d8f483ae670106d47,20230513,TK-100,8,228,248,-20
6633cb8d8f483ae670106d48,20230515,TK-100,8,199,218,-19
6633cb8d8f483ae670106d49,20230516,TK-100,8,165,179,-14
6633cb8d8f483ae670106d4a,20230517,TK-100,8,243,265,-22
6633cb8d8f483ae670106d4b,20230518,TK-100,8,153,166,-13
6633cb8d8f483ae670106d4c,20230519,TK-100,8,167,182,-15
6633cb8d8f483ae670106d4d,20230520,TK-100,8,187,206,-19
6633cb8d8f483ae670106d4e,20230522,TK-100,8,254,276,-22
6633cb8d8f483ae670106d4f,20230523,TK-100,8,127,138,-11
6633cb8d8f483ae670106d50,20230524,TK-100,8,182,198,-16
6633cb8d8f483ae670106d51,20230525,TK-100,8,136,149,-13
6633cb8d8f483ae670106d52,20230526,TK-100,8,171,187,-16
6633cb8d8f483ae670106d53,20230527,TK-100,8,232,245,-13
6633cb8d8f483ae670106d54,20230529,TK-100,8,204,221,-17
6633cb8d8f483ae670106d55,20230530,TK-100,8,65,72,-7
6633cb8d8f483ae670106d56,20230531,TK-100,8,0,0,0
6633cb8d8f483ae670106d57,20230602,TK-100,8,0,0,0
6633cb8d8f483ae670106d58,20230603,TK-100,8,0,0,0
6633cb8d8f483ae670106d59,20230606,TK-100,8,174,191,-17
6633cb8d8f483ae670106d5a,20230607,TK-100,8,161,178,-17
6633cb8d8f483ae670106d5b,20230608,TK-100,8,134,147,-13
6633cb8d8f483ae670106d5c,20230609,TK-100,8,129,146,-17
6633cb8d8f483ae670106d5d,20230610,TK-100,8,91,103,-12
6633cb8d8f483ae670106d5e,20230612,TK-100,8,78,93,-15
6633cb8d8f483ae670106d5f,20230613,TK-100,8,61,69,-8
6633cb8d8f483ae670106d60,20230614,TK-100,8,70,82,-12
6633cb8d8f483ae670106d61,20230615,TK-100,8,66,76,-10
6633cb8d8f483ae670106d62,20230616,TK-100,8,86,100,-14
6633cb8d8f483ae670106d63,20230617,TK-100,8,95,107,-12
6633cb8d8f483ae670106d64,20230619,TK-100,8,91,104,-13
6633cb8d8f483ae670106d65,20230620,TK-100,8,57,70,-13
6633cb8d8f483ae670106d66,20230621,TK-100,8,58,71,-13
6633cb8d8f483ae670106d67,20230622,TK-100,8,51,59,-8
6633cb8d8f483ae670106d68,20230624,TK-100,8,2,2,0
6633cb8d8f483ae670106d69,20230626,TK-100,8,50,59,-9
6633cb8d8f483ae670106d6a,20230627,TK-100,8,42,47,-5
6633cb8d8f483ae670106d6b,20230628,TK-100,8,127,151,-24
6633cb8d8f483ae670106d6c,20230630,TK-100,8,64,74,-10
6633cb8d8f483ae670106d6d,20230701,TK-100,8,78,93,-15
6633cb8d8f483ae670106d6e,20230703,TK-100,8,57,68,-11
6633cb8d8f483ae670106d6f,20230704,TK-100,8,55,66,-11
6633cb8d8f483ae670106d70,20230705,TK-100,8,62,74,-12
6633cb8d8f483ae670106d71,20230706,TK-100,8,57,70,-13
6633cb8d8f483ae670106d72,20230707,TK-100,8,73,86,-13
6633cb8d8f483ae670106d73,20230708,TK-100,8,97,118,-21
6633cb8d8f483ae670106d74,20230710,TK-100,8,85,101,-16
6633cb8d8f483ae670106d75,20230711,TK-100,8,59,72,-13
6633cb8d8f483ae670106d76,20230712,TK-100,8,72,86,-14
6633cb8d8f483ae670106d77,20230713,TK-100,8,86,99,-13
6633cb8d8f483ae670106d78,20230714,TK-100,8,56,71,-15
6633cb8d8f483ae670106d79,20230715,TK-100,8,91,108,-17
6633cb8d8f483ae670106d7a,20230716,TK-100,8,16,18,-2
6633cb8d8f483ae670106d7b,20230717,TK-100,8,90,106,-16
6633cb8d8f483ae670106d7c,20230718,TK-100,8,100,116,-16
6633cb8d8f483ae670106d7d,20230719,TK-100,8,54,65,-11
6633cb8d8f483ae670106d7e,20221109,TK-101,7,1510394,1510401,-7
6633cb8d8f483ae670106d7f,20221110,TK-101,7,1942682,1942689,-7
6633cb8d8f483ae670106d80,20221111,TK-101,7,2857610,2857749,-139
6633cb8d8f483ae670106d81,20221112,TK-101,7,1999024,1998904,120
6633cb8d8f483ae670106d82,20221113,TK-101,7,93582,93582,0
6633cb8d8f483ae670106d83,20221114,TK-101,7,1307172,1307180,-8
6633cb8d8f483ae670106d84,20221213,TK-101,7,1248436,1248442,-6
6633cb8d8f483ae670106d85,20221214,TK-101,7,1488626,1488628,-2
6633cb8d8f483ae670106d86,20221215,TK-101,7,1267206,1267215,-9
6633cb8d8f483ae670106d87,20221216,TK-101,7,3330184,3330194,-10
6633cb8d8f483ae670106d88,20221217,TK-101,7,2728763,2728772,-9
6633cb8d8f483ae670106d89,20221218,TK-101,7,205464,205464,0
6633cb8d8f483ae670106d8a,20221230,TK-101,7,2462326,2462333,-7
6633cb8d8f483ae670106d8b,20221231,TK-101,7,1515577,1515584,-7
6633cb8d8f483ae670106d8c,20230101,TK-101,7,418765,418765,0
6633cb8d8f483ae670106d8d,20230109,TK-101,7,1695326,1695330,-4
6633cb8d8f483ae670106d8e,20230110,TK-101,7,2791976,2791984,-8
6633cb8d8f483ae670106d8f,20230111,TK-101,7,1656044,1656053,-9
6633cb8d8f483ae670106d90,20230112,TK-101,7,2291693,2291703,-10
6633cb8d8f483ae670106d91,20230324,TK-101,7,757803,757804,-1
6633cb8d8f483ae670106d92,20230326,TK-101,7,98709,98709,0
6633cb8d8f483ae670106d93,20230601,TK-101,7,2187075,2187082,-7
6633cb8d8f483ae670106d94,20230602,TK-101,7,3752184,3752199,-15
6633cb8d8f483ae670106d95,20230603,TK-101,7,1642284,1642293,-9
6633cb8d8f483ae670106d96,20230604,TK-101,7,98093,98093,0
6633cb8d8f483ae670106d97,20230605,TK-101,7,3137384,3137394,-10
6633cb8d8f483ae670106d98,20230606,TK-101,7,3169132,3169152,-20
6633cb8d8f483ae670106d99,20230607,TK-101,7,2909759,2909782,-23
6633cb8d8f483ae670106d9a,20230608,TK-101,7,2392897,2392913,-16
6633cb8d8f483ae670106d9b,20230627,TK-101,7,2808533,2808555,-22
6633cb8d8f483ae670106d9c,20230628,TK-101,7,3327620,3327658,-38
6633cb8d8f483ae670106d9d,20230630,TK-101,7,1031803,1031823,-20
6633cb8d8f483ae670106d9e,20230701,TK-101,7,1233298,1233323,-25
6633cb8d8f483ae670106d9f,20230702,TK-101,7,65177,65177,0
6633cb8d8f483ae670106da0,20230703,TK-101,7,2200518,2200542,-24
6633cb8d8f483ae670106da1,20230704,TK-101,7,3009854,3009878,-24
6633cb8d8f483ae670106da2,20230705,TK-101,7,2241921,2241945,-24
6633cb8d8f483ae670106da3,20230706,TK-101,7,2215906,2215928,-22
6633cb8d8f483ae670106da4,20230707,TK-101,7,2912851,2912878,-27
6633cb8d8f483ae670106da5,20230719,TK-101,7,25629,25629,0
6633cb8d8f483ae670106da6,20221021,TK-102,7,265149,265149,0
6633cb8d8f483ae670106da7,20221023,TK-102,7,224036,224036,0
6633cb8d8f483ae670106da8,20221025,TK-102,7,3041413,3041484,-71
6633cb8d8f483ae670106da9,20221026,TK-102,7,3489901,3489846,55
6633cb8d8f483ae670106daa,20221027,TK-102,7,3512493,3512503,-10
6633cb8d8f483ae670106dab,20221028,TK-102,7,3830051,3830062,-11
6633cb8d8f483ae670106dac,20221029,TK-102,7,3444688,3444700,-12
6633cb8d8f483ae670106dad,20221030,TK-102,7,214193,214193,0
6633cb8d8f483ae670106dae,20221031,TK-102,7,4484537,4484550,-13
6633cb8d8f483ae670106daf,20221101,TK-102,7,528276,528277,-1
6633cb8d8f483ae670106db0,20221218,TK-102,7,23945,23945,0
6633cb8d8f483ae670106db1,20221219,TK-102,7,3453513,3453521,-8
6633cb8d8f483ae670106db2,20221220,TK-102,7,3213967,3213977,-10
6633cb8d8f483ae670106db3,20221221,TK-102,7,2719751,2719762,-11
6633cb8d8f483ae670106db4,20221222,TK-102,7,2677760,2677821,-61
6633cb8d8f483ae670106db5,20221223,TK-102,7,3726745,3726701,44
6633cb8d8f483ae670106db6,20221224,TK-102,7,2146528,2146537,-9
6633cb8d8f483ae670106db7,20221225,TK-102,7,32966,32966,0
6633cb8d8f483ae670106db8,20221226,TK-102,7,2708908,2708915,-7
6633cb8d8f483ae670106db9,20221227,TK-102,7,2867611,2867622,-11
6633cb8d8f483ae670106dba,20221228,TK-102,7,2835264,2835273,-9
6633cb8d8f483ae670106dbb,20221229,TK-102,7,1121848,1121852,-4
6633cb8d8f483ae670106dbc,20230120,TK-102,7,1695502,1695508,-6
6633cb8d8f483ae670106dbd,20230121,TK-102,7,2393284,2393293,-9
6633cb8d8f483ae670106dbe,20230122,TK-102,7,160832,160832,0
6633cb8d8f483ae670106dbf,20230123,TK-102,7,2653294,2653304,-10
6633cb8d8f483ae670106dc0,20230124,TK-102,7,2761608,2761617,-9
6633cb8d8f483ae670106dc1,20230125,TK-102,7,2334458,2334464,-6
6633cb8d8f483ae670106dc2,20230126,TK-102,7,2389488,2389496,-8
6633cb8d8f483ae670106dc3,20230127,TK-102,7,2896404,2896409,-5
6633cb8d8f483ae670106dc4,20230128,TK-102,7,2172857,2172865,-8
6633cb8d8f483ae670106dc5,20230129,TK-102,7,113412,113412,0
6633cb8d8f483ae670106dc6,20230130,TK-102,7,271302,271302,0
6633cb8d8f483ae670106dc7,20230504,TK-102,7,4194751,4194769,-18
6633cb8d8f483ae670106dc8,20230505,TK-102,7,3098358,3098373,-15
6633cb8d8f483ae670106dc9,20230519,TK-102,7,32789,32789,0
6633cb8d8f483ae670106dca,20230520,TK-102,7,2507681,2507705,-24
6633cb8d8f483ae670106dcb,20230524,TK-102,7,2614404,2614754,-350
6633cb8d8f483ae670106dcc,20230526,TK-102,7,3435509,3435530,-21
6633cb8d8f483ae670106dcd,20230528,TK-102,7,127217,127217,0
6633cb8d8f483ae670106dce,20230529,TK-102,7,1774283,1774296,-13
6633cb8d8f483ae670106dcf,20221006,TK-103,7,982780,982783,-3
6633cb8d8f483ae670106dd0,20221013,TK-103,7,3670810,3670821,-11
6633cb8d8f483ae670106dd1,20221014,TK-103,7,4476661,4476673,-12
6633cb8d8f483ae670106dd2,20221206,TK-103,7,2380716,2380724,-8
6633cb8d8f483ae670106dd3,20221207,TK-103,7,3167403,3167412,-9
6633cb8d8f483ae670106dd4,20221208,TK-103,7,2456491,2456499,-8
6633cb8d8f483ae670106dd5,20221209,TK-103,7,2251583,2251588,-5
6633cb8d8f483ae670106dd6,20221210,TK-103,7,1820198,1820208,-10
6633cb8d8f483ae670106dd7,20221211,TK-103,7,149442,149442,0
6633cb8d8f483ae670106dd8,20221212,TK-103,7,1612188,1612197,-9
6633cb8d8f483ae670106dd9,20221229,TK-103,7,2028792,2028796,-4
6633cb8d8f483ae670106dda,20221230,TK-103,7,884391,884393,-2
6633cb8d8f483ae670106ddb,20230130,TK-103,7,2930854,2930862,-8
6633cb8d8f483ae670106ddc,20230131,TK-103,7,2546427,2546435,-8
6633cb8d8f483ae670106ddd,20230201,TK-103,7,2272210,2272218,-8
6633cb8d8f483ae670106dde,20230202,TK-103,7,2625108,2625115,-7
6633cb8d8f483ae670106ddf,20230203,TK-103,7,2735852,2735864,-12
6633cb8d8f483ae670106de0,20230204,TK-103,7,1956551,1956559,-8
6633cb8d8f483ae670106de1,20230205,TK-103,7,161098,161098,0
6633cb8d8f483ae670106de2,20230206,TK-103,7,2714945,2714952,-7
6633cb8d8f483ae670106de3,20230207,TK-103,7,2880619,2880628,-9
6633cb8d8f483ae670106de4,20230307,TK-103,7,1521920,1521922,-2
6633cb8d8f483ae670106de5,20230308,TK-103,7,2825816,2825822,-6
6633cb8d8f483ae670106de6,20230309,TK-103,7,3032059,3032069,-10
6633cb8d8f483ae670106de7,20230310,TK-103,7,3394398,3394408,-10
6633cb8d8f483ae670106de8,20230311,TK-103,7,2519456,2519466,-10
6633cb8d8f483ae670106de9,20230312,TK-103,7,141664,141664,0
6633cb8d8f483ae670106dea,20230313,TK-103,7,3317229,3317238,-9
6633cb8d8f483ae670106deb,20230314,TK-103,7,3335844,3335853,-9
6633cb8d8f483ae670106dec,20230315,TK-103,7,3790972,3790982,-10
6633cb8d8f483ae670106ded,20230316,TK-103,7,2674888,2674902,-14
6633cb8d8f483ae670106dee,20230317,TK-103,7,3468744,3468758,-14
6633cb8d8f483ae670106def,20230318,TK-103,7,2371335,2371341,-6
6633cb8d8f483ae670106df0,20230319,TK-103,7,61834,61834,0
6633cb8d8f483ae670106df1,20230320,TK-103,7,3394117,3394129,-12
6633cb8d8f483ae670106df2,20230321,TK-103,7,3049000,3049007,-7
6633cb8d8f483ae670106df3,20230322,TK-103,7,3239662,3239671,-9
6633cb8d8f483ae670106df4,20230323,TK-103,7,2497779,2497787,-8
6633cb8d8f483ae670106df5,20230324,TK-103,7,2376504,2376515,-11
6633cb8d8f483ae670106df6,20230328,TK-103,7,1998841,1998848,-7
6633cb8d8f483ae670106df7,20230329,TK-103,7,2123784,2123793,-9
6633cb8d8f483ae670106df8,20230330,TK-103,7,2145350,2145358,-8
6633cb8d8f483ae670106df9,20230331,TK-103,7,2000553,2000559,-6
6633cb8d8f483ae670106dfa,20230401,TK-103,7,2886084,2886092,-8
6633cb8d8f483ae670106dfb,20230402,TK-103,7,171301,171301,0
6633cb8d8f483ae670106dfc,20230403,TK-103,7,3521033,3521043,-10
6633cb8d8f483ae670106dfd,20230404,TK-103,7,3492546,3492558,-12
6633cb8d8f483ae670106dfe,20230407,TK-103,7,3289980,3289917,63
6633cb8d8f483ae670106dff,20230408,TK-103,7,2137849,2137861,-12
6633cb8d8f483ae670106e00,20230409,TK-103,7,63762,63762,0
6633cb8d8f483ae670106e01,20230410,TK-103,7,3051333,3051344,-11
6633cb8d8f483ae670106e02,20230411,TK-103,7,2503379,2503389,-10
6633cb8d8f483ae670106e03,20230412,TK-103,7,2921479,2921488,-9
6633cb8d8f483ae670106e04,20230417,TK-103,7,234801,234801,0
6633cb8d8f483ae670106e05,20230421,TK-103,7,1908353,1908362,-9
6633cb8d8f483ae670106e06,20230423,TK-103,7,229858,229858,0
6633cb8d8f483ae670106e07,20230424,TK-103,7,1671368,1671378,-10
6633cb8d8f483ae670106e08,20230425,TK-103,7,1742253,1742260,-7
6633cb8d8f483ae670106e09,20230426,TK-103,7,2522522,2522530,-8
6633cb8d8f483ae670106e0a,20230427,TK-103,7,2494260,2494268,-8
6633cb8d8f483ae670106e0b,20230428,TK-103,7,2796650,2796660,-10
6633cb8d8f483ae670106e0c,20230429,TK-103,7,2173812,2173823,-11
6633cb8d8f483ae670106e0d,20230430,TK-103,7,232398,232398,0
6633cb8d8f483ae670106e0e,20230501,TK-103,7,1437734,1437741,-7
6633cb8d8f483ae670106e0f,20230502,TK-103,7,3327832,3327842,-10
6633cb8d8f483ae670106e10,20230503,TK-103,7,4171393,4171404,-11
6633cb8d8f483ae670106e11,20230504,TK-103,7,61694,61694,0
6633cb8d8f483ae670106e12,20230531,TK-103,7,3807135,3807144,-9
6633cb8d8f483ae670106e13,20230601,TK-103,7,907584,907584,0
6633cb8d8f483ae670106e14,20230617,TK-103,7,2634269,2634307,-38
6633cb8d8f483ae670106e15,20230618,TK-103,7,65532,65532,0
6633cb8d8f483ae670106e16,20230619,TK-103,7,2370886,2371517,-631
6633cb8d8f483ae670106e17,20230620,TK-103,7,2553788,2553214,574
6633cb8d8f483ae670106e18,20230621,TK-103,7,2374911,2374935,-24
6633cb8d8f483ae670106e19,20230708,TK-103,7,2066639,2066665,-26
6633cb8d8f483ae670106e1a,20230709,TK-103,7,97886,97886,0
6633cb8d8f483ae670106e1b,20230710,TK-103,7,2806662,2806769,-107
6633cb8d8f483ae670106e1c,20230712,TK-103,7,83,0,83
6633cb8d8f483ae670106e1d,20230718,TK-103,7,3347161,3347195,-34
6633cb8d8f483ae670106e1e,20230719,TK-103,7,2320816,2320839,-23
6633cb8d8f483ae670106e1f,20221114,TK-104,7,805703,805703,0
6633cb8d8f483ae670106e20,20221115,TK-104,7,2069360,2069368,-8
6633cb8d8f483ae670106e21,20221116,TK-104,7,3167123,3167133,-10
6633cb8d8f483ae670106e22,20221117,TK-104,7,3326503,3326512,-9
6633cb8d8f483ae670106e23,20221118,TK-104,7,3250170,3250181,-11
6633cb8d8f483ae670106e24,20221119,TK-104,7,2246442,2246452,-10
6633cb8d8f483ae670106e25,20221120,TK-104,7,65849,65849,0
6633cb8d8f483ae670106e26,20221121,TK-104,7,3099607,3099618,-11
6633cb8d8f483ae670106e27,20221123,TK-104,7,2607683,2607641,42
6633cb8d8f483ae670106e28,20221124,TK-104,7,2405178,2405211,-33
6633cb8d8f483ae670106e29,20221125,TK-104,7,1690107,1690110,-3
6633cb8d8f483ae670106e2a,20221126,TK-104,7,16,0,16
6633cb8d8f483ae670106e2b,20230112,TK-104,7,64842,64842,0
6633cb8d8f483ae670106e2c,20230115,TK-104,7,98869,98869,0
6633cb8d8f483ae670106e2d,20230116,TK-104,7,2597893,2597899,-6
6633cb8d8f483ae670106e2e,20230119,TK-104,7,2757200,2757208,-8
6633cb8d8f483ae670106e2f,20230120,TK-104,7,1299190,1299198,-8
6633cb8d8f483ae670106e30,20230209,TK-104,7,505515,505515,0
6633cb8d8f483ae670106e31,20230210,TK-104,7,2742274,2742281,-7
6633cb8d8f483ae670106e32,20230211,TK-104,7,1825799,1825807,-8
6633cb8d8f483ae670106e33,20230212,TK-104,7,127006,127006,0
6633cb8d8f483ae670106e34,20230213,TK-104,7,2076167,2076173,-6
6633cb8d8f483ae670106e35,20230214,TK-104,7,1778541,1778550,-9
6633cb8d8f483ae670106e36,20230215,TK-104,7,2591770,2591774,-4
6633cb8d8f483ae670106e37,20230216,TK-104,7,3272169,3272179,-10
6633cb8d8f483ae670106e38,20230217,TK-104,7,3453842,3453853,-11
6633cb8d8f483ae670106e39,20230218,TK-104,7,2753355,2753360,-5
6633cb8d8f483ae670106e3a,20230219,TK-104,7,160893,160893,0
6633cb8d8f483ae670106e3b,20230222,TK-104,7,3089623,3089631,-8
6633cb8d8f483ae670106e3c,20230223,TK-104,7,2578431,2578439,-8
6633cb8d8f483ae670106e3d,20230224,TK-104,7,3017472,3017480,-8
6633cb8d8f483ae670106e3e,20230225,TK-104,7,2041160,2041166,-6
6633cb8d8f483ae670106e3f,20230226,TK-104,7,245186,245186,0
6633cb8d8f483ae670106e40,20230227,TK-104,7,1968121,1968125,-4
6633cb8d8f483ae670106e41,20230228,TK-104,7,1578864,1578870,-6
6633cb8d8f483ae670106e42,20230304,TK-104,7,3167648,3167655,-7
6633cb8d8f483ae670106e43,20230305,TK-104,7,234636,234636,0
6633cb8d8f483ae670106e44,20230306,TK-104,7,3390776,3390784,-8
6633cb8d8f483ae670106e45,20230307,TK-104,7,1418585,1418590,-5
6633cb8d8f483ae670106e46,20230413,TK-104,7,2680799,2680810,-11
6633cb8d8f483ae670106e47,20230414,TK-104,7,2528876,2528886,-10
6633cb8d8f483ae670106e48,20230415,TK-104,7,206677,206677,0
6633cb8d8f483ae670106e49,20230417,TK-104,7,1945977,1945987,-10
6633cb8d8f483ae670106e4a,20230418,TK-104,7,2786975,2786983,-8
6633cb8d8f483ae670106e4b,20230419,TK-104,7,3020928,3020941,-13
6633cb8d8f483ae670106e4c,20230420,TK-104,7,2807504,2807518,-14
6633cb8d8f483ae670106e4d,20230506,TK-104,7,3217712,3217730,-18
6633cb8d8f483ae670106e4e,20230507,TK-104,7,148955,148955,0
6633cb8d8f483ae670106e4f,20230508,TK-104,7,3222674,3222696,-22
6633cb8d8f483ae670106e50,20230509,TK-104,7,3410944,3410964,-20
6633cb8d8f483ae670106e51,20230510,TK-104,7,3225986,3226011,-25
6633cb8d8f483ae670106e52,20230511,TK-104,7,3308565,3308588,-23
6633cb8d8f483ae670106e53,20230512,TK-104,7,2714727,2714749,-22
6633cb8d8f483ae670106e54,20230529,TK-104,7,1449527,1449539,-12
6633cb8d8f483ae670106e55,20230603,TK-104,7,884221,884226,-5
6633cb8d8f483ae670106e56,20230609,TK-104,7,2533525,2533549,-24
6633cb8d8f483ae670106e57,20230621,TK-104,7,455260,455260,0
6633cb8d8f483ae670106e58,20230622,TK-104,7,2858961,2858985,-24
6633cb8d8f483ae670106e59,20230623,TK-104,7,3384266,3384280,-14
6633cb8d8f483ae670106e5a,20230624,TK-104,7,2732941,2732949,-8
6633cb8d8f483ae670106e5b,20230625,TK-104,7,261984,261984,0
6633cb8d8f483ae670106e5c,20230626,TK-104,7,3646372,3646397,-25
6633cb8d8f483ae670106e5d,20221012,TK-105,4,645572,645575,-3
6633cb8d8f483ae670106e5e,20221013,TK-105,4,704826,704834,-8
6633cb8d8f483ae670106e5f,20221014,TK-105,4,441378,441383,-5
6633cb8d8f483ae670106e60,20221015,TK-105,4,505046,505048,-2
6633cb8d8f483ae670106e61,20221016,TK-105,4,30775,30775,0
6633cb8d8f483ae670106e62,20221017,TK-105,4,437313,437314,-1
6633cb8d8f483ae670106e63,20221018,TK-105,4,572269,572271,-2
6633cb8d8f483ae670106e64,20221019,TK-105,4,198312,198314,-2
6633cb8d8f483ae670106e65,20221020,TK-105,4,143804,143804,0
6633cb8d8f483ae670106e66,20221021,TK-105,4,369883,369887,-4
6633cb8d8f483ae670106e67,20221023,TK-105,4,32741,32741,0
6633cb8d8f483ae670106e68,20221025,TK-105,4,326371,326375,-4
6633cb8d8f483ae670106e69,20221026,TK-105,4,431322,431327,-5
6633cb8d8f483ae670106e6a,20221223,TK-105,4,502704,502707,-3
6633cb8d8f483ae670106e6b,20221224,TK-105,4,223320,223324,-4
6633cb8d8f483ae670106e6c,20221225,TK-105,4,163578,163788,-210
6633cb8d8f483ae670106e6d,20221226,TK-105,4,464819,464613,206
6633cb8d8f483ae670106e6e,20221227,TK-105,4,374858,374860,-2
6633cb8d8f483ae670106e6f,20221228,TK-105,4,388763,388767,-4
6633cb8d8f483ae670106e70,20221229,TK-105,4,337046,337053,-7
6633cb8d8f483ae670106e71,20230101,TK-105,4,63968,63968,0
6633cb8d8f483ae670106e72,20230102,TK-105,4,582510,582514,-4
6633cb8d8f483ae670106e73,20230307,TK-105,4,189693,189693,0
6633cb8d8f483ae670106e74,20230308,TK-105,4,361725,361728,-3
6633cb8d8f483ae670106e75,20230309,TK-105,4,415298,415302,-4
6633cb8d8f483ae670106e76,20230310,TK-105,4,387375,387382,-7
6633cb8d8f483ae670106e77,20230311,TK-105,4,194160,194165,-5
6633cb8d8f483ae670106e78,20230312,TK-105,4,85609,85609,0
6633cb8d8f483ae670106e79,20230313,TK-105,4,411462,411558,-96
6633cb8d8f483ae670106e7a,20230314,TK-105,4,441458,442093,-635
6633cb8d8f483ae670106e7b,20230315,TK-105,4,393196,392924,272
6633cb8d8f483ae670106e7c,20230316,TK-105,4,304939,304496,443
6633cb8d8f483ae670106e7d,20230317,TK-105,4,410563,410567,-4
6633cb8d8f483ae670106e7e,20230318,TK-105,4,186092,186095,-3
6633cb8d8f483ae670106e7f,20230319,TK-105,4,184222,184222,0
6633cb8d8f483ae670106e80,20230320,TK-105,4,382186,382191,-5
6633cb8d8f483ae670106e81,20230321,TK-105,4,462898,462901,-3
6633cb8d8f483ae670106e82,20230322,TK-105,4,240395,240410,-15
6633cb8d8f483ae670106e83,20230323,TK-105,4,277531,277544,-13
6633cb8d8f483ae670106e84,20230324,TK-105,4,200991,201003,-12
6633cb8d8f483ae670106e85,20230523,TK-105,4,330987,331002,-15
6633cb8d8f483ae670106e86,20230524,TK-105,4,358107,358121,-14
6633cb8d8f483ae670106e87,20230525,TK-105,4,198043,198053,-10
6633cb8d8f483ae670106e88,20230526,TK-105,4,393917,393935,-18
6633cb8d8f483ae670106e89,20230527,TK-105,4,308103,308121,-18
6633cb8d8f483ae670106e8a,20230528,TK-105,4,128515,128515,0
6633cb8d8f483ae670106e8b,20230529,TK-105,4,365457,365471,-14
6633cb8d8f483ae670106e8c,20230530,TK-105,4,462097,462109,-12
6633cb8d8f483ae670106e8d,20230531,TK-105,4,443041,443057,-16
6633cb8d8f483ae670106e8e,20230601,TK-105,4,426010,426028,-18
6633cb8d8f483ae670106e8f,20230602,TK-105,4,521226,521244,-18
6633cb8d8f483ae670106e90,20230603,TK-105,4,233285,233305,-20
6633cb8d8f483ae670106e91,20230604,TK-105,4,128513,128513,0
6633cb8d8f483ae670106e92,20230605,TK-105,4,308369,308381,-12
6633cb8d8f483ae670106e93,20230606,TK-105,4,428092,428103,-11
6633cb8d8f483ae670106e94,20230607,TK-105,4,335429,335446,-17
6633cb8d8f483ae670106e95,20230608,TK-105,4,318038,318051,-13
6633cb8d8f483ae670106e96,20230609,TK-105,4,425034,425048,-14
6633cb8d8f483ae670106e97,20230610,TK-105,4,184034,184048,-14
6633cb8d8f483ae670106e98,20230611,TK-105,4,135162,135162,0
6633cb8d8f483ae670106e99,20230612,TK-105,4,342704,342714,-10
6633cb8d8f483ae670106e9a,20210929,TK-106,4,440292,440298,-6
6633cb8d8f483ae670106e9b,20210930,TK-106,4,429871,429875,-4
6633cb8d8f483ae670106e9c,20211001,TK-106,4,322187,322193,-6
6633cb8d8f483ae670106e9d,20211002,TK-106,4,217541,217545,-4
6633cb8d8f483ae670106e9e,20211003,TK-106,4,32600,32600,0
6633cb8d8f483ae670106e9f,20211004,TK-106,4,466398,466405,-7
6633cb8d8f483ae670106ea0,20211007,TK-106,4,429430,429436,-6
6633cb8d8f483ae670106ea1,20211008,TK-106,4,455901,455909,-8
6633cb8d8f483ae670106ea2,20211009,TK-106,4,269825,269831,-6
6633cb8d8f483ae670106ea3,20211010,TK-106,4,128609,128620,-11
6633cb8d8f483ae670106ea4,20211011,TK-106,4,539735,539740,-5
6633cb8d8f483ae670106ea5,20211012,TK-106,4,425318,425309,9
6633cb8d8f483ae670106ea6,20211017,TK-106,4,119904,119904,0
6633cb8d8f483ae670106ea7,20211018,TK-106,4,564842,564845,-3
6633cb8d8f483ae670106ea8,20211019,TK-106,4,221679,221685,-6
6633cb8d8f483ae670106ea9,20211020,TK-106,4,247437,247440,-3
6633cb8d8f483ae670106eaa,20211021,TK-106,4,431679,431685,-6
6633cb8d8f483ae670106eab,20211022,TK-106,4,399711,399717,-6
6633cb8d8f483ae670106eac,20211023,TK-106,4,283541,283544,-3
6633cb8d8f483ae670106ead,20211024,TK-106,4,149046,149046,0
6633cb8d8f483ae670106eae,20211025,TK-106,4,461963,461972,-9
6633cb8d8f483ae670106eaf,20211026,TK-106,4,485451,485459,-8
6633cb8d8f483ae670106eb0,20211029,TK-106,4,441406,441409,-3
6633cb8d8f483ae670106eb1,20211030,TK-106,4,374182,374187,-5
6633cb8d8f483ae670106eb2,20211031,TK-106,4,83181,83181,0
6633cb8d8f483ae670106eb3,20211101,TK-106,4,411178,411183,-5
6633cb8d8f483ae670106eb4,20211102,TK-106,4,425747,425753,-6
6633cb8d8f483ae670106eb5,20211103,TK-106,4,329978,329982,-4
6633cb8d8f483ae670106eb6,20211104,TK-106,4,329646,329650,-4
6633cb8d8f483ae670106eb7,20211107,TK-106,4,129818,129782,36
6633cb8d8f483ae670106eb8,20211108,TK-106,4,465339,465342,-3
6633cb8d8f483ae670106eb9,20211109,TK-106,4,272686,272688,-2
6633cb8d8f483ae670106eba,20211110,TK-106,4,310671,310676,-5
6633cb8d8f483ae670106ebb,20211111,TK-106,4,364229,364234,-5
6633cb8d8f483ae670106ebc,20211112,TK-106,4,521412,521420,-8
6633cb8d8f483ae670106ebd,20211114,TK-106,4,148133,148133,0
6633cb8d8f483ae670106ebe,20211116,TK-106,4,364308,364312,-4
6633cb8d8f483ae670106ebf,20211117,TK-106,4,534716,534722,-6
6633cb8d8f483ae670106ec0,20211118,TK-106,4,340005,340008,-3
6633cb8d8f483ae670106ec1,20211119,TK-106,4,582111,582117,-6
6633cb8d8f483ae670106ec2,20211120,TK-106,4,232939,232943,-4
6633cb8d8f483ae670106ec3,20211121,TK-106,4,170635,170635,0
6633cb8d8f483ae670106ec4,20211122,TK-106,4,525126,525133,-7
6633cb8d8f483ae670106ec5,20211123,TK-106,4,359267,359273,-6
6633cb8d8f483ae670106ec6,20211124,TK-106,4,412679,412684,-5
6633cb8d8f483ae670106ec7,20211125,TK-106,4,344044,344048,-4
6633cb8d8f483ae670106ec8,20211126,TK-106,4,471839,471848,-9
6633cb8d8f483ae670106ec9,20211127,TK-106,4,220824,220829,-5
6633cb8d8f483ae670106eca,20211128,TK-106,4,96133,96133,0
6633cb8d8f483ae670106ecb,20211129,TK-106,4,250902,250905,-3
6633cb8d8f483ae670106ecc,20211130,TK-106,4,271513,271517,-4
6633cb8d8f483ae670106ecd,20211201,TK-106,4,431750,431759,-9
6633cb8d8f483ae670106ece,20211202,TK-106,4,468575,468577,-2
6633cb8d8f483ae670106ecf,20211204,TK-106,4,299682,299689,-7
6633cb8d8f483ae670106ed0,20211205,TK-106,4,107013,107013,0
6633cb8d8f483ae670106ed1,20211207,TK-106,4,313694,313699,-5
6633cb8d8f483ae670106ed2,20211208,TK-106,4,328471,328476,-5
6633cb8d8f483ae670106ed3,20211209,TK-106,4,360891,360894,-3
6633cb8d8f483ae670106ed4,20211210,TK-106,4,336374,336383,-9
6633cb8d8f483ae670106ed5,20211211,TK-106,4,274302,274305,-3
6633cb8d8f483ae670106ed6,20211212,TK-106,4,168671,168671,0
6633cb8d8f483ae670106ed7,20211213,TK-106,4,312219,312223,-4
6633cb8d8f483ae670106ed8,20211214,TK-106,4,189402,189407,-5
6633cb8d8f483ae670106ed9,20211215,TK-106,4,201175,201179,-4
6633cb8d8f483ae670106eda,20211216,TK-106,4,290333,290336,-3
6633cb8d8f483ae670106edb,20211217,TK-106,4,292068,292076,-8
6633cb8d8f483ae670106edc,20211218,TK-106,4,292998,293005,-7
6633cb8d8f483ae670106edd,20211219,TK-106,4,148788,148788,0
6633cb8d8f483ae670106ede,20211220,TK-106,4,446952,446957,-5
6633cb8d8f483ae670106edf,20211221,TK-106,4,705279,705285,-6
6633cb8d8f483ae670106ee0,20211222,TK-106,4,645119,645126,-7
6633cb8d8f483ae670106ee1,20211223,TK-106,4,770017,770023,-6
6633cb8d8f483ae670106ee2,20211224,TK-106,4,754439,754446,-7
6633cb8d8f483ae670106ee3,20211225,TK-106,4,255083,255089,-6
6633cb8d8f483ae670106ee4,20211226,TK-106,4,134619,134619,0
6633cb8d8f483ae670106ee5,20211227,TK-106,4,576707,576716,-9
6633cb8d8f483ae670106ee6,20211228,TK-106,4,409291,409298,-7
6633cb8d8f483ae670106ee7,20211229,TK-106,4,494543,494547,-4
6633cb8d8f483ae670106ee8,20211230,TK-106,4,457927,457935,-8
6633cb8d8f483ae670106ee9,20211231,TK-106,4,379071,379078,-7
6633cb8d8f483ae670106eea,20220102,TK-106,4,143078,143078,0
6633cb8d8f483ae670106eeb,20220104,TK-106,4,464459,464464,-5
6633cb8d8f483ae670106eec,20220105,TK-106,4,413876,413882,-6
6633cb8d8f483ae670106eed,20220106,TK-106,4,387829,387836,-7
6633cb8d8f483ae670106eee,20220107,TK-106,4,427741,427747,-6
6633cb8d8f483ae670106eef,20220108,TK-106,4,209874,209878,-4
6633cb8d8f483ae670106ef0,20220109,TK-106,4,71156,71156,0
6633cb8d8f483ae670106ef1,20220110,TK-106,4,425664,425667,-3
6633cb8d8f483ae670106ef2,20220111,TK-106,4,242884,242888,-4
6633cb8d8f483ae670106ef3,20220112,TK-106,4,267577,267583,-6
6633cb8d8f483ae670106ef4,20220113,TK-106,4,352494,352497,-3
6633cb8d8f483ae670106ef5,20220114,TK-106,4,331882,331888,-6
6633cb8d8f483ae670106ef6,20220115,TK-106,4,343708,343711,-3
6633cb8d8f483ae670106ef7,20220116,TK-106,4,66830,66830,0
6633cb8d8f483ae670106ef8,20220117,TK-106,4,300776,300781,-5
6633cb8d8f483ae670106ef9,20220118,TK-106,4,269663,269667,-4
6633cb8d8f483ae670106efa,20220119,TK-106,4,335868,335872,-4
6633cb8d8f483ae670106efb,20220120,TK-106,4,246879,246884,-5
6633cb8d8f483ae670106efc,20220121,TK-106,4,291692,291699,-7
6633cb8d8f483ae670106efd,20220122,TK-106,4,226817,226822,-5
6633cb8d8f483ae670106efe,20220123,TK-106,4,78932,78932,0
6633cb8d8f483ae670106eff,20220124,TK-106,4,328870,328875,-5
6633cb8d8f483ae670106f00,20220125,TK-106,4,277178,277181,-3
6633cb8d8f483ae670106f01,20220126,TK-106,4,276822,276830,-8
6633cb8d8f483ae670106f02,20220127,TK-106,4,289534,289542,-8
6633cb8d8f483ae670106f03,20220128,TK-106,4,369360,369372,-12
6633cb8d8f483ae670106f04,20220129,TK-106,4,277363,277376,-13
6633cb8d8f483ae670106f05,20220130,TK-106,4,129839,129839,0
6633cb8d8f483ae670106f06,20220201,TK-106,4,320403,320410,-7
6633cb8d8f483ae670106f07,20220202,TK-106,4,249484,249495,-11
6633cb8d8f483ae670106f08,20220203,TK-106,4,302784,302798,-14
6633cb8d8f483ae670106f09,20220205,TK-106,4,232516,232526,-10
6633cb8d8f483ae670106f0a,20220206,TK-106,4,75864,75864,0
6633cb8d8f483ae670106f0b,20220207,TK-106,4,397102,397110,-8
6633cb8d8f483ae670106f0c,20220208,TK-106,4,277409,277417,-8
6633cb8d8f483ae670106f0d,20220209,TK-106,4,325320,325333,-13
6633cb8d8f483ae670106f0e,20220210,TK-106,4,343258,343270,-12
6633cb8d8f483ae670106f0f,20220211,TK-106,4,357487,357496,-9
6633cb8d8f483ae670106f10,20220213,TK-106,4,102686,102686,0
6633cb8d8f483ae670106f11,20220215,TK-106,4,359464,359476,-12
6633cb8d8f483ae670106f12,20220216,TK-106,4,383564,383580,-16
6633cb8d8f483ae670106f13,20220217,TK-106,4,372357,372366,-9
6633cb8d8f483ae670106f14,20220218,TK-106,4,321082,321093,-11
6633cb8d8f483ae670106f15,20220219,TK-106,4,264479,264487,-8
6633cb8d8f483ae670106f16,20220220,TK-106,4,115024,115024,0
6633cb8d8f483ae670106f17,20220221,TK-106,4,325947,325952,-5
6633cb8d8f483ae670106f18,20220222,TK-106,4,229444,229447,-3
6633cb8d8f483ae670106f19,20220223,TK-106,4,331022,331027,-5
6633cb8d8f483ae670106f1a,20220224,TK-106,4,311343,311347,-4
6633cb8d8f483ae670106f1b,20220225,TK-106,4,462385,462392,-7
6633cb8d8f483ae670106f1c,20220226,TK-106,4,319774,319778,-4
6633cb8d8f483ae670106f1d,20220227,TK-106,4,135356,135356,0
6633cb8d8f483ae670106f1e,20220228,TK-106,4,462194,462317,-123
6633cb8d8f483ae670106f1f,20220301,TK-106,4,392524,392409,115
6633cb8d8f483ae670106f20,20220302,TK-106,4,369174,369181,-7
6633cb8d8f483ae670106f21,20220303,TK-106,4,411863,411866,-3
6633cb8d8f483ae670106f22,20220304,TK-106,4,473733,473738,-5
6633cb8d8f483ae670106f23,20220305,TK-106,4,297556,297560,-4
6633cb8d8f483ae670106f24,20220306,TK-106,4,137125,137125,0
6633cb8d8f483ae670106f25,20220307,TK-106,4,473534,473538,-4
6633cb8d8f483ae670106f26,20220308,TK-106,4,423108,423112,-4
6633cb8d8f483ae670106f27,20220309,TK-106,4,405017,405021,-4
6633cb8d8f483ae670106f28,20220310,TK-106,4,492895,492898,-3
6633cb8d8f483ae670106f29,20220311,TK-106,4,481173,481179,-6
6633cb8d8f483ae670106f2a,20220312,TK-106,4,348152,348160,-8
6633cb8d8f483ae670106f2b,20220313,TK-106,4,37887,37887,0
6633cb8d8f483ae670106f2c,20220314,TK-106,4,544598,544605,-7
6633cb8d8f483ae670106f2d,20220315,TK-106,4,461489,461497,-8
6633cb8d8f483ae670106f2e,20220316,TK-106,4,461016,461024,-8
6633cb8d8f483ae670106f2f,20220317,TK-106,4,367430,367434,-4
6633cb8d8f483ae670106f30,20220318,TK-106,4,402923,402930,-7
6633cb8d8f483ae670106f31,20220319,TK-106,4,240342,240349,-7
6633cb8d8f483ae670106f32,20220320,TK-106,4,119912,119912,0
6633cb8d8f483ae670106f33,20220321,TK-106,4,455006,455109,-103
6633cb8d8f483ae670106f34,20220322,TK-106,4,353076,352983,93
6633cb8d8f483ae670106f35,20220323,TK-106,4,331020,331027,-7
6633cb8d8f483ae670106f36,20220324,TK-106,4,384419,384425,-6
6633cb8d8f483ae670106f37,20220325,TK-106,4,275998,275999,-1
6633cb8d8f483ae670106f38,20220326,TK-106,4,212579,212581,-2
6633cb8d8f483ae670106f39,20220328,TK-106,4,425094,425100,-6
6633cb8d8f483ae670106f3a,20220329,TK-106,4,321139,321143,-4
6633cb8d8f483ae670106f3b,20220330,TK-106,4,339165,339171,-6
6633cb8d8f483ae670106f3c,20220331,TK-106,4,399061,399064,-3
6633cb8d8f483ae670106f3d,20220401,TK-106,4,317035,317039,-4
6633cb8d8f483ae670106f3e,20220402,TK-106,4,213464,213470,-6
6633cb8d8f483ae670106f3f,20220403,TK-106,4,5001,5001,0
6633cb8d8f483ae670106f40,20220404,TK-106,4,131406,131406,0
6633cb8d8f483ae670106f41,20220405,TK-106,4,275761,275765,-4
6633cb8d8f483ae670106f42,20220408,TK-106,4,335096,335101,-5
6633cb8d8f483ae670106f43,20220409,TK-106,4,192577,192582,-5
6633cb8d8f483ae670106f44,20220410,TK-106,4,62772,62772,0
6633cb8d8f483ae670106f45,20220411,TK-106,4,318849,318852,-3
6633cb8d8f483ae670106f46,20220412,TK-106,4,211311,211314,-3
6633cb8d8f483ae670106f47,20220413,TK-106,4,231200,231203,-3
6633cb8d8f483ae670106f48,20220414,TK-106,4,190122,190126,-4
6633cb8d8f483ae670106f49,20220415,TK-106,4,348366,348370,-4
6633cb8d8f483ae670106f4a,20220416,TK-106,4,249734,249739,-5
6633cb8d8f483ae670106f4b,20220417,TK-106,4,66223,66223,0
6633cb8d8f483ae670106f4c,20220418,TK-106,4,434315,434321,-6
6633cb8d8f483ae670106f4d,20220421,TK-106,4,780751,780760,-9
6633cb8d8f483ae670106f4e,20220422,TK-106,4,195315,195319,-4
6633cb8d8f483ae670106f4f,20220423,TK-106,4,68777,68777,0
6633cb8d8f483ae670106f50,20220424,TK-106,4,449043,449049,-6
6633cb8d8f483ae670106f51,20220425,TK-106,4,355151,355154,-3
6633cb8d8f483ae670106f52,20220426,TK-106,4,480459,480463,-4
6633cb8d8f483ae670106f53,20220427,TK-106,4,476539,476546,-7
6633cb8d8f483ae670106f54,20220428,TK-106,4,469440,469446,-6
6633cb8d8f483ae670106f55,20220429,TK-106,4,347835,347840,-5
6633cb8d8f483ae670106f56,20220501,TK-106,4,73396,73396,0
6633cb8d8f483ae670106f57,20220503,TK-106,4,304342,304346,-4
6633cb8d8f483ae670106f58,20220504,TK-106,4,388396,388401,-5
6633cb8d8f483ae670106f59,20220505,TK-106,4,492728,492807,-79
6633cb8d8f483ae670106f5a,20220506,TK-106,4,503648,503721,-73
6633cb8d8f483ae670106f5b,20220507,TK-106,4,324072,323941,131
6633cb8d8f483ae670106f5c,20220508,TK-106,4,145524,145524,0
6633cb8d8f483ae670106f5d,20220509,TK-106,4,578338,578345,-7
6633cb8d8f483ae670106f5e,20220510,TK-106,4,447395,447400,-5
6633cb8d8f483ae670106f5f,20220511,TK-106,4,528076,528082,-6
6633cb8d8f483ae670106f60,20220512,TK-106,4,482510,482514,-4
6633cb8d8f483ae670106f61,20220513,TK-106,4,538493,538500,-7
6633cb8d8f483ae670106f62,20220514,TK-106,4,410042,410048,-6
6633cb8d8f483ae670106f63,20220515,TK-106,4,88163,88163,0
6633cb8d8f483ae670106f64,20220516,TK-106,4,402427,402434,-7
6633cb8d8f483ae670106f65,20220517,TK-106,4,515478,515486,-8
6633cb8d8f483ae670106f66,20220520,TK-106,4,404427,404433,-6
6633cb8d8f483ae670106f67,20220521,TK-106,4,242333,242339,-6
6633cb8d8f483ae670106f68,20220522,TK-106,4,129794,129794,0
6633cb8d8f483ae670106f69,20220523,TK-106,4,510046,510054,-8
6633cb8d8f483ae670106f6a,20220524,TK-106,4,361802,361806,-4
6633cb8d8f483ae670106f6b,20220525,TK-106,4,399502,399508,-6
6633cb8d8f483ae670106f6c,20220526,TK-106,4,420290,420295,-5
6633cb8d8f483ae670106f6d,20220527,TK-106,4,551393,551397,-4
6633cb8d8f483ae670106f6e,20220528,TK-106,4,200628,200632,-4
6633cb8d8f483ae670106f6f,20220529,TK-106,4,63423,63423,0
6633cb8d8f483ae670106f70,20220530,TK-106,4,522912,522917,-5
6633cb8d8f483ae670106f71,20220531,TK-106,4,332431,332435,-4
6633cb8d8f483ae670106f72,20220601,TK-106,4,665501,665506,-5
6633cb8d8f483ae670106f73,20220602,TK-106,4,434847,434852,-5
6633cb8d8f483ae670106f74,20220603,TK-106,4,500496,500541,-45
6633cb8d8f483ae670106f75,20220604,TK-106,4,255431,255398,33
6633cb8d8f483ae670106f76,20220605,TK-106,4,99728,99728,0
6633cb8d8f483ae670106f77,20220606,TK-106,4,618860,618864,-4
6633cb8d8f483ae670106f78,20220607,TK-106,4,529444,529451,-7
6633cb8d8f483ae670106f79,20220608,TK-106,4,472937,472942,-5
6633cb8d8f483ae670106f7a,20220609,TK-106,4,339563,339570,-7
6633cb8d8f483ae670106f7b,20220610,TK-106,4,526823,526829,-6
6633cb8d8f483ae670106f7c,20220611,TK-106,4,292354,292363,-9
6633cb8d8f483ae670106f7d,20220612,TK-106,4,131318,131318,0
6633cb8d8f483ae670106f7e,20220613,TK-106,4,595823,595829,-6
6633cb8d8f483ae670106f7f,20220614,TK-106,4,577765,577770,-5
6633cb8d8f483ae670106f80,20220615,TK-106,4,372232,372238,-6
6633cb8d8f483ae670106f81,20220616,TK-106,4,334467,334470,-3
6633cb8d8f483ae670106f82,20220617,TK-106,4,454595,454599,-4
6633cb8d8f483ae670106f83,20220618,TK-106,4,291704,291711,-7
6633cb8d8f483ae670106f84,20220619,TK-106,4,66064,66064,0
6633cb8d8f483ae670106f85,20220623,TK-106,4,386202,386207,-5
6633cb8d8f483ae670106f86,20220624,TK-106,4,388105,388111,-6
6633cb8d8f483ae670106f87,20220625,TK-106,4,254182,254185,-3
6633cb8d8f483ae670106f88,20220626,TK-106,4,98939,98939,0
6633cb8d8f483ae670106f89,20220627,TK-106,4,381675,381681,-6
6633cb8d8f483ae670106f8a,20220628,TK-106,4,364677,364681,-4
6633cb8d8f483ae670106f8b,20220630,TK-106,4,313260,313268,-8
6633cb8d8f483ae670106f8c,20220702,TK-106,4,300830,300837,-7
6633cb8d8f483ae670106f8d,20220703,TK-106,4,65169,65169,0
6633cb8d8f483ae670106f8e,20220704,TK-106,4,393978,393985,-7
6633cb8d8f483ae670106f8f,20220706,TK-106,4,402678,402688,-10
6633cb8d8f483ae670106f90,20220707,TK-106,4,578689,578697,-8
6633cb8d8f483ae670106f91,20220708,TK-106,4,518285,518294,-9
6633cb8d8f483ae670106f92,20220709,TK-106,4,254505,254511,-6
6633cb8d8f483ae670106f93,20220711,TK-106,4,125112,125114,-2
6633cb8d8f483ae670106f94,20220712,TK-106,4,213834,213840,-6
6633cb8d8f483ae670106f95,20220713,TK-106,4,315859,315861,-2
6633cb8d8f483ae670106f96,20220714,TK-106,4,266666,266668,-2
6633cb8d8f483ae670106f97,20220715,TK-106,4,450769,450777,-8
6633cb8d8f483ae670106f98,20220716,TK-106,4,530354,530370,-16
6633cb8d8f483ae670106f99,20220717,TK-106,4,132703,132703,0
6633cb8d8f483ae670106f9a,20220718,TK-106,4,662462,662475,-13
6633cb8d8f483ae670106f9b,20220719,TK-106,4,447606,447618,-12
6633cb8d8f483ae670106f9c,20220720,TK-106,4,572344,572360,-16
6633cb8d8f483ae670106f9d,20220721,TK-106,4,499251,499256,-5
6633cb8d8f483ae670106f9e,20220722,TK-106,4,490889,490900,-11
6633cb8d8f483ae670106f9f,20220723,TK-106,4,451342,451354,-12
6633cb8d8f483ae670106fa0,20220724,TK-106,4,79893,79893,0
6633cb8d8f483ae670106fa1,20220725,TK-106,4,463835,463844,-9
6633cb8d8f483ae670106fa2,20220726,TK-106,4,360194,360203,-9
6633cb8d8f483ae670106fa3,20220727,TK-106,4,451426,451437,-11
6633cb8d8f483ae670106fa4,20220728,TK-106,4,442423,442430,-7
6633cb8d8f483ae670106fa5,20220729,TK-106,4,516708,516721,-13
6633cb8d8f483ae670106fa6,20220730,TK-106,4,267549,267560,-11
6633cb8d8f483ae670106fa7,20220731,TK-106,4,158755,158755,0
6633cb8d8f483ae670106fa8,20220801,TK-106,4,422085,422093,-8
6633cb8d8f483ae670106fa9,20220802,TK-106,4,488720,488730,-10
6633cb8d8f483ae670106faa,20220803,TK-106,4,766103,766118,-15
6633cb8d8f483ae670106fab,20220804,TK-106,4,358576,358589,-13
6633cb8d8f483ae670106fac,20220807,TK-106,4,112146,112148,-2
6633cb8d8f483ae670106fad,20220808,TK-106,4,494742,494756,-14
6633cb8d8f483ae670106fae,20220809,TK-106,4,425609,425654,-45
6633cb8d8f483ae670106faf,20220810,TK-106,4,403989,403965,24
6633cb8d8f483ae670106fb0,20220811,TK-106,4,576150,576164,-14
6633cb8d8f483ae670106fb1,20220812,TK-106,4,471849,471858,-9
6633cb8d8f483ae670106fb2,20220813,TK-106,4,435969,435981,-12
6633cb8d8f483ae670106fb3,20220814,TK-106,4,165425,165428,-3
6633cb8d8f483ae670106fb4,20220815,TK-106,4,452427,452441,-14
6633cb8d8f483ae670106fb5,20220816,TK-106,4,671732,671746,-14
6633cb8d8f483ae670106fb6,20220817,TK-106,4,516486,516499,-13
6633cb8d8f483ae670106fb7,20220818,TK-106,4,518131,518141,-10
6633cb8d8f483ae670106fb8,20220819,TK-106,4,581071,581080,-9
6633cb8d8f483ae670106fb9,20220820,TK-106,4,408761,408776,-15
6633cb8d8f483ae670106fba,20220821,TK-106,4,76726,76728,-2
6633cb8d8f483ae670106fbb,20220822,TK-106,4,425119,425132,-13
6633cb8d8f483ae670106fbc,20220823,TK-106,4,680219,680232,-13
6633cb8d8f483ae670106fbd,20220824,TK-106,4,431817,431823,-6
6633cb8d8f483ae670106fbe,20220825,TK-106,4,501931,501939,-8
6633cb8d8f483ae670106fbf,20220826,TK-106,4,404737,404748,-11
6633cb8d8f483ae670106fc0,20220827,TK-106,4,307173,307185,-12
6633cb8d8f483ae670106fc1,20220828,TK-106,4,101497,101499,-2
6633cb8d8f483ae670106fc2,20220829,TK-106,4,381098,381105,-7
6633cb8d8f483ae670106fc3,20220830,TK-106,4,366707,366716,-9
6633cb8d8f483ae670106fc4,20220831,TK-106,4,335872,335878,-6
6633cb8d8f483ae670106fc5,20220901,TK-106,4,277210,277214,-4
6633cb8d8f483ae670106fc6,20220904,TK-106,4,150050,150050,0
6633cb8d8f483ae670106fc7,20220905,TK-106,4,482774,482782,-8
6633cb8d8f483ae670106fc8,20220906,TK-106,4,550897,550941,-44
6633cb8d8f483ae670106fc9,20220907,TK-106,4,511219,511223,-4
6633cb8d8f483ae670106fca,20220908,TK-106,4,561794,561801,-7
6633cb8d8f483ae670106fcb,20220909,TK-106,4,413270,413236,34
6633cb8d8f483ae670106fcc,20220910,TK-106,4,306831,306839,-8
6633cb8d8f483ae670106fcd,20220911,TK-106,4,64830,64830,0
6633cb8d8f483ae670106fce,20220912,TK-106,4,450096,450100,-4
6633cb8d8f483ae670106fcf,20220913,TK-106,4,471710,471717,-7
6633cb8d8f483ae670106fd0,20220914,TK-106,4,297966,297975,-9
6633cb8d8f483ae670106fd1,20220915,TK-106,4,271845,271849,-4
6633cb8d8f483ae670106fd2,20220918,TK-106,4,80867,80867,0
6633cb8d8f483ae670106fd3,20220920,TK-106,4,597279,597288,-9
6633cb8d8f483ae670106fd4,20220921,TK-106,4,604765,604772,-7
6633cb8d8f483ae670106fd5,20220922,TK-106,4,664056,664061,-5
6633cb8d8f483ae670106fd6,20220923,TK-106,4,653086,653092,-6
6633cb8d8f483ae670106fd7,20220924,TK-106,4,289377,289382,-5
6633cb8d8f483ae670106fd8,20220925,TK-106,4,65408,65408,0
6633cb8d8f483ae670106fd9,20220926,TK-106,4,586510,586515,-5
6633cb8d8f483ae670106fda,20220927,TK-106,4,384524,384529,-5
6633cb8d8f483ae670106fdb,20220929,TK-106,4,382144,382147,-3
6633cb8d8f483ae670106fdc,20220930,TK-106,4,401362,401366,-4
6633cb8d8f483ae670106fdd,20221001,TK-106,4,374581,374584,-3
6633cb8d8f483ae670106fde,20221004,TK-106,4,636843,636847,-4
6633cb8d8f483ae670106fdf,20221005,TK-106,4,472206,472206,0
6633cb8d8f483ae670106fe0,20221006,TK-106,4,604020,604020,0
6633cb8d8f483ae670106fe1,20221009,TK-106,4,65277,65277,0
6633cb8d8f483ae670106fe2,20221010,TK-106,4,461878,461880,-2
6633cb8d8f483ae670106fe3,20221011,TK-106,4,582513,582515,-2
6633cb8d8f483ae670106fe4,20221125,TK-106,4,182783,182784,-1
6633cb8d8f483ae670106fe5,20221126,TK-106,4,155125,155125,0
6633cb8d8f483ae670106fe6,20221127,TK-106,4,95846,95846,0
6633cb8d8f483ae670106fe7,20221128,TK-106,4,263027,263027,0
6633cb8d8f483ae670106fe8,20221129,TK-106,4,224634,224636,-2
6633cb8d8f483ae670106fe9,20221130,TK-106,4,206729,206732,-3
6633cb8d8f483ae670106fea,20221201,TK-106,4,276767,276768,-1
6633cb8d8f483ae670106feb,20221202,TK-106,4,404215,404218,-3
6633cb8d8f483ae670106fec,20221203,TK-106,4,412123,412126,-3
6633cb8d8f483ae670106fed,20221204,TK-106,4,103733,103733,0
6633cb8d8f483ae670106fee,20221205,TK-106,4,323163,323171,-8
6633cb8d8f483ae670106fef,20221206,TK-106,4,320931,320932,-1
6633cb8d8f483ae670106ff0,20221207,TK-106,4,397428,397431,-3
6633cb8d8f483ae670106ff1,20221208,TK-106,4,282497,282498,-1
6633cb8d8f483ae670106ff2,20221209,TK-106,4,367563,367563,0
6633cb8d8f483ae670106ff3,20221210,TK-106,4,177164,177166,-2
6633cb8d8f483ae670106ff4,20230109,TK-106,4,368593,368599,-6
6633cb8d8f483ae670106ff5,20230116,TK-106,4,322554,322557,-3
6633cb8d8f483ae670106ff6,20230119,TK-106,4,308279,308281,-2
6633cb8d8f483ae670106ff7,20230120,TK-106,4,415117,415210,-93
6633cb8d8f483ae670106ff8,20230121,TK-106,4,160800,160716,84
6633cb8d8f483ae670106ff9,20230122,TK-106,4,131871,131871,0
6633cb8d8f483ae670106ffa,20230123,TK-106,4,394429,394433,-4
6633cb8d8f483ae670106ffb,20230124,TK-106,4,311864,311868,-4
6633cb8d8f483ae670106ffc,20230125,TK-106,4,261913,261913,0
6633cb8d8f483ae670106ffd,20230126,TK-106,4,328916,328916,0
6633cb8d8f483ae670106ffe,20230127,TK-106,4,416919,416919,0
6633cb8d8f483ae670106fff,20230128,TK-106,4,129439,129439,0
6633cb8d8f483ae670107000,20230129,TK-106,4,111468,111468,0
6633cb8d8f483ae670107001,20230130,TK-106,4,393344,393346,-2
6633cb8d8f483ae670107002,20230131,TK-106,4,359318,359318,0
6633cb8d8f483ae670107003,20230201,TK-106,4,294530,294530,0
6633cb8d8f483ae670107004,20230202,TK-106,4,373294,373297,-3
6633cb8d8f483ae670107005,20230203,TK-106,4,390957,390962,-5
6633cb8d8f483ae670107006,20230204,TK-106,4,193030,193034,-4
6633cb8d8f483ae670107007,20230205,TK-106,4,118198,118438,-240
6633cb8d8f483ae670107008,20230206,TK-106,4,283307,283069,238
6633cb8d8f483ae670107009,20230207,TK-106,4,443362,443365,-3
6633cb8d8f483ae67010700a,20230208,TK-106,4,401255,401257,-2
6633cb8d8f483ae67010700b,20230209,TK-106,4,228125,228129,-4
6633cb8d8f483ae67010700c,20230324,TK-106,4,161106,161108,-2
6633cb8d8f483ae67010700d,20230325,TK-106,4,239717,239731,-14
6633cb8d8f483ae67010700e,20230326,TK-106,4,143711,143711,0
6633cb8d8f483ae67010700f,20230327,TK-106,4,291379,291387,-8
6633cb8d8f483ae670107010,20230328,TK-106,4,228698,228705,-7
6633cb8d8f483ae670107011,20230329,TK-106,4,147193,147201,-8
6633cb8d8f483ae670107012,20230330,TK-106,4,303520,303529,-9
6633cb8d8f483ae670107013,20230331,TK-106,4,328968,328973,-5
6633cb8d8f483ae670107014,20230401,TK-106,4,316958,316964,-6
6633cb8d8f483ae670107015,20230402,TK-106,4,137208,137208,0
6633cb8d8f483ae670107016,20230403,TK-106,4,611437,611449,-12
6633cb8d8f483ae670107017,20230404,TK-106,4,397032,397046,-14
6633cb8d8f483ae670107018,20230405,TK-106,4,416676,416683,-7
6633cb8d8f483ae670107019,20230406,TK-106,4,345243,345252,-9
6633cb8d8f483ae67010701a,20230407,TK-106,4,389930,389943,-13
6633cb8d8f483ae67010701b,20230408,TK-106,4,218654,218665,-11
6633cb8d8f483ae67010701c,20230409,TK-106,4,162114,162114,0
6633cb8d8f483ae67010701d,20230410,TK-106,4,338360,338367,-7
6633cb8d8f483ae67010701e,20230411,TK-106,4,395644,395651,-7
6633cb8d8f483ae67010701f,20230412,TK-106,4,144329,144341,-12
6633cb8d8f483ae670107020,20230511,TK-106,4,149420,149420,0
6633cb8d8f483ae670107021,20230512,TK-106,4,417804,417823,-19
6633cb8d8f483ae670107022,20230513,TK-106,4,218970,218989,-19
6633cb8d8f483ae670107023,20230514,TK-106,4,98691,98691,0
6633cb8d8f483ae670107024,20230515,TK-106,4,443206,443219,-13
6633cb8d8f483ae670107025,20230516,TK-106,4,633298,633310,-12
6633cb8d8f483ae670107026,20230517,TK-106,4,460997,461014,-17
6633cb8d8f483ae670107027,20230518,TK-106,4,500999,501009,-10
6633cb8d8f483ae670107028,20230519,TK-106,4,425532,425550,-18
6633cb8d8f483ae670107029,20230520,TK-106,4,184528,184544,-16
6633cb8d8f483ae67010702a,20230521,TK-106,4,128393,128395,-2
6633cb8d8f483ae67010702b,20230630,TK-106,4,247385,247395,-10
6633cb8d8f483ae67010702c,20230701,TK-106,4,258108,258128,-20
6633cb8d8f483ae67010702d,20230702,TK-106,4,82457,82457,0
6633cb8d8f483ae67010702e,20230703,TK-106,4,499071,499162,-91
6633cb8d8f483ae67010702f,20230704,TK-106,4,520904,520919,-15
6633cb8d8f483ae670107030,20230705,TK-106,4,500198,500214,-16
6633cb8d8f483ae670107031,20230706,TK-106,4,466217,466230,-13
6633cb8d8f483ae670107032,20230707,TK-106,4,588953,588972,-19
6633cb8d8f483ae670107033,20230708,TK-106,4,303442,303462,-20
6633cb8d8f483ae670107034,20230709,TK-106,4,146449,146449,0
6633cb8d8f483ae670107035,20230710,TK-106,4,439306,439244,62
6633cb8d8f483ae670107036,20230711,TK-106,4,499384,499399,-15
6633cb8d8f483ae670107037,20230712,TK-106,4,359647,359664,-17
6633cb8d8f483ae670107038,20230719,TK-106,4,511904,511917,-13
6633cb8d8f483ae670107039,20211004,TK-200,9,0,0,0
6633cb8d8f483ae67010703a,20211005,TK-200,9,0,0,0
6633cb8d8f483ae67010703b,20211009,TK-200,9,1,1,0
6633cb8d8f483ae67010703c,20211011,TK-200,9,0,0,0
6633cb8d8f483ae67010703d,20211015,TK-200,9,0,0,0
6633cb8d8f483ae67010703e,20211106,TK-200,9,0,0,0
6633cb8d8f483ae67010703f,20220126,TK-200,9,6,13,-7
6633cb8d8f483ae670107040,20220127,TK-200,9,9,17,-8
6633cb8d8f483ae670107041,20220128,TK-200,9,14,21,-7
6633cb8d8f483ae670107042,20220129,TK-200,9,16,27,-11
6633cb8d8f483ae670107043,20220131,TK-200,9,11,19,-8
6633cb8d8f483ae670107044,20220201,TK-200,9,10,18,-8
6633cb8d8f483ae670107045,20220202,TK-200,9,8,14,-6
6633cb8d8f483ae670107046,20220203,TK-200,9,7,14,-7
6633cb8d8f483ae670107047,20220204,TK-200,9,14,23,-9
6633cb8d8f483ae670107048,20220205,TK-200,9,14,26,-12
6633cb8d8f483ae670107049,20220207,TK-200,9,10,18,-8
6633cb8d8f483ae67010704a,20220208,TK-200,9,11,17,-6
6633cb8d8f483ae67010704b,20220209,TK-200,9,13,21,-8
6633cb8d8f483ae67010704c,20220210,TK-200,9,6,16,-10
6633cb8d8f483ae67010704d,20220211,TK-200,9,9,13,-4
6633cb8d8f483ae67010704e,20220212,TK-200,9,14,22,-8
6633cb8d8f483ae67010704f,20220214,TK-200,9,19,29,-10
6633cb8d8f483ae670107050,20220215,TK-200,9,10,23,-13
6633cb8d8f483ae670107051,20220216,TK-200,9,20,29,-9
6633cb8d8f483ae670107052,20220217,TK-200,9,12,20,-8
6633cb8d8f483ae670107053,20220218,TK-200,9,12,22,-10
6633cb8d8f483ae670107054,20220219,TK-200,9,14,25,-11
6633cb8d8f483ae670107055,20220714,TK-200,9,0,0,0
6633cb8d8f483ae670107056,20220715,TK-200,9,4,5,-1
6633cb8d8f483ae670107057,20220716,TK-200,9,26,41,-15
6633cb8d8f483ae670107058,20220717,TK-200,9,1,1,0
6633cb8d8f483ae670107059,20220718,TK-200,9,12,24,-12
6633cb8d8f483ae67010705a,20220719,TK-200,9,23,32,-9
6633cb8d8f483ae67010705b,20220720,TK-200,9,15,24,-9
6633cb8d8f483ae67010705c,20220721,TK-200,9,2,5,-3
6633cb8d8f483ae67010705d,20220722,TK-200,9,20,29,-9
6633cb8d8f483ae67010705e,20220723,TK-200,9,14,24,-10
6633cb8d8f483ae67010705f,20220725,TK-200,9,7,12,-5
6633cb8d8f483ae670107060,20220726,TK-200,9,4,6,-2
6633cb8d8f483ae670107061,20220727,TK-200,9,15,21,-6
6633cb8d8f483ae670107062,20220728,TK-200,9,9,13,-4
6633cb8d8f483ae670107063,20220729,TK-200,9,18,22,-4
6633cb8d8f483ae670107064,20220730,TK-200,9,13,23,-10
6633cb8d8f483ae670107065,20220801,TK-200,9,10,18,-8
6633cb8d8f483ae670107066,20220802,TK-200,9,17,27,-10
6633cb8d8f483ae670107067,20220803,TK-200,9,18,30,-12
6633cb8d8f483ae670107068,20220804,TK-200,9,21,32,-11
6633cb8d8f483ae670107069,20220805,TK-200,9,10,15,-5
6633cb8d8f483ae67010706a,20220806,TK-200,9,21,32,-11
6633cb8d8f483ae67010706b,20220807,TK-200,9,7,8,-1
6633cb8d8f483ae67010706c,20220808,TK-200,9,15,23,-8
6633cb8d8f483ae67010706d,20220809,TK-200,9,20,24,-4
6633cb8d8f483ae67010706e,20220810,TK-200,9,6,12,-6
6633cb8d8f483ae67010706f,20220811,TK-200,9,16,28,-12
6633cb8d8f483ae670107070,20220812,TK-200,9,3,9,-6
6633cb8d8f483ae670107071,20220813,TK-200,9,18,24,-6
6633cb8d8f483ae670107072,20220814,TK-200,9,7,8,-1
6633cb8d8f483ae670107073,20220815,TK-200,9,20,28,-8
6633cb8d8f483ae670107074,20220816,TK-200,9,17,27,-10
6633cb8d8f483ae670107075,20220817,TK-200,9,11,19,-8
6633cb8d8f483ae670107076,20220818,TK-200,9,9,13,-4
6633cb8d8f483ae670107077,20220819,TK-200,9,6,11,-5
6633cb8d8f483ae670107078,20220820,TK-200,9,10,19,-9
6633cb8d8f483ae670107079,20220821,TK-200,9,6,7,-1
6633cb8d8f483ae67010707a,20220822,TK-200,9,13,23,-10
6633cb8d8f483ae67010707b,20220823,TK-200,9,17,22,-5
6633cb8d8f483ae67010707c,20220824,TK-200,9,2,3,-1
6633cb8d8f483ae67010707d,20220826,TK-200,9,11,17,-6
6633cb8d8f483ae67010707e,20220827,TK-200,9,16,30,-14
6633cb8d8f483ae67010707f,20220828,TK-200,9,5,5,0
6633cb8d8f483ae670107080,20220901,TK-200,9,6,10,-4
6633cb8d8f483ae670107081,20220902,TK-200,9,5,7,-2
6633cb8d8f483ae670107082,20220903,TK-200,9,3,8,-5
6633cb8d8f483ae670107083,20220904,TK-200,9,1,1,0
6633cb8d8f483ae670107084,20220905,TK-200,9,6,10,-4
6633cb8d8f483ae670107085,20220906,TK-200,9,2,2,0
6633cb8d8f483ae670107086,20220907,TK-200,9,9,17,-8
6633cb8d8f483ae670107087,20220908,TK-200,9,4,9,-5
6633cb8d8f483ae670107088,20220909,TK-200,9,7,11,-4
6633cb8d8f483ae670107089,20220910,TK-200,9,8,14,-6
6633cb8d8f483ae67010708a,20220912,TK-200,9,0,1,-1
6633cb8d8f483ae67010708b,20220913,TK-200,9,12,21,-9
6633cb8d8f483ae67010708c,20220914,TK-200,9,5,11,-6
6633cb8d8f483ae67010708d,20220915,TK-200,9,3,4,-1
6633cb8d8f483ae67010708e,20220916,TK-200,9,5,8,-3
6633cb8d8f483ae67010708f,20220917,TK-200,9,6,12,-6
6633cb8d8f483ae670107090,20230314,TK-200,9,2,4,-2
6633cb8d8f483ae670107091,20230322,TK-200,9,6,7,-1
6633cb8d8f483ae670107092,20230323,TK-200,9,13,20,-7
6633cb8d8f483ae670107093,20230324,TK-200,9,6,15,-9
6633cb8d8f483ae670107094,20230325,TK-200,9,12,21,-9
6633cb8d8f483ae670107095,20230327,TK-200,9,6,10,-4
6633cb8d8f483ae670107096,20230328,TK-200,9,10,12,-2
6633cb8d8f483ae670107097,20230329,TK-200,9,3,8,-5
6633cb8d8f483ae670107098,20230330,TK-200,9,6,9,-3
6633cb8d8f483ae670107099,20230401,TK-200,9,3,5,-2
6633cb8d8f483ae67010709a,20230403,TK-200,9,3,6,-3
6633cb8d8f483ae67010709b,20230404,TK-200,9,9,15,-6
6633cb8d8f483ae67010709c,20230405,TK-200,9,2,3,-1
6633cb8d8f483ae67010709d,20230406,TK-200,9,5,10,-5
6633cb8d8f483ae67010709e,20230407,TK-200,9,7,11,-4
6633cb8d8f483ae67010709f,20230408,TK-200,9,5,8,-3
6633cb8d8f483ae6701070a0,20230410,TK-200,9,2,5,-3
6633cb8d8f483ae6701070a1,20230411,TK-200,9,3,5,-2
6633cb8d8f483ae6701070a2,20230412,TK-200,9,7,8,-1
6633cb8d8f483ae6701070a3,20230413,TK-200,9,9,10,-1
6633cb8d8f483ae6701070a4,20230414,TK-200,9,7,10,-3
6633cb8d8f483ae6701070a5,20230415,TK-200,9,2,3,-1
6633cb8d8f483ae6701070a6,20230417,TK-200,9,3,5,-2
6633cb8d8f483ae6701070a7,20230418,TK-200,9,9,12,-3
6633cb8d8f483ae6701070a8,20230419,TK-200,9,8,10,-2
6633cb8d8f483ae6701070a9,20230420,TK-200,9,8,14,-6
6633cb8d8f483ae6701070aa,20230421,TK-200,9,3,6,-3
6633cb8d8f483ae6701070ab,20230423,TK-200,9,6,7,-1
6633cb8d8f483ae6701070ac,20230424,TK-200,9,7,12,-5
6633cb8d8f483ae6701070ad,20230425,TK-200,9,5,9,-4
6633cb8d8f483ae6701070ae,20230426,TK-200,9,9,12,-3
6633cb8d8f483ae6701070af,20230427,TK-200,9,7,11,-4
6633cb8d8f483ae6701070b0,20230428,TK-200,9,8,12,-4
6633cb8d8f483ae6701070b1,20230429,TK-200,9,14,20,-6
6633cb8d8f483ae6701070b2,20230430,TK-200,9,0,0,0
6633cb8d8f483ae6701070b3,20230501,TK-200,9,6,10,-4
6633cb8d8f483ae6701070b4,20230502,TK-200,9,10,16,-6
6633cb8d8f483ae6701070b5,20230503,TK-200,9,13,21,-8
6633cb8d8f483ae6701070b6,20230504,TK-200,9,6,13,-7
6633cb8d8f483ae6701070b7,20230505,TK-200,9,12,17,-5
6633cb8d8f483ae6701070b8,20230506,TK-200,9,10,18,-8
6633cb8d8f483ae6701070b9,20230508,TK-200,9,11,19,-8
6633cb8d8f483ae6701070ba,20230509,TK-200,9,13,18,-5
6633cb8d8f483ae6701070bb,20230510,TK-200,9,13,20,-7
6633cb8d8f483ae6701070bc,20230511,TK-200,9,7,14,-7
6633cb8d8f483ae6701070bd,20230512,TK-200,9,10,14,-4
6633cb8d8f483ae6701070be,20230513,TK-200,9,9,15,-6
6633cb8d8f483ae6701070bf,20230515,TK-200,9,3,7,-4
6633cb8d8f483ae6701070c0,20230516,TK-200,9,8,10,-2
6633cb8d8f483ae6701070c1,20230517,TK-200,9,9,16,-7
6633cb8d8f483ae6701070c2,20230518,TK-200,9,4,7,-3
6633cb8d8f483ae6701070c3,20230519,TK-200,9,11,16,-5
6633cb8d8f483ae6701070c4,20230520,TK-200,9,5,9,-4
6633cb8d8f483ae6701070c5,20230521,TK-200,9,12,12,0
6633cb8d8f483ae6701070c6,20230522,TK-200,9,11,17,-6
6633cb8d8f483ae6701070c7,20230523,TK-200,9,8,12,-4
6633cb8d8f483ae6701070c8,20230524,TK-200,9,10,15,-5
6633cb8d8f483ae6701070c9,20230525,TK-200,9,3,8,-5
6633cb8d8f483ae6701070ca,20230526,TK-200,9,11,16,-5
6633cb8d8f483ae6701070cb,20230527,TK-200,9,11,21,-10
6633cb8d8f483ae6701070cc,20230529,TK-200,9,9,13,-4
6633cb8d8f483ae6701070cd,20230530,TK-200,9,7,11,-4
6633cb8d8f483ae6701070ce,20230531,TK-200,9,5,11,-6
6633cb8d8f483ae6701070cf,20230601,TK-200,9,11,17,-6
6633cb8d8f483ae6701070d0,20230602,TK-200,9,14,17,-3
6633cb8d8f483ae6701070d1,20230603,TK-200,9,7,16,-9
6633cb8d8f483ae6701070d2,20230605,TK-200,9,10,14,-4
6633cb8d8f483ae6701070d3,20230606,TK-200,9,9,13,-4
6633cb8d8f483ae6701070d4,20230607,TK-200,9,11,20,-9
6633cb8d8f483ae6701070d5,20230608,TK-200,9,5,9,-4
6633cb8d8f483ae6701070d6,20230609,TK-200,9,6,11,-5
6633cb8d8f483ae6701070d7,20230610,TK-200,9,1,8,-7
6633cb8d8f483ae6701070d8,20230612,TK-200,9,1,8,-7
6633cb8d8f483ae6701070d9,20230613,TK-200,9,2,6,-4
6633cb8d8f483ae6701070da,20230614,TK-200,9,0,7,-7
6633cb8d8f483ae6701070db,20230615,TK-200,9,2,7,-5
6633cb8d8f483ae6701070dc,20230616,TK-200,9,1,10,-9
6633cb8d8f483ae6701070dd,20230617,TK-200,9,2,13,-11
6633cb8d8f483ae6701070de,20230619,TK-200,9,0,2,-2
6633cb8d8f483ae6701070df,20230620,TK-200,9,3,11,-8
6633cb8d8f483ae6701070e0,20230621,TK-200,9,1,8,-7
6633cb8d8f483ae6701070e1,20230622,TK-200,9,2,9,-7
6633cb8d8f483ae6701070e2,20230623,TK-200,9,3,13,-10
6633cb8d8f483ae6701070e3,20230624,TK-200,9,7,18,-11
6633cb8d8f483ae6701070e4,20230625,TK-200,9,0,0,0
6633cb8d8f483ae6701070e5,20230626,TK-200,9,4,16,-12
6633cb8d8f483ae6701070e6,20230627,TK-200,9,3,9,-6
6633cb8d8f483ae6701070e7,20230628,TK-200,9,4,20,-16
6633cb8d8f483ae6701070e8,20230630,TK-200,9,1,7,-6
6633cb8d8f483ae6701070e9,20230701,TK-200,9,4,16,-12
6633cb8d8f483ae6701070ea,20230703,TK-200,9,1,11,-10
6633cb8d8f483ae6701070eb,20230704,TK-200,9,2,11,-9
6633cb8d8f483ae6701070ec,20230705,TK-200,9,3,12,-9
6633cb8d8f483ae6701070ed,20230706,TK-200,9,2,9,-7
6633cb8d8f483ae6701070ee,20230707,TK-200,9,2,10,-8
6633cb8d8f483ae6701070ef,20230708,TK-200,9,4,18,-14
6633cb8d8f483ae6701070f0,20230710,TK-200,9,1,13,-12
6633cb8d8f483ae6701070f1,20230711,TK-200,9,6,14,-8
6633cb8d8f483ae6701070f2,20230712,TK-200,9,1,8,-7
6633cb8d8f483ae6701070f3,20230713,TK-200,9,2,5,-3
6633cb8d8f483ae6701070f4,20230714,TK-200,9,2,12,-10
6633cb8d8f483ae6701070f5,20230715,TK-200,9,3,16,-13
6633cb8d8f483ae6701070f6,20230716,TK-200,9,0,2,-2
6633cb8d8f483ae6701070f7,20230717,TK-200,9,4,14,-10
6633cb8d8f483ae6701070f8,20230718,TK-200,9,1,11,-10
6633cb8d8f483ae6701070f9,20230719,TK-200,9,3,12,-9
6633cb8d8f483ae6701070fa,20221110,TK-201,4,363860,363864,-4
6633cb8d8f483ae6701070fb,20221111,TK-201,4,389759,389762,-3
6633cb8d8f483ae6701070fc,20221112,TK-201,4,167122,167124,-2
6633cb8d8f483ae6701070fd,20221113,TK-201,4,133502,133502,0
6633cb8d8f483ae6701070fe,20221114,TK-201,4,237857,237859,-2
6633cb8d8f483ae6701070ff,20221115,TK-201,4,312020,312021,-1
6633cb8d8f483ae670107100,20221116,TK-201,4,331191,331198,-7
6633cb8d8f483ae670107101,20221117,TK-201,4,516000,516006,-6
6633cb8d8f483ae670107102,20221118,TK-201,4,347690,347742,-52
6633cb8d8f483ae670107103,20221119,TK-201,4,170739,170694,45
6633cb8d8f483ae670107104,20221120,TK-201,4,163838,163838,0
6633cb8d8f483ae670107105,20221121,TK-201,4,384357,384361,-4
6633cb8d8f483ae670107106,20221122,TK-201,4,339725,339725,0
6633cb8d8f483ae670107107,20221123,TK-201,4,274700,274701,-1
6633cb8d8f483ae670107108,20221124,TK-201,4,246126,246130,-4
6633cb8d8f483ae670107109,20221125,TK-201,4,76688,76689,-1
6633cb8d8f483ae67010710a,20221220,TK-201,4,276132,276136,-4
6633cb8d8f483ae67010710b,20221221,TK-201,4,367681,367682,-1
6633cb8d8f483ae67010710c,20221222,TK-201,4,329942,329943,-1
6633cb8d8f483ae67010710d,20221230,TK-201,4,422303,422308,-5
6633cb8d8f483ae67010710e,20221231,TK-201,4,116807,116809,-2
6633cb8d8f483ae67010710f,20230101,TK-201,4,79657,79657,0
6633cb8d8f483ae670107110,20230103,TK-201,4,407982,407988,-6
6633cb8d8f483ae670107111,20230106,TK-201,4,391380,391386,-6
6633cb8d8f483ae670107112,20230107,TK-201,4,266580,266584,-4
6633cb8d8f483ae670107113,20230108,TK-201,4,186669,186669,0
6633cb8d8f483ae670107114,20230110,TK-201,4,414833,414836,-3
6633cb8d8f483ae670107115,20230111,TK-201,4,157605,157607,-2
6633cb8d8f483ae670107116,20230112,TK-201,4,229644,229646,-2
6633cb8d8f483ae670107117,20230113,TK-201,4,327193,327197,-4
6633cb8d8f483ae670107118,20230114,TK-201,4,157875,157878,-3
6633cb8d8f483ae670107119,20230115,TK-201,4,96899,96899,0
6633cb8d8f483ae67010711a,20230412,TK-201,4,133829,133831,-2
6633cb8d8f483ae67010711b,20230413,TK-201,4,277283,277291,-8
6633cb8d8f483ae67010711c,20230414,TK-201,4,434550,434565,-15
6633cb8d8f483ae67010711d,20230415,TK-201,4,229487,229494,-7
6633cb8d8f483ae67010711e,20230416,TK-201,4,148986,148986,0
6633cb8d8f483ae67010711f,20230417,TK-201,4,383718,383728,-10
6633cb8d8f483ae670107120,20230418,TK-201,4,510569,510576,-7
6633cb8d8f483ae670107121,20230419,TK-201,4,550593,550604,-11
6633cb8d8f483ae670107122,20230420,TK-201,4,472399,472410,-11
6633cb8d8f483ae670107123,20230421,TK-201,4,198410,198421,-11
6633cb8d8f483ae670107124,20230423,TK-201,4,171755,171761,-6
6633cb8d8f483ae670107125,20230424,TK-201,4,265528,265541,-13
6633cb8d8f483ae670107126,20230425,TK-201,4,363925,363936,-11
6633cb8d8f483ae670107127,20230426,TK-201,4,417674,417683,-9
6633cb8d8f483ae670107128,20230427,TK-201,4,438889,438894,-5
6633cb8d8f483ae670107129,20230428,TK-201,4,543683,543775,-92
6633cb8d8f483ae67010712a,20230429,TK-201,4,237817,237745,72
6633cb8d8f483ae67010712b,20230430,TK-201,4,205945,205945,0
6633cb8d8f483ae67010712c,20230501,TK-201,4,231944,231950,-6
6633cb8d8f483ae67010712d,20230502,TK-201,4,456372,456381,-9
6633cb8d8f483ae67010712e,20230503,TK-201,4,493053,493114,-61
6633cb8d8f483ae67010712f,20230504,TK-201,4,638964,638941,23
6633cb8d8f483ae670107130,20230505,TK-201,4,432709,432724,-15
6633cb8d8f483ae670107131,20230506,TK-201,4,243215,243230,-15
6633cb8d8f483ae670107132,20230507,TK-201,4,196907,196907,0
6633cb8d8f483ae670107133,20230508,TK-201,4,384958,384972,-14
6633cb8d8f483ae670107134,20230509,TK-201,4,326069,326088,-19
6633cb8d8f483ae670107135,20230510,TK-201,4,357675,357695,-20
6633cb8d8f483ae670107136,20230511,TK-201,4,244413,244427,-14
6633cb8d8f483ae670107137,20221027,TK-202,4,408686,408692,-6
6633cb8d8f483ae670107138,20221028,TK-202,4,632101,632106,-5
6633cb8d8f483ae670107139,20221029,TK-202,4,320376,320382,-6
6633cb8d8f483ae67010713a,20221030,TK-202,4,97399,97399,0
6633cb8d8f483ae67010713b,20221031,TK-202,4,478347,478351,-4
6633cb8d8f483ae67010713c,20221101,TK-202,4,255272,255274,-2
6633cb8d8f483ae67010713d,20221102,TK-202,4,297933,297937,-4
6633cb8d8f483ae67010713e,20221103,TK-202,4,266432,266434,-2
6633cb8d8f483ae67010713f,20221104,TK-202,4,344860,344864,-4
6633cb8d8f483ae670107140,20221105,TK-202,4,167819,167822,-3
6633cb8d8f483ae670107141,20221106,TK-202,4,129444,129444,0
6633cb8d8f483ae670107142,20221107,TK-202,4,436606,436611,-5
6633cb8d8f483ae670107143,20221108,TK-202,4,377849,377853,-4
6633cb8d8f483ae670107144,20221109,TK-202,4,250478,250482,-4
6633cb8d8f483ae670107145,20221211,TK-202,4,189424,189424,0
6633cb8d8f483ae670107146,20221212,TK-202,4,235871,235875,-4
6633cb8d8f483ae670107147,20221213,TK-202,4,176049,176145,-96
6633cb8d8f483ae670107148,20221214,TK-202,4,221319,221225,94
6633cb8d8f483ae670107149,20221215,TK-202,4,154936,154939,-3
6633cb8d8f483ae67010714a,20221216,TK-202,4,471795,471799,-4
6633cb8d8f483ae67010714b,20221217,TK-202,4,269291,269295,-4
6633cb8d8f483ae67010714c,20221218,TK-202,4,56961,56961,0
6633cb8d8f483ae67010714d,20221219,TK-202,4,371856,371859,-3
6633cb8d8f483ae67010714e,20221220,TK-202,4,12976,12976,0
6633cb8d8f483ae67010714f,20230209,TK-202,4,129154,129154,0
6633cb8d8f483ae670107150,20230210,TK-202,4,465366,465368,-2
6633cb8d8f483ae670107151,20230211,TK-202,4,149013,149015,-2
6633cb8d8f483ae670107152,20230212,TK-202,4,117952,117952,0
6633cb8d8f483ae670107153,20230213,TK-202,4,236738,236740,-2
6633cb8d8f483ae670107154,20230214,TK-202,4,213797,213798,-1
6633cb8d8f483ae670107155,20230215,TK-202,4,345577,345579,-2
6633cb8d8f483ae670107156,20230216,TK-202,4,387537,387539,-2
6633cb8d8f483ae670107157,20230217,TK-202,4,449571,449575,-4
6633cb8d8f483ae670107158,20230218,TK-202,4,212490,212491,-1
6633cb8d8f483ae670107159,20230219,TK-202,4,150820,150820,0
6633cb8d8f483ae67010715a,20230222,TK-202,4,406640,406643,-3
6633cb8d8f483ae67010715b,20230223,TK-202,4,353624,353627,-3
6633cb8d8f483ae67010715c,20230224,TK-202,4,323996,323998,-2
6633cb8d8f483ae67010715d,20230225,TK-202,4,226378,226381,-3
6633cb8d8f483ae67010715e,20230226,TK-202,4,122906,122906,0
6633cb8d8f483ae67010715f,20230227,TK-202,4,249578,249579,-1
6633cb8d8f483ae670107160,20230228,TK-202,4,217992,217993,-1
6633cb8d8f483ae670107161,20230301,TK-202,4,437860,437864,-4
6633cb8d8f483ae670107162,20230304,TK-202,4,213662,213666,-4
6633cb8d8f483ae670107163,20230305,TK-202,4,120880,120880,0
6633cb8d8f483ae670107164,20230306,TK-202,4,419337,419341,-4
6633cb8d8f483ae670107165,20230307,TK-202,4,282543,282546,-3
6633cb8d8f483ae670107166,20230613,TK-202,4,318098,318109,-11
6633cb8d8f483ae670107167,20230614,TK-202,4,362746,362760,-14
6633cb8d8f483ae670107168,20230615,TK-202,4,340232,340245,-13
6633cb8d8f483ae670107169,20230616,TK-202,4,386975,386992,-17
6633cb8d8f483ae67010716a,20230617,TK-202,4,286669,286690,-21
6633cb8d8f483ae67010716b,20230618,TK-202,4,94815,94815,0
6633cb8d8f483ae67010716c,20230619,TK-202,4,359165,359174,-9
6633cb8d8f483ae67010716d,20230620,TK-202,4,426295,426308,-13
6633cb8d8f483ae67010716e,20230621,TK-202,4,418517,418528,-11
6633cb8d8f483ae67010716f,20230622,TK-202,4,470361,470377,-16
6633cb8d8f483ae670107170,20230623,TK-202,4,644656,644678,-22
6633cb8d8f483ae670107171,20230624,TK-202,4,316935,316952,-17
6633cb8d8f483ae670107172,20230625,TK-202,4,175164,175165,-1
6633cb8d8f483ae670107173,20230626,TK-202,4,675565,675584,-19
6633cb8d8f483ae670107174,20230627,TK-202,4,557575,557592,-17
6633cb8d8f483ae670107175,20230628,TK-202,4,463974,463996,-22
6633cb8d8f483ae670107176,20230713,TK-202,4,474437,474452,-15
6633cb8d8f483ae670107177,20230714,TK-202,4,463859,463874,-15
6633cb8d8f483ae670107178,20230715,TK-202,4,323628,323649,-21
6633cb8d8f483ae670107179,20230716,TK-202,4,73750,73752,-2
6633cb8d8f483ae67010717a,20230717,TK-202,4,522559,522574,-15
6633cb8d8f483ae67010717b,20230718,TK-202,4,689898,689916,-18
6633cb8d8f483ae67010717c,20230101,TK-203,7,29916,29916,0
6633cb8d8f483ae67010717d,20230102,TK-203,7,2673562,2673570,-8
6633cb8d8f483ae67010717e,20230103,TK-203,7,2912513,2912525,-12
6633cb8d8f483ae67010717f,20230107,TK-203,7,2102027,2102036,-9
6633cb8d8f483ae670107180,20230108,TK-203,7,353262,353262,0
6633cb8d8f483ae670107181,20230109,TK-203,7,1350535,1350538,-3
6633cb8d8f483ae670107182,20230609,TK-203,7,363879,363879,0
6633cb8d8f483ae670107183,20230610,TK-203,7,2164172,2164204,-32
6633cb8d8f483ae670107184,20230611,TK-203,7,92255,92255,0
6633cb8d8f483ae670107185,20230612,TK-203,7,2556779,2556805,-26
6633cb8d8f483ae670107186,20230613,TK-203,7,2321162,2321188,-26
6633cb8d8f483ae670107187,20230614,TK-203,7,2583244,2583269,-25
6633cb8d8f483ae670107188,20230615,TK-203,7,2546029,2546055,-26
6633cb8d8f483ae670107189,20230616,TK-203,7,3215062,3215092,-30
6633cb8d8f483ae67010718a,20230710,TK-203,7,73955,73955,0
6633cb8d8f483ae67010718b,20230711,TK-203,7,3218344,3218366,-22
6633cb8d8f483ae67010718c,20230712,TK-203,7,2961702,2961730,-28
6633cb8d8f483ae67010718d,20230713,TK-203,7,2734427,2734457,-30
6633cb8d8f483ae67010718e,20230714,TK-203,7,3064438,3064461,-23
6633cb8d8f483ae67010718f,20230715,TK-203,7,2016896,2016925,-29
6633cb8d8f483ae670107190,20230716,TK-203,7,261397,261400,-3
6633cb8d8f483ae670107191,20230717,TK-203,7,3715377,3715406,-29
6633cb8d8f483ae670107192,20210929,TK-205,7,3751678,3751703,-25
6633cb8d8f483ae670107193,20210930,TK-205,7,4370739,4370758,-19
6633cb8d8f483ae670107194,20211001,TK-205,7,2464030,2464053,-23
6633cb8d8f483ae670107195,20211002,TK-205,7,1946227,1946247,-20
6633cb8d8f483ae670107196,20211003,TK-205,7,32817,32817,0
6633cb8d8f483ae670107197,20211004,TK-205,7,3355525,3355549,-24
6633cb8d8f483ae670107198,20211007,TK-205,7,2758551,2758575,-24
6633cb8d8f483ae670107199,20211008,TK-205,7,3520439,3520463,-24
6633cb8d8f483ae67010719a,20211011,TK-205,7,3273126,3273147,-21
6633cb8d8f483ae67010719b,20211017,TK-205,7,173827,173827,0
6633cb8d8f483ae67010719c,20211018,TK-205,7,2908131,2908145,-14
6633cb8d8f483ae67010719d,20211019,TK-205,7,1342327,1342335,-8
6633cb8d8f483ae67010719e,20211020,TK-205,7,1631369,1631375,-6
6633cb8d8f483ae67010719f,20211021,TK-205,7,2479455,2479465,-10
6633cb8d8f483ae6701071a0,20211022,TK-205,7,2386387,2386410,-23
6633cb8d8f483ae6701071a1,20211023,TK-205,7,2467129,2467153,-24
6633cb8d8f483ae6701071a2,20211024,TK-205,7,141158,141158,0
6633cb8d8f483ae6701071a3,20211025,TK-205,7,2922231,2922246,-15
6633cb8d8f483ae6701071a4,20211026,TK-205,7,2830587,2830598,-11
6633cb8d8f483ae6701071a5,20211029,TK-205,7,3903725,3903745,-20
6633cb8d8f483ae6701071a6,20211030,TK-205,7,3684479,3684506,-27
6633cb8d8f483ae6701071a7,20211031,TK-205,7,207298,207298,0
6633cb8d8f483ae6701071a8,20211101,TK-205,7,2761407,2761427,-20
6633cb8d8f483ae6701071a9,20211102,TK-205,7,2759473,2759493,-20
6633cb8d8f483ae6701071aa,20211103,TK-205,7,2842860,2842880,-20
6633cb8d8f483ae6701071ab,20211104,TK-205,7,2955960,2955985,-25
6633cb8d8f483ae6701071ac,20211107,TK-205,7,180605,180605,0
6633cb8d8f483ae6701071ad,20211109,TK-205,7,2943537,2943555,-18
6633cb8d8f483ae6701071ae,20211110,TK-205,7,3330539,3330561,-22
6633cb8d8f483ae6701071af,20211111,TK-205,7,3547245,3547269,-24
6633cb8d8f483ae6701071b0,20211112,TK-205,7,3655286,3655313,-27
6633cb8d8f483ae6701071b1,20211114,TK-205,7,226951,226951,0
6633cb8d8f483ae6701071b2,20211116,TK-205,7,3383322,3383335,-13
6633cb8d8f483ae6701071b3,20211118,TK-205,7,2727291,2727307,-16
6633cb8d8f483ae6701071b4,20211119,TK-205,7,3691855,3691877,-22
6633cb8d8f483ae6701071b5,20211120,TK-205,7,3065064,3065088,-24
6633cb8d8f483ae6701071b6,20211121,TK-205,7,251144,251144,0
6633cb8d8f483ae6701071b7,20211122,TK-205,7,3700851,3700862,-11
6633cb8d8f483ae6701071b8,20211123,TK-205,7,3342833,3342846,-13
6633cb8d8f483ae6701071b9,20211124,TK-205,7,3155957,3155971,-14
6633cb8d8f483ae6701071ba,20211125,TK-205,7,3168876,3168886,-10
6633cb8d8f483ae6701071bb,20211126,TK-205,7,3521172,3521192,-20
6633cb8d8f483ae6701071bc,20211127,TK-205,7,2980900,2980922,-22
6633cb8d8f483ae6701071bd,20211129,TK-205,7,2961130,2961147,-17
6633cb8d8f483ae6701071be,20211130,TK-205,7,2511574,2511590,-16
6633cb8d8f483ae6701071bf,20211201,TK-205,7,3398334,3398363,-29
6633cb8d8f483ae6701071c0,20211202,TK-205,7,3253043,3253065,-22
6633cb8d8f483ae6701071c1,20211205,TK-205,7,217619,217619,0
6633cb8d8f483ae6701071c2,20211207,TK-205,7,2825624,2825642,-18
6633cb8d8f483ae6701071c3,20211208,TK-205,7,3150299,3150322,-23
6633cb8d8f483ae6701071c4,20211211,TK-205,7,2715624,2715645,-21
6633cb8d8f483ae6701071c5,20211212,TK-205,7,26923,26923,0
6633cb8d8f483ae6701071c6,20211213,TK-205,7,2692199,2692218,-19
6633cb8d8f483ae6701071c7,20211214,TK-205,7,2636002,2636019,-17
6633cb8d8f483ae6701071c8,20211215,TK-205,7,2762015,2762039,-24
6633cb8d8f483ae6701071c9,20211216,TK-205,7,3050777,3050796,-19
6633cb8d8f483ae6701071ca,20211217,TK-205,7,3482794,3482816,-22
6633cb8d8f483ae6701071cb,20211218,TK-205,7,3093704,3093727,-23
6633cb8d8f483ae6701071cc,20211219,TK-205,7,250579,250579,0
6633cb8d8f483ae6701071cd,20211220,TK-205,7,3526053,3526066,-13
6633cb8d8f483ae6701071ce,20211221,TK-205,7,3799123,3799150,-27
6633cb8d8f483ae6701071cf,20211222,TK-205,7,3640866,3640893,-27
6633cb8d8f483ae6701071d0,20211223,TK-205,7,3681329,3681353,-24
6633cb8d8f483ae6701071d1,20211224,TK-205,7,4196278,4196301,-23
6633cb8d8f483ae6701071d2,20211225,TK-205,7,2998149,2998170,-21
6633cb8d8f483ae6701071d3,20211226,TK-205,7,26894,26894,0
6633cb8d8f483ae6701071d4,20211227,TK-205,7,3367150,3367176,-26
6633cb8d8f483ae6701071d5,20211228,TK-205,7,2935244,2935268,-24
6633cb8d8f483ae6701071d6,20211229,TK-205,7,3315088,3315109,-21
6633cb8d8f483ae6701071d7,20211230,TK-205,7,3863489,3863507,-18
6633cb8d8f483ae6701071d8,20211231,TK-205,7,4300344,4300373,-29
6633cb8d8f483ae6701071d9,20220102,TK-205,7,120040,120040,0
6633cb8d8f483ae6701071da,20220104,TK-205,7,3761733,3761757,-24
6633cb8d8f483ae6701071db,20220105,TK-205,7,3286203,3286217,-14
6633cb8d8f483ae6701071dc,20220106,TK-205,7,3115995,3116101,-106
6633cb8d8f483ae6701071dd,20220107,TK-205,7,3728092,3728008,84
6633cb8d8f483ae6701071de,20220108,TK-205,7,2683046,2683055,-9
6633cb8d8f483ae6701071df,20220109,TK-205,7,109019,109019,0
6633cb8d8f483ae6701071e0,20220110,TK-205,7,3497089,3497100,-11
6633cb8d8f483ae6701071e1,20220111,TK-205,7,2077061,2077074,-13
6633cb8d8f483ae6701071e2,20220112,TK-205,7,3097154,3097163,-9
6633cb8d8f483ae6701071e3,20220113,TK-205,7,3280786,3280795,-9
6633cb8d8f483ae6701071e4,20220114,TK-205,7,3863510,3863524,-14
6633cb8d8f483ae6701071e5,20220115,TK-205,7,3748844,3748854,-10
6633cb8d8f483ae6701071e6,20220116,TK-205,7,460857,460857,0
6633cb8d8f483ae6701071e7,20220117,TK-205,7,2934920,2934932,-12
6633cb8d8f483ae6701071e8,20220118,TK-205,7,2863764,2863774,-10
6633cb8d8f483ae6701071e9,20220119,TK-205,7,3103138,3103150,-12
6633cb8d8f483ae6701071ea,20220120,TK-205,7,2520296,2520309,-13
6633cb8d8f483ae6701071eb,20220121,TK-205,7,3988351,3988362,-11
6633cb8d8f483ae6701071ec,20220122,TK-205,7,2880237,2880246,-9
6633cb8d8f483ae6701071ed,20220123,TK-205,7,5998,5998,0
6633cb8d8f483ae6701071ee,20220124,TK-205,7,3441075,3441085,-10
6633cb8d8f483ae6701071ef,20220125,TK-205,7,2951610,2951621,-11
6633cb8d8f483ae6701071f0,20220126,TK-205,7,2599037,2599057,-20
6633cb8d8f483ae6701071f1,20220127,TK-205,7,2852065,2852086,-21
6633cb8d8f483ae6701071f2,20220128,TK-205,7,3650429,3650452,-23
6633cb8d8f483ae6701071f3,20220129,TK-205,7,3315929,3315956,-27
6633cb8d8f483ae6701071f4,20220130,TK-205,7,215701,215701,0
6633cb8d8f483ae6701071f5,20220202,TK-205,7,2638039,2638064,-25
6633cb8d8f483ae6701071f6,20220203,TK-205,7,2751271,2751296,-25
6633cb8d8f483ae6701071f7,20220205,TK-205,7,2910075,2910100,-25
6633cb8d8f483ae6701071f8,20220206,TK-205,7,215660,215660,0
6633cb8d8f483ae6701071f9,20220207,TK-205,7,3062472,3062492,-20
6633cb8d8f483ae6701071fa,20220208,TK-205,7,2660687,2660709,-22
6633cb8d8f483ae6701071fb,20220209,TK-205,7,2605727,2605754,-27
6633cb8d8f483ae6701071fc,20220210,TK-205,7,2732588,2732612,-24
6633cb8d8f483ae6701071fd,20220211,TK-205,7,3383642,3383659,-17
6633cb8d8f483ae6701071fe,20220212,TK-205,7,2898855,2898880,-25
6633cb8d8f483ae6701071ff,20220213,TK-205,7,175978,175978,0
6633cb8d8f483ae670107200,20220214,TK-205,7,4437070,4437096,-26
6633cb8d8f483ae670107201,20220215,TK-205,7,4755147,4755190,-43
6633cb8d8f483ae670107202,20220216,TK-205,7,3465613,3465619,-6
6633cb8d8f483ae670107203,20220217,TK-205,7,2851952,2851973,-21
6633cb8d8f483ae670107204,20220218,TK-205,7,3841763,3841790,-27
6633cb8d8f483ae670107205,20220219,TK-205,7,2704283,2704301,-18
6633cb8d8f483ae670107206,20220220,TK-205,7,32946,32946,0
6633cb8d8f483ae670107207,20220221,TK-205,7,3043165,3043176,-11
6633cb8d8f483ae670107208,20220222,TK-205,7,2607983,2607994,-11
6633cb8d8f483ae670107209,20220223,TK-205,7,3239584,3239644,-60
6633cb8d8f483ae67010720a,20220224,TK-205,7,3339034,3339046,-12
6633cb8d8f483ae67010720b,20220225,TK-205,7,4266859,4266868,-9
6633cb8d8f483ae67010720c,20220226,TK-205,7,2875766,2875725,41
6633cb8d8f483ae67010720d,20220227,TK-205,7,61015,61015,0
6633cb8d8f483ae67010720e,20220302,TK-205,7,2709310,2709323,-13
6633cb8d8f483ae67010720f,20220303,TK-205,7,2863509,2863523,-14
6633cb8d8f483ae670107210,20220304,TK-205,7,3999562,3999569,-7
6633cb8d8f483ae670107211,20220305,TK-205,7,3016948,3016958,-10
6633cb8d8f483ae670107212,20220306,TK-205,7,188994,188994,0
6633cb8d8f483ae670107213,20220307,TK-205,7,3549070,3549455,-385
6633cb8d8f483ae670107214,20220308,TK-205,7,3668831,3668466,365
6633cb8d8f483ae670107215,20220309,TK-205,7,3608060,3608071,-11
6633cb8d8f483ae670107216,20220310,TK-205,7,3344872,3344885,-13
6633cb8d8f483ae670107217,20220311,TK-205,7,4089584,4089597,-13
6633cb8d8f483ae670107218,20220312,TK-205,7,3199565,3199578,-13
6633cb8d8f483ae670107219,20220313,TK-205,7,357107,357107,0
6633cb8d8f483ae67010721a,20220314,TK-205,7,3566041,3566055,-14
6633cb8d8f483ae67010721b,20220315,TK-205,7,3759209,3759224,-15
6633cb8d8f483ae67010721c,20220316,TK-205,7,2706538,2706553,-15
6633cb8d8f483ae67010721d,20220317,TK-205,7,3274049,3274059,-10
6633cb8d8f483ae67010721e,20220318,TK-205,7,3628925,3628941,-16
6633cb8d8f483ae67010721f,20220319,TK-205,7,2798881,2798894,-13
6633cb8d8f483ae670107220,20220320,TK-205,7,92796,92796,0
6633cb8d8f483ae670107221,20220321,TK-205,7,3293814,3293824,-10
6633cb8d8f483ae670107222,20220322,TK-205,7,2982868,2982880,-12
6633cb8d8f483ae670107223,20220323,TK-205,7,2620852,2620861,-9
6633cb8d8f483ae670107224,20220324,TK-205,7,2642415,2642427,-12
6633cb8d8f483ae670107225,20220325,TK-205,7,2649808,2649817,-9
6633cb8d8f483ae670107226,20220326,TK-205,7,2418767,2418776,-9
6633cb8d8f483ae670107227,20220328,TK-205,7,3535636,3535650,-14
6633cb8d8f483ae670107228,20220329,TK-205,7,2294213,2294220,-7
6633cb8d8f483ae670107229,20220404,TK-205,7,2432303,2432313,-10
6633cb8d8f483ae67010722a,20220405,TK-205,7,1950239,1950249,-10
6633cb8d8f483ae67010722b,20220408,TK-205,7,2448649,2448660,-11
6633cb8d8f483ae67010722c,20220409,TK-205,7,1888286,1888299,-13
6633cb8d8f483ae67010722d,20220410,TK-205,7,32954,32954,0
6633cb8d8f483ae67010722e,20220411,TK-205,7,2423534,2423541,-7
6633cb8d8f483ae67010722f,20220412,TK-205,7,1845956,1845965,-9
6633cb8d8f483ae670107230,20220413,TK-205,7,2050863,2050871,-8
6633cb8d8f483ae670107231,20220414,TK-205,7,1704790,1704834,-44
6633cb8d8f483ae670107232,20220415,TK-205,7,1814782,1814755,27
6633cb8d8f483ae670107233,20220416,TK-205,7,2382603,2382612,-9
6633cb8d8f483ae670107234,20220418,TK-205,7,2520076,2520086,-10
6633cb8d8f483ae670107235,20220421,TK-205,7,4663392,4663373,19
6633cb8d8f483ae670107236,20220422,TK-205,7,2247594,2247604,-10
6633cb8d8f483ae670107237,20220423,TK-205,7,29960,29960,0
6633cb8d8f483ae670107238,20220424,TK-205,7,2395876,2395887,-11
6633cb8d8f483ae670107239,20220425,TK-205,7,2322636,2322647,-11
6633cb8d8f483ae67010723a,20220426,TK-205,7,2768207,2768216,-9
6633cb8d8f483ae67010723b,20220427,TK-205,7,2845296,2845304,-8
6633cb8d8f483ae67010723c,20220428,TK-205,7,2992872,2992880,-8
6633cb8d8f483ae67010723d,20220429,TK-205,7,2839196,2839211,-15
6633cb8d8f483ae67010723e,20220501,TK-205,7,55842,55842,0
6633cb8d8f483ae67010723f,20220503,TK-205,7,1535601,1535608,-7
6633cb8d8f483ae670107240,20220504,TK-205,7,1852632,1852641,-9
6633cb8d8f483ae670107241,20220505,TK-205,7,2792911,2792923,-12
6633cb8d8f483ae670107242,20220506,TK-205,7,2613964,2613972,-8
6633cb8d8f483ae670107243,20220507,TK-205,7,2209940,2209950,-10
6633cb8d8f483ae670107244,20220508,TK-205,7,114574,114574,0
6633cb8d8f483ae670107245,20220509,TK-205,7,2682149,2682162,-13
6633cb8d8f483ae670107246,20220510,TK-205,7,2557395,2557407,-12
6633cb8d8f483ae670107247,20220511,TK-205,7,3222906,3222915,-9
6633cb8d8f483ae670107248,20220512,TK-205,7,2911711,2911721,-10
6633cb8d8f483ae670107249,20220513,TK-205,7,3704310,3704325,-15
6633cb8d8f483ae67010724a,20220514,TK-205,7,3127276,3127285,-9
6633cb8d8f483ae67010724b,20220515,TK-205,7,150025,150025,0
6633cb8d8f483ae67010724c,20220516,TK-205,7,2500274,2500286,-12
6633cb8d8f483ae67010724d,20220517,TK-205,7,2691147,2691160,-13
6633cb8d8f483ae67010724e,20220520,TK-205,7,3486344,3486355,-11
6633cb8d8f483ae67010724f,20220521,TK-205,7,2374217,2374226,-9
6633cb8d8f483ae670107250,20220522,TK-205,7,98484,98484,0
6633cb8d8f483ae670107251,20220523,TK-205,7,2772187,2772201,-14
6633cb8d8f483ae670107252,20220524,TK-205,7,2910456,2910466,-10
6633cb8d8f483ae670107253,20220525,TK-205,7,2361062,2361072,-10
6633cb8d8f483ae670107254,20220526,TK-205,7,2746132,2746142,-10
6633cb8d8f483ae670107255,20220527,TK-205,7,3054078,3054087,-9
6633cb8d8f483ae670107256,20220528,TK-205,7,2161387,2161480,-93
6633cb8d8f483ae670107257,20220529,TK-205,7,32740,32740,0
6633cb8d8f483ae670107258,20220530,TK-205,7,3000173,3000099,74
6633cb8d8f483ae670107259,20220603,TK-205,7,3730183,3730257,-74
6633cb8d8f483ae67010725a,20220604,TK-205,7,2682546,2682497,49
6633cb8d8f483ae67010725b,20220605,TK-205,7,31668,31668,0
6633cb8d8f483ae67010725c,20220606,TK-205,7,3564519,3564524,-5
6633cb8d8f483ae67010725d,20220607,TK-205,7,3809400,3809412,-12
6633cb8d8f483ae67010725e,20220608,TK-205,7,3126690,3126699,-9
6633cb8d8f483ae67010725f,20220609,TK-205,7,3135535,3135545,-10
6633cb8d8f483ae670107260,20220610,TK-205,7,3450889,3450902,-13
6633cb8d8f483ae670107261,20220611,TK-205,7,2664483,2664498,-15
6633cb8d8f483ae670107262,20220612,TK-205,7,28765,28765,0
6633cb8d8f483ae670107263,20220613,TK-205,7,3452611,3452626,-15
6633cb8d8f483ae670107264,20220614,TK-205,7,3381416,3381430,-14
6633cb8d8f483ae670107265,20220617,TK-205,7,2847877,2847885,-8
6633cb8d8f483ae670107266,20220618,TK-205,7,2433346,2433359,-13
6633cb8d8f483ae670107267,20220623,TK-205,7,2582551,2582659,-108
6633cb8d8f483ae670107268,20220624,TK-205,7,3194898,3194817,81
6633cb8d8f483ae670107269,20220625,TK-205,7,2099946,2099956,-10
6633cb8d8f483ae67010726a,20220626,TK-205,7,32748,32748,0
6633cb8d8f483ae67010726b,20220627,TK-205,7,2585138,2585151,-13
6633cb8d8f483ae67010726c,20220628,TK-205,7,3008568,3008581,-13
6633cb8d8f483ae67010726d,20220630,TK-205,7,2707347,2707361,-14
6633cb8d8f483ae67010726e,20220702,TK-205,7,2734113,2734126,-13
6633cb8d8f483ae67010726f,20220703,TK-205,7,195097,195097,0
6633cb8d8f483ae670107270,20220704,TK-205,7,3103943,3103952,-9
6633cb8d8f483ae670107271,20220706,TK-205,7,2867965,2867975,-10
6633cb8d8f483ae670107272,20220707,TK-205,7,3209955,3209971,-16
6633cb8d8f483ae670107273,20220711,TK-205,7,653256,653257,-1
6633cb8d8f483ae670107274,20220712,TK-205,7,1124348,1124356,-8
6633cb8d8f483ae670107275,20220713,TK-205,7,1008140,1008147,-7
6633cb8d8f483ae670107276,20220714,TK-205,7,1494940,1494944,-4
6633cb8d8f483ae670107277,20220715,TK-205,7,1436727,1436733,-6
6633cb8d8f483ae670107278,20220716,TK-205,7,3115440,3115493,-53
6633cb8d8f483ae670107279,20220717,TK-205,7,92016,92016,0
6633cb8d8f483ae67010727a,20220718,TK-205,7,3507032,3506997,35
6633cb8d8f483ae67010727b,20220719,TK-205,7,3289820,3289831,-11
6633cb8d8f483ae67010727c,20220720,TK-205,7,3503235,3503245,-10
6633cb8d8f483ae67010727d,20220721,TK-205,7,2463857,2463868,-11
6633cb8d8f483ae67010727e,20220722,TK-205,7,3217975,3217986,-11
6633cb8d8f483ae67010727f,20220723,TK-205,7,2771876,2771888,-12
6633cb8d8f483ae670107280,20220724,TK-205,7,32707,32707,0
6633cb8d8f483ae670107281,20220725,TK-205,7,2848564,2848576,-12
6633cb8d8f483ae670107282,20220726,TK-205,7,2976003,2976012,-9
6633cb8d8f483ae670107283,20220727,TK-205,7,2570608,2570617,-9
6633cb8d8f483ae670107284,20220728,TK-205,7,2679728,2679836,-108
6633cb8d8f483ae670107285,20220729,TK-205,7,2499817,2499727,90
6633cb8d8f483ae670107286,20220730,TK-205,7,1992102,1992113,-11
6633cb8d8f483ae670107287,20220731,TK-205,7,35528,35528,0
6633cb8d8f483ae670107288,20220801,TK-205,7,4287869,4287877,-8
6633cb8d8f483ae670107289,20220802,TK-205,7,3407389,3407403,-14
6633cb8d8f483ae67010728a,20220803,TK-205,7,4351686,4351698,-12
6633cb8d8f483ae67010728b,20220804,TK-205,7,3443881,3443895,-14
6633cb8d8f483ae67010728c,20220807,TK-205,7,308320,308320,0
6633cb8d8f483ae67010728d,20220808,TK-205,7,2872506,2872512,-6
6633cb8d8f483ae67010728e,20220809,TK-205,7,2530070,2530079,-9
6633cb8d8f483ae67010728f,20220810,TK-205,7,2867179,2867191,-12
6633cb8d8f483ae670107290,20220811,TK-205,7,2689512,2689523,-11
6633cb8d8f483ae670107291,20220812,TK-205,7,2633260,2633271,-11
6633cb8d8f483ae670107292,20220813,TK-205,7,2270066,2270077,-11
6633cb8d8f483ae670107293,20220814,TK-205,7,305358,305358,0
6633cb8d8f483ae670107294,20220815,TK-205,7,2413540,2413550,-10
6633cb8d8f483ae670107295,20220818,TK-205,7,2903704,2903696,8
6633cb8d8f483ae670107296,20220819,TK-205,7,3139653,3139663,-10
6633cb8d8f483ae670107297,20220820,TK-205,7,2904553,2904563,-10
6633cb8d8f483ae670107298,20220821,TK-205,7,181157,181157,0
6633cb8d8f483ae670107299,20220822,TK-205,7,3098523,3098537,-14
6633cb8d8f483ae67010729a,20220823,TK-205,7,3210117,3210204,-87
6633cb8d8f483ae67010729b,20220824,TK-205,7,2606918,2606928,-10
6633cb8d8f483ae67010729c,20220825,TK-205,7,2798191,2798202,-11
6633cb8d8f483ae67010729d,20220826,TK-205,7,2947853,2947863,-10
6633cb8d8f483ae67010729e,20220827,TK-205,7,2749639,2749574,65
6633cb8d8f483ae67010729f,20220828,TK-205,7,220457,220457,0
6633cb8d8f483ae6701072a0,20220829,TK-205,7,3451762,3451773,-11
6633cb8d8f483ae6701072a1,20220830,TK-205,7,3047361,3047371,-10
6633cb8d8f483ae6701072a2,20220831,TK-205,7,3786398,3787144,-746
6633cb8d8f483ae6701072a3,20220901,TK-205,7,2326032,2325305,727
6633cb8d8f483ae6701072a4,20220904,TK-205,7,139863,139863,0
6633cb8d8f483ae6701072a5,20220905,TK-205,7,2422982,2422986,-4
6633cb8d8f483ae6701072a6,20220906,TK-205,7,2582481,2582481,0
6633cb8d8f483ae6701072a7,20220907,TK-205,7,2406917,2406920,-3
6633cb8d8f483ae6701072a8,20220908,TK-205,7,2765920,2765926,-6
6633cb8d8f483ae6701072a9,20220909,TK-205,7,3075764,3075776,-12
6633cb8d8f483ae6701072aa,20220912,TK-205,7,3015655,3015664,-9
6633cb8d8f483ae6701072ab,20220913,TK-205,7,2449754,2449765,-11
6633cb8d8f483ae6701072ac,20220914,TK-205,7,2109455,2109464,-9
6633cb8d8f483ae6701072ad,20220915,TK-205,7,1682415,1682423,-8
6633cb8d8f483ae6701072ae,20220918,TK-205,7,111979,111979,0
6633cb8d8f483ae6701072af,20220921,TK-205,7,3291213,3291223,-10
6633cb8d8f483ae6701072b0,20220924,TK-205,7,2035678,2035689,-11
6633cb8d8f483ae6701072b1,20220926,TK-205,7,2504676,2504686,-10
6633cb8d8f483ae6701072b2,20220927,TK-205,7,1914003,1914014,-11
6633cb8d8f483ae6701072b3,20220929,TK-205,7,1588404,1588413,-9
6633cb8d8f483ae6701072b4,20220930,TK-205,7,1632238,1632248,-10
6633cb8d8f483ae6701072b5,20221001,TK-205,7,2289981,2289986,-5
6633cb8d8f483ae6701072b6,20221004,TK-205,7,3659310,3659328,-18
6633cb8d8f483ae6701072b7,20221005,TK-205,7,2606158,2606171,-13
6633cb8d8f483ae6701072b8,20221006,TK-205,7,1515924,1515935,-11
6633cb8d8f483ae6701072b9,20221007,TK-205,7,2973,2973,0
6633cb8d8f483ae6701072ba,20221015,TK-205,7,3813550,3813565,-15
6633cb8d8f483ae6701072bb,20221016,TK-205,7,65436,65436,0
6633cb8d8f483ae6701072bc,20221017,TK-205,7,2591109,2591120,-11
6633cb8d8f483ae6701072bd,20221018,TK-205,7,2348938,2348950,-12
6633cb8d8f483ae6701072be,20221019,TK-205,7,2343101,2343111,-10
6633cb8d8f483ae6701072bf,20221020,TK-205,7,325994,325994,0
6633cb8d8f483ae6701072c0,20221021,TK-205,7,3173275,3173286,-11
6633cb8d8f483ae6701072c1,20221101,TK-205,7,1589987,1589995,-8
6633cb8d8f483ae6701072c2,20221102,TK-205,7,2334474,2334487,-13
6633cb8d8f483ae6701072c3,20221103,TK-205,7,2691043,2691051,-8
6633cb8d8f483ae6701072c4,20221104,TK-205,7,2785157,2785167,-10
6633cb8d8f483ae6701072c5,20221105,TK-205,7,2043081,2043090,-9
6633cb8d8f483ae6701072c6,20221106,TK-205,7,159225,159225,0
6633cb8d8f483ae6701072c7,20221107,TK-205,7,2606678,2606687,-9
6633cb8d8f483ae6701072c8,20221108,TK-205,7,2185740,2185748,-8
6633cb8d8f483ae6701072c9,20221109,TK-205,7,836938,836940,-2
6633cb8d8f483ae6701072ca,20221125,TK-205,7,1399660,1399663,-3
6633cb8d8f483ae6701072cb,20221126,TK-205,7,1984474,1984482,-8
6633cb8d8f483ae6701072cc,20221128,TK-205,7,2234459,2234469,-10
6633cb8d8f483ae6701072cd,20221129,TK-205,7,1672593,1672604,-11
6633cb8d8f483ae6701072ce,20221130,TK-205,7,1754595,1754605,-10
6633cb8d8f483ae6701072cf,20221201,TK-205,7,2115741,2115746,-5
6633cb8d8f483ae6701072d0,20221202,TK-205,7,3059171,3059179,-8
6633cb8d8f483ae6701072d1,20221203,TK-205,7,2684097,2684109,-12
6633cb8d8f483ae6701072d2,20221204,TK-205,7,307995,307995,0
6633cb8d8f483ae6701072d3,20221205,TK-205,7,3182375,3182385,-10
6633cb8d8f483ae6701072d4,20221206,TK-205,7,701278,701281,-3
6633cb8d8f483ae6701072d5,20230415,TK-205,7,1763605,1763614,-9
6633cb8d8f483ae6701072d6,20230416,TK-205,7,46768,46768,0
6633cb8d8f483ae6701072d7,20230512,TK-205,7,227253,227253,0
6633cb8d8f483ae6701072d8,20230513,TK-205,7,2153255,2153281,-26
6633cb8d8f483ae6701072d9,20230514,TK-205,7,96460,96460,0
6633cb8d8f483ae6701072da,20230515,TK-205,7,2978096,2978118,-22
6633cb8d8f483ae6701072db,20230517,TK-205,7,3596037,3596065,-28
6633cb8d8f483ae6701072dc,20230518,TK-205,7,3154787,3154808,-21
6633cb8d8f483ae6701072dd,20230519,TK-205,7,2487432,2487455,-23
6633cb8d8f483ae6701072de,20230616,TK-205,7,32707,32707,0
6633cb8d8f483ae6701072df,20210928,TK-300,12,19,20,-1
6633cb8d8f483ae6701072e0,20210929,TK-300,12,36,37,-1
6633cb8d8f483ae6701072e1,20210930,TK-300,12,52,53,-1
6633cb8d8f483ae6701072e2,20211001,TK-300,12,51,54,-3
6633cb8d8f483ae6701072e3,20211002,TK-300,12,7,7,0
6633cb8d8f483ae6701072e4,20211004,TK-300,12,22,22,0
6633cb8d8f483ae6701072e5,20211005,TK-300,12,22,29,-7
6633cb8d8f483ae6701072e6,20211006,TK-300,12,32,27,5
6633cb8d8f483ae6701072e7,20211007,TK-300,12,35,36,-1
6633cb8d8f483ae6701072e8,20211008,TK-300,12,54,57,-3
6633cb8d8f483ae6701072e9,20211009,TK-300,12,23,24,-1
6633cb8d8f483ae6701072ea,20211011,TK-300,12,21,22,-1
6633cb8d8f483ae6701072eb,20211012,TK-300,12,22,22,0
6633cb8d8f483ae6701072ec,20211015,TK-300,12,52,53,-1
6633cb8d8f483ae6701072ed,20211016,TK-300,12,29,30,-1
6633cb8d8f483ae6701072ee,20211018,TK-300,12,43,44,-1
6633cb8d8f483ae6701072ef,20211019,TK-300,12,15,15,0
6633cb8d8f483ae6701072f0,20211020,TK-300,12,7,7,0
6633cb8d8f483ae6701072f1,20211021,TK-300,12,43,45,-2
6633cb8d8f483ae6701072f2,20211022,TK-300,12,43,45,-2
6633cb8d8f483ae6701072f3,20211023,TK-300,12,7,7,0
6633cb8d8f483ae6701072f4,20211025,TK-300,12,28,29,-1
6633cb8d8f483ae6701072f5,20211026,TK-300,12,13,14,-1
6633cb8d8f483ae6701072f6,20211027,TK-300,12,36,36,0
6633cb8d8f483ae6701072f7,20211028,TK-300,12,29,31,-2
6633cb8d8f483ae6701072f8,20211029,TK-300,12,26,27,-1
6633cb8d8f483ae6701072f9,20211030,TK-300,12,37,38,-1
6633cb8d8f483ae6701072fa,20211101,TK-300,12,29,29,0
6633cb8d8f483ae6701072fb,20211102,TK-300,12,36,38,-2
6633cb8d8f483ae6701072fc,20211103,TK-300,12,15,15,0
6633cb8d8f483ae6701072fd,20211104,TK-300,12,29,30,-1
6633cb8d8f483ae6701072fe,20211105,TK-300,12,41,42,-1
6633cb8d8f483ae6701072ff,20211106,TK-300,12,17,18,-1
6633cb8d8f483ae670107300,20211108,TK-300,12,14,14,0
6633cb8d8f483ae670107301,20211109,TK-300,12,15,15,0
6633cb8d8f483ae670107302,20211110,TK-300,12,29,30,-1
6633cb8d8f483ae670107303,20211111,TK-300,12,34,36,-2
6633cb8d8f483ae670107304,20211112,TK-300,12,57,60,-3
6633cb8d8f483ae670107305,20211113,TK-300,12,21,21,0
6633cb8d8f483ae670107306,20211115,TK-300,12,34,36,-2
6633cb8d8f483ae670107307,20211116,TK-300,12,29,30,-1
6633cb8d8f483ae670107308,20211117,TK-300,12,44,47,-3
6633cb8d8f483ae670107309,20211118,TK-300,12,7,7,0
6633cb8d8f483ae67010730a,20211119,TK-300,12,43,44,-1
6633cb8d8f483ae67010730b,20211120,TK-300,12,21,21,0
6633cb8d8f483ae67010730c,20211122,TK-300,12,21,22,-1
6633cb8d8f483ae67010730d,20211123,TK-300,12,34,35,-1
6633cb8d8f483ae67010730e,20211124,TK-300,12,49,51,-2
6633cb8d8f483ae67010730f,20211125,TK-300,12,23,23,0
6633cb8d8f483ae670107310,20211126,TK-300,12,50,52,-2
6633cb8d8f483ae670107311,20211127,TK-300,12,43,44,-1
6633cb8d8f483ae670107312,20211129,TK-300,12,23,24,-1
6633cb8d8f483ae670107313,20211130,TK-300,12,21,22,-1
6633cb8d8f483ae670107314,20211201,TK-300,12,35,36,-1
6633cb8d8f483ae670107315,20211202,TK-300,12,29,30,-1
6633cb8d8f483ae670107316,20211203,TK-300,12,35,36,-1
6633cb8d8f483ae670107317,20211204,TK-300,12,45,47,-2
6633cb8d8f483ae670107318,20211206,TK-300,12,22,23,-1
6633cb8d8f483ae670107319,20211207,TK-300,12,29,30,-1
6633cb8d8f483ae67010731a,20211208,TK-300,12,49,52,-3
6633cb8d8f483ae67010731b,20211209,TK-300,12,28,28,0
6633cb8d8f483ae67010731c,20211210,TK-300,12,33,34,-1
6633cb8d8f483ae67010731d,20211211,TK-300,12,31,31,0
6633cb8d8f483ae67010731e,20211213,TK-300,12,15,15,0
6633cb8d8f483ae67010731f,20211214,TK-300,12,42,45,-3
6633cb8d8f483ae670107320,20211215,TK-300,12,38,40,-2
6633cb8d8f483ae670107321,20211216,TK-300,12,7,7,0
6633cb8d8f483ae670107322,20211217,TK-300,12,27,28,-1
6633cb8d8f483ae670107323,20211218,TK-300,12,48,51,-3
6633cb8d8f483ae670107324,20211220,TK-300,12,38,39,-1
6633cb8d8f483ae670107325,20211221,TK-300,12,57,58,-1
6633cb8d8f483ae670107326,20211222,TK-300,12,54,56,-2
6633cb8d8f483ae670107327,20211223,TK-300,12,42,44,-2
6633cb8d8f483ae670107328,20211224,TK-300,12,61,63,-2
6633cb8d8f483ae670107329,20211225,TK-300,12,33,34,-1
6633cb8d8f483ae67010732a,20211227,TK-300,12,57,60,-3
6633cb8d8f483ae67010732b,20211228,TK-300,12,61,64,-3
6633cb8d8f483ae67010732c,20211229,TK-300,12,33,35,-2
6633cb8d8f483ae67010732d,20211230,TK-300,12,41,44,-3
6633cb8d8f483ae67010732e,20211231,TK-300,12,47,48,-1
6633cb8d8f483ae67010732f,20220101,TK-300,12,39,41,-2
6633cb8d8f483ae670107330,20220103,TK-300,12,58,60,-2
6633cb8d8f483ae670107331,20220104,TK-300,12,40,41,-1
6633cb8d8f483ae670107332,20220105,TK-300,12,22,22,0
6633cb8d8f483ae670107333,20220106,TK-300,12,26,27,-1
6633cb8d8f483ae670107334,20220107,TK-300,12,43,45,-2
6633cb8d8f483ae670107335,20220110,TK-300,12,15,15,0
6633cb8d8f483ae670107336,20220111,TK-300,12,37,39,-2
6633cb8d8f483ae670107337,20220112,TK-300,12,15,15,0
6633cb8d8f483ae670107338,20220113,TK-300,12,7,7,0
6633cb8d8f483ae670107339,20220114,TK-300,12,35,36,-1
6633cb8d8f483ae67010733a,20220115,TK-300,12,35,36,-1
6633cb8d8f483ae67010733b,20220117,TK-300,12,21,22,-1
6633cb8d8f483ae67010733c,20220118,TK-300,12,37,39,-2
6633cb8d8f483ae67010733d,20220119,TK-300,12,15,15,0
6633cb8d8f483ae67010733e,20220120,TK-300,12,28,29,-1
6633cb8d8f483ae67010733f,20220121,TK-300,12,43,45,-2
6633cb8d8f483ae670107340,20220122,TK-300,12,20,21,-1
6633cb8d8f483ae670107341,20220124,TK-300,12,15,15,0
6633cb8d8f483ae670107342,20220125,TK-300,12,37,39,-2
6633cb8d8f483ae670107343,20220126,TK-300,12,22,23,-1
6633cb8d8f483ae670107344,20220127,TK-300,12,14,14,0
6633cb8d8f483ae670107345,20220128,TK-300,12,43,45,-2
6633cb8d8f483ae670107346,20220129,TK-300,12,22,22,0
6633cb8d8f483ae670107347,20220131,TK-300,12,57,60,-3
6633cb8d8f483ae670107348,20220201,TK-300,12,22,23,-1
6633cb8d8f483ae670107349,20220202,TK-300,12,36,37,-1
6633cb8d8f483ae67010734a,20220203,TK-300,12,49,51,-2
6633cb8d8f483ae67010734b,20220204,TK-300,12,29,30,-1
6633cb8d8f483ae67010734c,20220205,TK-300,12,16,16,0
6633cb8d8f483ae67010734d,20220207,TK-300,12,22,22,0
6633cb8d8f483ae67010734e,20220208,TK-300,12,26,27,-1
6633cb8d8f483ae67010734f,20220209,TK-300,12,45,47,-2
6633cb8d8f483ae670107350,20220210,TK-300,12,42,45,-3
6633cb8d8f483ae670107351,20220211,TK-300,12,29,30,-1
6633cb8d8f483ae670107352,20220212,TK-300,12,36,37,-1
6633cb8d8f483ae670107353,20220214,TK-300,12,39,40,-1
6633cb8d8f483ae670107354,20220215,TK-300,12,32,33,-1
6633cb8d8f483ae670107355,20220216,TK-300,12,42,44,-2
6633cb8d8f483ae670107356,20220217,TK-300,12,36,37,-1
6633cb8d8f483ae670107357,20220218,TK-300,12,39,41,-2
6633cb8d8f483ae670107358,20220219,TK-300,12,22,22,0
6633cb8d8f483ae670107359,20220221,TK-300,12,29,31,-2
6633cb8d8f483ae67010735a,20220222,TK-300,12,28,29,-1
6633cb8d8f483ae67010735b,20220223,TK-300,12,20,21,-1
6633cb8d8f483ae67010735c,20220224,TK-300,12,15,15,0
6633cb8d8f483ae67010735d,20220225,TK-300,12,27,28,-1
6633cb8d8f483ae67010735e,20220226,TK-300,12,29,30,-1
6633cb8d8f483ae67010735f,20220228,TK-300,12,28,29,-1
6633cb8d8f483ae670107360,20220301,TK-300,12,21,22,-1
6633cb8d8f483ae670107361,20220302,TK-300,12,29,30,-1
6633cb8d8f483ae670107362,20220303,TK-300,12,29,31,-2
6633cb8d8f483ae670107363,20220304,TK-300,12,43,46,-3
6633cb8d8f483ae670107364,20220305,TK-300,12,27,28,-1
6633cb8d8f483ae670107365,20220307,TK-300,12,15,15,0
6633cb8d8f483ae670107366,20220308,TK-300,12,44,46,-2
6633cb8d8f483ae670107367,20220309,TK-300,12,15,15,0
6633cb8d8f483ae670107368,20220310,TK-300,12,22,23,-1
6633cb8d8f483ae670107369,20220311,TK-300,12,47,48,-1
6633cb8d8f483ae67010736a,20220312,TK-300,12,50,52,-2
6633cb8d8f483ae67010736b,20220314,TK-300,12,44,45,-1
6633cb8d8f483ae67010736c,20220315,TK-300,12,62,65,-3
6633cb8d8f483ae67010736d,20220316,TK-300,12,56,59,-3
6633cb8d8f483ae67010736e,20220317,TK-300,12,43,45,-2
6633cb8d8f483ae67010736f,20220318,TK-300,12,34,35,-1
6633cb8d8f483ae670107370,20220319,TK-300,12,64,67,-3
6633cb8d8f483ae670107371,20220321,TK-300,12,40,42,-2
6633cb8d8f483ae670107372,20220322,TK-300,12,36,37,-1
6633cb8d8f483ae670107373,20220323,TK-300,12,28,29,-1
6633cb8d8f483ae670107374,20220324,TK-300,12,25,26,-1
6633cb8d8f483ae670107375,20220325,TK-300,12,16,16,0
6633cb8d8f483ae670107376,20220326,TK-300,12,21,21,0
6633cb8d8f483ae670107377,20220328,TK-300,12,37,38,-1
6633cb8d8f483ae670107378,20220329,TK-300,12,30,31,-1
6633cb8d8f483ae670107379,20220330,TK-300,12,43,45,-2
6633cb8d8f483ae67010737a,20220331,TK-300,12,23,23,0
6633cb8d8f483ae67010737b,20220401,TK-300,12,39,40,-1
6633cb8d8f483ae67010737c,20220402,TK-300,12,29,30,-1
6633cb8d8f483ae67010737d,20220404,TK-300,12,22,22,0
6633cb8d8f483ae67010737e,20220405,TK-300,12,36,37,-1
6633cb8d8f483ae67010737f,20220407,TK-300,12,30,31,-1
6633cb8d8f483ae670107380,20220408,TK-300,12,15,15,0
6633cb8d8f483ae670107381,20220409,TK-300,12,28,29,-1
6633cb8d8f483ae670107382,20220411,TK-300,12,7,7,0
6633cb8d8f483ae670107383,20220412,TK-300,12,19,20,-1
6633cb8d8f483ae670107384,20220413,TK-300,12,9,9,0
6633cb8d8f483ae670107385,20220414,TK-300,12,22,23,-1
6633cb8d8f483ae670107386,20220415,TK-300,12,15,15,0
6633cb8d8f483ae670107387,20220416,TK-300,12,44,45,-1
6633cb8d8f483ae670107388,20220418,TK-300,12,14,14,0
6633cb8d8f483ae670107389,20220419,TK-300,12,15,15,0
6633cb8d8f483ae67010738a,20220420,TK-300,12,21,21,0
6633cb8d8f483ae67010738b,20220421,TK-300,12,57,59,-2
6633cb8d8f483ae67010738c,20220422,TK-300,12,15,15,0
6633cb8d8f483ae67010738d,20220423,TK-300,12,7,7,0
6633cb8d8f483ae67010738e,20220424,TK-300,12,22,22,0
6633cb8d8f483ae67010738f,20220425,TK-300,12,30,31,-1
6633cb8d8f483ae670107390,20220426,TK-300,12,7,7,0
6633cb8d8f483ae670107391,20220427,TK-300,12,35,37,-2
6633cb8d8f483ae670107392,20220428,TK-300,12,42,44,-2
6633cb8d8f483ae670107393,20220429,TK-300,12,31,33,-2
6633cb8d8f483ae670107394,20220503,TK-300,12,7,7,0
6633cb8d8f483ae670107395,20220504,TK-300,12,30,31,-1
6633cb8d8f483ae670107396,20220505,TK-300,12,48,50,-2
6633cb8d8f483ae670107397,20220506,TK-300,12,15,15,0
6633cb8d8f483ae670107398,20220507,TK-300,12,11,11,0
6633cb8d8f483ae670107399,20220509,TK-300,12,27,28,-1
6633cb8d8f483ae67010739a,20220510,TK-300,12,29,29,0
6633cb8d8f483ae67010739b,20220511,TK-300,12,21,22,-1
6633cb8d8f483ae67010739c,20220512,TK-300,12,22,23,-1
6633cb8d8f483ae67010739d,20220513,TK-300,12,51,54,-3
6633cb8d8f483ae67010739e,20220514,TK-300,12,25,26,-1
6633cb8d8f483ae67010739f,20220516,TK-300,12,22,23,-1
6633cb8d8f483ae6701073a0,20220517,TK-300,12,40,42,-2
6633cb8d8f483ae6701073a1,20220518,TK-300,12,58,61,-3
6633cb8d8f483ae6701073a2,20220519,TK-300,12,26,27,-1
6633cb8d8f483ae6701073a3,20220520,TK-300,12,29,30,-1
6633cb8d8f483ae6701073a4,20220521,TK-300,12,31,31,0
6633cb8d8f483ae6701073a5,20220523,TK-300,12,35,36,-1
6633cb8d8f483ae6701073a6,20220524,TK-300,12,42,44,-2
6633cb8d8f483ae6701073a7,20220525,TK-300,12,20,20,0
6633cb8d8f483ae6701073a8,20220526,TK-300,12,21,22,-1
6633cb8d8f483ae6701073a9,20220527,TK-300,12,43,45,-2
6633cb8d8f483ae6701073aa,20220528,TK-300,12,23,23,0
6633cb8d8f483ae6701073ab,20220530,TK-300,12,14,14,0
6633cb8d8f483ae6701073ac,20220531,TK-300,12,28,29,-1
6633cb8d8f483ae6701073ad,20220601,TK-300,12,15,15,0
6633cb8d8f483ae6701073ae,20220602,TK-300,12,27,28,-1
6633cb8d8f483ae6701073af,20220603,TK-300,12,35,37,-2
6633cb8d8f483ae6701073b0,20220604,TK-300,12,35,37,-2
6633cb8d8f483ae6701073b1,20220606,TK-300,12,27,29,-2
6633cb8d8f483ae6701073b2,20220607,TK-300,12,21,21,0
6633cb8d8f483ae6701073b3,20220608,TK-300,12,35,36,-1
6633cb8d8f483ae6701073b4,20220609,TK-300,12,15,15,0
6633cb8d8f483ae6701073b5,20220610,TK-300,12,49,52,-3
6633cb8d8f483ae6701073b6,20220611,TK-300,12,47,50,-3
6633cb8d8f483ae6701073b7,20220613,TK-300,12,30,31,-1
6633cb8d8f483ae6701073b8,20220614,TK-300,12,38,39,-1
6633cb8d8f483ae6701073b9,20220615,TK-300,12,52,55,-3
6633cb8d8f483ae6701073ba,20220616,TK-300,12,21,22,-1
6633cb8d8f483ae6701073bb,20220617,TK-300,12,15,15,0
6633cb8d8f483ae6701073bc,20220618,TK-300,12,26,27,-1
6633cb8d8f483ae6701073bd,20220620,TK-300,12,39,41,-2
6633cb8d8f483ae6701073be,20220621,TK-300,12,49,51,-2
6633cb8d8f483ae6701073bf,20220622,TK-300,12,60,62,-2
6633cb8d8f483ae6701073c0,20220623,TK-300,12,38,40,-2
6633cb8d8f483ae6701073c1,20220624,TK-300,12,49,50,-1
6633cb8d8f483ae6701073c2,20220625,TK-300,12,21,22,-1
6633cb8d8f483ae6701073c3,20220627,TK-300,12,35,36,-1
6633cb8d8f483ae6701073c4,20220628,TK-300,12,39,40,-1
6633cb8d8f483ae6701073c5,20220629,TK-300,12,10,10,0
6633cb8d8f483ae6701073c6,20220630,TK-300,12,53,55,-2
6633cb8d8f483ae6701073c7,20220701,TK-300,12,35,37,-2
6633cb8d8f483ae6701073c8,20220702,TK-300,12,50,53,-3
6633cb8d8f483ae6701073c9,20220704,TK-300,12,26,26,0
6633cb8d8f483ae6701073ca,20220705,TK-300,12,29,30,-1
6633cb8d8f483ae6701073cb,20220706,TK-300,12,48,50,-2
6633cb8d8f483ae6701073cc,20220707,TK-300,12,47,49,-2
6633cb8d8f483ae6701073cd,20220708,TK-300,12,66,69,-3
6633cb8d8f483ae6701073ce,20220709,TK-300,12,14,14,0
6633cb8d8f483ae6701073cf,20220712,TK-300,12,25,26,-1
6633cb8d8f483ae6701073d0,20220713,TK-300,12,15,15,0
6633cb8d8f483ae6701073d1,20220714,TK-300,12,13,13,0
6633cb8d8f483ae6701073d2,20220715,TK-300,12,7,7,0
6633cb8d8f483ae6701073d3,20220716,TK-300,12,21,21,0
6633cb8d8f483ae6701073d4,20220718,TK-300,12,42,43,-1
6633cb8d8f483ae6701073d5,20220719,TK-300,12,36,38,-2
6633cb8d8f483ae6701073d6,20220720,TK-300,12,31,33,-2
6633cb8d8f483ae6701073d7,20220721,TK-300,12,35,36,-1
6633cb8d8f483ae6701073d8,20220722,TK-300,12,28,29,-1
6633cb8d8f483ae6701073d9,20220723,TK-300,12,27,27,0
6633cb8d8f483ae6701073da,20220725,TK-300,12,35,37,-2
6633cb8d8f483ae6701073db,20220726,TK-300,12,17,18,-1
6633cb8d8f483ae6701073dc,20220727,TK-300,12,28,29,-1
6633cb8d8f483ae6701073dd,20220728,TK-300,12,8,8,0
6633cb8d8f483ae6701073de,20220729,TK-300,12,8,8,0
6633cb8d8f483ae6701073df,20220730,TK-300,12,16,16,0
6633cb8d8f483ae6701073e0,20220731,TK-300,12,8,8,0
6633cb8d8f483ae6701073e1,20220801,TK-300,12,32,33,-1
6633cb8d8f483ae6701073e2,20220802,TK-300,12,24,24,0
6633cb8d8f483ae6701073e3,20220803,TK-300,12,32,33,-1
6633cb8d8f483ae6701073e4,20220804,TK-300,12,48,49,-1
6633cb8d8f483ae6701073e5,20220805,TK-300,12,32,33,-1
6633cb8d8f483ae6701073e6,20220806,TK-300,12,14,14,0
6633cb8d8f483ae6701073e7,20220808,TK-300,12,11,12,-1
6633cb8d8f483ae6701073e8,20220809,TK-300,12,31,32,-1
6633cb8d8f483ae6701073e9,20220810,TK-300,12,43,44,-1
6633cb8d8f483ae6701073ea,20220811,TK-300,12,19,20,-1
6633cb8d8f483ae6701073eb,20220812,TK-300,12,14,14,0
6633cb8d8f483ae6701073ec,20220813,TK-300,12,14,14,0
6633cb8d8f483ae6701073ed,20220815,TK-300,12,21,21,0
6633cb8d8f483ae6701073ee,20220816,TK-300,12,39,40,-1
6633cb8d8f483ae6701073ef,20220817,TK-300,12,27,27,0
6633cb8d8f483ae6701073f0,20220818,TK-300,12,33,34,-1
6633cb8d8f483ae6701073f1,20220819,TK-300,12,25,26,-1
6633cb8d8f483ae6701073f2,20220820,TK-300,12,30,31,-1
6633cb8d8f483ae6701073f3,20220822,TK-300,12,59,61,-2
6633cb8d8f483ae6701073f4,20220823,TK-300,12,14,14,0
6633cb8d8f483ae6701073f5,20220824,TK-300,12,34,35,-1
6633cb8d8f483ae6701073f6,20220825,TK-300,12,54,57,-3
6633cb8d8f483ae6701073f7,20220826,TK-300,12,19,20,-1
6633cb8d8f483ae6701073f8,20220827,TK-300,12,29,31,-2
6633cb8d8f483ae6701073f9,20220829,TK-300,12,21,21,0
6633cb8d8f483ae6701073fa,20220830,TK-300,12,36,37,-1
6633cb8d8f483ae6701073fb,20220831,TK-300,12,44,53,-9
6633cb8d8f483ae6701073fc,20220901,TK-300,12,15,15,0
6633cb8d8f483ae6701073fd,20220902,TK-300,12,35,37,-2
6633cb8d8f483ae6701073fe,20220903,TK-300,12,29,30,-1
6633cb8d8f483ae6701073ff,20220905,TK-300,12,27,28,-1
6633cb8d8f483ae670107400,20220906,TK-300,12,7,7,0
6633cb8d8f483ae670107401,20220907,TK-300,12,27,28,-1
6633cb8d8f483ae670107402,20220908,TK-300,12,34,35,-1
6633cb8d8f483ae670107403,20220909,TK-300,12,33,35,-2
6633cb8d8f483ae670107404,20220910,TK-300,12,28,29,-1
6633cb8d8f483ae670107405,20220912,TK-300,12,21,21,0
6633cb8d8f483ae670107406,20220913,TK-300,12,17,17,0
6633cb8d8f483ae670107407,20220914,TK-300,12,21,21,0
6633cb8d8f483ae670107408,20220915,TK-300,12,21,22,-1
6633cb8d8f483ae670107409,20220916,TK-300,12,35,36,-1
6633cb8d8f483ae67010740a,20220917,TK-300,12,36,37,-1
6633cb8d8f483ae67010740b,20220918,TK-300,12,5,5,0
6633cb8d8f483ae67010740c,20220919,TK-300,12,28,29,-1
6633cb8d8f483ae67010740d,20220920,TK-300,12,40,42,-2
6633cb8d8f483ae67010740e,20220921,TK-300,12,25,26,-1
6633cb8d8f483ae67010740f,20220922,TK-300,12,21,22,-1
6633cb8d8f483ae670107410,20220923,TK-300,12,13,14,-1
6633cb8d8f483ae670107411,20220924,TK-300,12,14,14,0
6633cb8d8f483ae670107412,20220926,TK-300,12,22,22,0
6633cb8d8f483ae670107413,20220927,TK-300,12,41,42,-1
6633cb8d8f483ae670107414,20220928,TK-300,12,14,14,0
6633cb8d8f483ae670107415,20220929,TK-300,12,14,14,0
6633cb8d8f483ae670107416,20220930,TK-300,12,14,15,-1
6633cb8d8f483ae670107417,20221001,TK-300,12,21,21,0
6633cb8d8f483ae670107418,20221004,TK-300,12,42,43,-1
6633cb8d8f483ae670107419,20221005,TK-300,12,42,43,-1
6633cb8d8f483ae67010741a,20221006,TK-300,12,30,32,-2
6633cb8d8f483ae67010741b,20221007,TK-300,12,13,14,-1
6633cb8d8f483ae67010741c,20221008,TK-300,12,34,35,-1
6633cb8d8f483ae67010741d,20221010,TK-300,12,22,22,0
6633cb8d8f483ae67010741e,20221011,TK-300,12,29,30,-1
6633cb8d8f483ae67010741f,20221012,TK-300,12,32,33,-1
6633cb8d8f483ae670107420,20221013,TK-300,12,51,53,-2
6633cb8d8f483ae670107421,20221014,TK-300,12,36,37,-1
6633cb8d8f483ae670107422,20221015,TK-300,12,43,45,-2
6633cb8d8f483ae670107423,20221017,TK-300,12,14,14,0
6633cb8d8f483ae670107424,20221018,TK-300,12,20,20,0
6633cb8d8f483ae670107425,20221019,TK-300,12,8,8,0
6633cb8d8f483ae670107426,20221021,TK-300,12,36,37,-1
6633cb8d8f483ae670107427,20221022,TK-300,12,13,21,-8
6633cb8d8f483ae670107428,20221024,TK-300,12,28,21,7
6633cb8d8f483ae670107429,20221025,TK-300,12,7,7,0
6633cb8d8f483ae67010742a,20221026,TK-300,12,34,35,-1
6633cb8d8f483ae67010742b,20221027,TK-300,12,35,37,-2
6633cb8d8f483ae67010742c,20221028,TK-300,12,29,30,-1
6633cb8d8f483ae67010742d,20221029,TK-300,12,36,37,-1
6633cb8d8f483ae67010742e,20221031,TK-300,12,49,52,-3
6633cb8d8f483ae67010742f,20221101,TK-300,12,20,21,-1
6633cb8d8f483ae670107430,20221102,TK-300,12,6,6,0
6633cb8d8f483ae670107431,20221103,TK-300,12,14,14,0
6633cb8d8f483ae670107432,20221104,TK-300,12,14,14,0
6633cb8d8f483ae670107433,20221105,TK-300,12,13,14,-1
6633cb8d8f483ae670107434,20221107,TK-300,12,29,29,0
6633cb8d8f483ae670107435,20221108,TK-300,12,14,14,0
6633cb8d8f483ae670107436,20221109,TK-300,12,22,22,0
6633cb8d8f483ae670107437,20221110,TK-300,12,21,22,-1
6633cb8d8f483ae670107438,20221111,TK-300,12,26,27,-1
6633cb8d8f483ae670107439,20221112,TK-300,12,14,14,0
6633cb8d8f483ae67010743a,20221114,TK-300,12,20,20,0
6633cb8d8f483ae67010743b,20221115,TK-300,12,7,7,0
6633cb8d8f483ae67010743c,20221116,TK-300,12,28,29,-1
6633cb8d8f483ae67010743d,20221117,TK-300,12,35,36,-1
6633cb8d8f483ae67010743e,20221118,TK-300,12,39,41,-2
6633cb8d8f483ae67010743f,20221119,TK-300,12,7,7,0
6633cb8d8f483ae670107440,20221121,TK-300,12,44,45,-1
6633cb8d8f483ae670107441,20221122,TK-300,12,27,28,-1
6633cb8d8f483ae670107442,20221123,TK-300,12,23,23,0
6633cb8d8f483ae670107443,20221124,TK-300,12,42,43,-1
6633cb8d8f483ae670107444,20221125,TK-300,12,35,37,-2
6633cb8d8f483ae670107445,20221126,TK-300,12,7,7,0
6633cb8d8f483ae670107446,20221128,TK-300,12,28,29,-1
6633cb8d8f483ae670107447,20221129,TK-300,12,22,23,-1
6633cb8d8f483ae670107448,20221130,TK-300,12,28,29,-1
6633cb8d8f483ae670107449,20221201,TK-300,12,7,7,0
6633cb8d8f483ae67010744a,20221202,TK-300,12,14,14,0
6633cb8d8f483ae67010744b,20221203,TK-300,12,48,51,-3
6633cb8d8f483ae67010744c,20221205,TK-300,12,31,33,-2
6633cb8d8f483ae67010744d,20221206,TK-300,12,36,37,-1
6633cb8d8f483ae67010744e,20221207,TK-300,12,35,37,-2
6633cb8d8f483ae67010744f,20221208,TK-300,12,8,8,0
6633cb8d8f483ae670107450,20221209,TK-300,12,26,27,-1
6633cb8d8f483ae670107451,20221210,TK-300,12,13,13,0
6633cb8d8f483ae670107452,20221212,TK-300,12,21,21,0
6633cb8d8f483ae670107453,20221213,TK-300,12,13,13,0
6633cb8d8f483ae670107454,20221215,TK-300,12,12,12,0
6633cb8d8f483ae670107455,20221216,TK-300,12,32,33,-1
6633cb8d8f483ae670107456,20221217,TK-300,12,34,35,-1
6633cb8d8f483ae670107457,20221219,TK-300,12,18,19,-1
6633cb8d8f483ae670107458,20221220,TK-300,12,21,21,0
6633cb8d8f483ae670107459,20221221,TK-300,12,33,34,-1
6633cb8d8f483ae67010745a,20221222,TK-300,12,21,21,0
6633cb8d8f483ae67010745b,20221223,TK-300,12,33,35,-2
6633cb8d8f483ae67010745c,20221224,TK-300,12,28,30,-2
6633cb8d8f483ae67010745d,20221226,TK-300,12,13,14,-1
6633cb8d8f483ae67010745e,20221227,TK-300,12,23,24,-1
6633cb8d8f483ae67010745f,20221228,TK-300,12,15,15,0
6633cb8d8f483ae670107460,20221229,TK-300,12,32,34,-2
6633cb8d8f483ae670107461,20221230,TK-300,12,10,12,-2
6633cb8d8f483ae670107462,20221231,TK-300,12,14,14,0
6633cb8d8f483ae670107463,20230101,TK-300,12,6,6,0
6633cb8d8f483ae670107464,20230102,TK-300,12,34,35,-1
6633cb8d8f483ae670107465,20230103,TK-300,12,42,44,-2
6633cb8d8f483ae670107466,20230104,TK-300,12,30,31,-1
6633cb8d8f483ae670107467,20230105,TK-300,12,28,29,-1
6633cb8d8f483ae670107468,20230106,TK-300,12,7,7,0
6633cb8d8f483ae670107469,20230107,TK-300,12,13,13,0
6633cb8d8f483ae67010746a,20230109,TK-300,12,21,22,-1
6633cb8d8f483ae67010746b,20230110,TK-300,12,21,22,-1
6633cb8d8f483ae67010746c,20230111,TK-300,12,13,14,-1
6633cb8d8f483ae67010746d,20230112,TK-300,12,21,22,-1
6633cb8d8f483ae67010746e,20230113,TK-300,12,13,17,-4
6633cb8d8f483ae67010746f,20230114,TK-300,12,7,3,4
6633cb8d8f483ae670107470,20230116,TK-300,12,15,15,0
6633cb8d8f483ae670107471,20230117,TK-300,12,14,14,0
6633cb8d8f483ae670107472,20230118,TK-300,12,21,22,-1
6633cb8d8f483ae670107473,20230119,TK-300,12,13,13,0
6633cb8d8f483ae670107474,20230120,TK-300,12,43,46,-3
6633cb8d8f483ae670107475,20230121,TK-300,12,14,14,0
6633cb8d8f483ae670107476,20230123,TK-300,12,22,23,-1
6633cb8d8f483ae670107477,20230301,TK-300,12,0,0,0
6633cb8d8f483ae670107478,20230307,TK-300,12,0,0,0
6633cb8d8f483ae670107479,20230308,TK-300,12,0,0,0
6633cb8d8f483ae67010747a,20230313,TK-300,12,0,0,0
6633cb8d8f483ae67010747b,20230314,TK-300,12,0,0,0
6633cb8d8f483ae67010747c,20230112,TK-305,1,40528,40020,508
6633cb8d8f483ae67010747d,20230124,TK-305,1,27440,27000,440
6633cb8d8f483ae67010747e,20230125,TK-305,1,28497,28040,457
6633cb8d8f483ae67010747f,20230128,TK-305,1,29879,29400,479
6633cb8d8f483ae670107480,20230213,TK-305,1,75950,75400,550
6633cb8d8f483ae670107481,20230214,TK-305,1,47524,47180,344
6633cb8d8f483ae670107482,20230215,TK-305,1,28587,28380,207
6633cb8d8f483ae670107483,20230216,TK-305,1,47303,46960,343
6633cb8d8f483ae670107484,20230323,TK-305,1,28204,28000,204
6633cb8d8f483ae670107485,20230409,TK-305,1,55641,54960,681
6633cb8d8f483ae670107486,20230421,TK-305,1,55927,55600,327
6633cb8d8f483ae670107487,20230523,TK-305,1,28271,27900,371
6633cb8d8f483ae670107488,20230524,TK-305,1,48571,48220,351
6633cb8d8f483ae670107489,20230411,TK-306,1,56300,56240,60
6633cb8d8f483ae67010748a,20210928,TK-400,13,1,2,-1
6633cb8d8f483ae67010748b,20210929,TK-400,13,0,2,-2
6633cb8d8f483ae67010748c,20210930,TK-400,13,0,2,-2
6633cb8d8f483ae67010748d,20211001,TK-400,13,0,2,-2
6633cb8d8f483ae67010748e,20211002,TK-400,13,0,0,0
6633cb8d8f483ae67010748f,20211004,TK-400,13,0,1,-1
6633cb8d8f483ae670107490,20211005,TK-400,13,0,2,-2
6633cb8d8f483ae670107491,20211006,TK-400,13,2,3,-1
6633cb8d8f483ae670107492,20211007,TK-400,13,1,3,-2
6633cb8d8f483ae670107493,20211008,TK-400,13,1,5,-4
6633cb8d8f483ae670107494,20211009,TK-400,13,0,0,0
6633cb8d8f483ae670107495,20211011,TK-400,13,0,1,-1
6633cb8d8f483ae670107496,20211012,TK-400,13,0,1,-1
6633cb8d8f483ae670107497,20211015,TK-400,13,1,2,-1
6633cb8d8f483ae670107498,20211016,TK-400,13,0,1,-1
6633cb8d8f483ae670107499,20211018,TK-400,13,0,3,-3
6633cb8d8f483ae67010749a,20211019,TK-400,13,0,0,0
6633cb8d8f483ae67010749b,20211020,TK-400,13,0,0,0
6633cb8d8f483ae67010749c,20211021,TK-400,13,1,3,-2
6633cb8d8f483ae67010749d,20211022,TK-400,13,0,2,-2
6633cb8d8f483ae67010749e,20211023,TK-400,13,0,0,0
6633cb8d8f483ae67010749f,20211025,TK-400,13,0,2,-2
6633cb8d8f483ae6701074a0,20211026,TK-400,13,1,1,0
6633cb8d8f483ae6701074a1,20211027,TK-400,13,0,2,-2
6633cb8d8f483ae6701074a2,20211028,TK-400,13,1,3,-2
6633cb8d8f483ae6701074a3,20211029,TK-400,13,1,3,-2
6633cb8d8f483ae6701074a4,20211030,TK-400,13,1,2,-1
6633cb8d8f483ae6701074a5,20211101,TK-400,13,0,2,-2
6633cb8d8f483ae6701074a6,20211102,TK-400,13,0,2,-2
6633cb8d8f483ae6701074a7,20211103,TK-400,13,0,0,0
6633cb8d8f483ae6701074a8,20211104,TK-400,13,0,1,-1
6633cb8d8f483ae6701074a9,20211105,TK-400,13,2,4,-2
6633cb8d8f483ae6701074aa,20211106,TK-400,13,0,1,-1
6633cb8d8f483ae6701074ab,20211108,TK-400,13,0,1,-1
6633cb8d8f483ae6701074ac,20211109,TK-400,13,0,0,0
6633cb8d8f483ae6701074ad,20211110,TK-400,13,0,1,-1
6633cb8d8f483ae6701074ae,20211111,TK-400,13,0,2,-2
6633cb8d8f483ae6701074af,20211112,TK-400,13,0,3,-3
6633cb8d8f483ae6701074b0,20211113,TK-400,13,0,1,-1
6633cb8d8f483ae6701074b1,20211115,TK-400,13,1,3,-2
6633cb8d8f483ae6701074b2,20211116,TK-400,13,1,1,0
6633cb8d8f483ae6701074b3,20211117,TK-400,13,0,1,-1
6633cb8d8f483ae6701074b4,20211118,TK-400,13,0,0,0
6633cb8d8f483ae6701074b5,20211119,TK-400,13,1,3,-2
6633cb8d8f483ae6701074b6,20211120,TK-400,13,0,1,-1
6633cb8d8f483ae6701074b7,20211122,TK-400,13,0,1,-1
6633cb8d8f483ae6701074b8,20211123,TK-400,13,2,3,-1
6633cb8d8f483ae6701074b9,20211124,TK-400,13,2,4,-2
6633cb8d8f483ae6701074ba,20211125,TK-400,13,0,0,0
6633cb8d8f483ae6701074bb,20211126,TK-400,13,1,3,-2
6633cb8d8f483ae6701074bc,20211127,TK-400,13,0,3,-3
6633cb8d8f483ae6701074bd,20211129,TK-400,13,0,0,0
6633cb8d8f483ae6701074be,20211130,TK-400,13,0,1,-1
6633cb8d8f483ae6701074bf,20211201,TK-400,13,0,2,-2
6633cb8d8f483ae6701074c0,20211204,TK-400,13,0,1,-1
6633cb8d8f483ae6701074c1,20211206,TK-400,13,0,1,-1
6633cb8d8f483ae6701074c2,20211207,TK-400,13,0,1,-1
6633cb8d8f483ae6701074c3,20211208,TK-400,13,0,3,-3
6633cb8d8f483ae6701074c4,20211209,TK-400,13,1,2,-1
6633cb8d8f483ae6701074c5,20211210,TK-400,13,2,3,-1
6633cb8d8f483ae6701074c6,20211211,TK-400,13,0,0,0
6633cb8d8f483ae6701074c7,20211213,TK-400,13,0,0,0
6633cb8d8f483ae6701074c8,20211214,TK-400,13,0,3,-3
6633cb8d8f483ae6701074c9,20211215,TK-400,13,0,0,0
6633cb8d8f483ae6701074ca,20211216,TK-400,13,0,0,0
6633cb8d8f483ae6701074cb,20211217,TK-400,13,1,2,-1
6633cb8d8f483ae6701074cc,20211218,TK-400,13,1,4,-3
6633cb8d8f483ae6701074cd,20211220,TK-400,13,0,2,-2
6633cb8d8f483ae6701074ce,20211221,TK-400,13,1,4,-3
6633cb8d8f483ae6701074cf,20211222,TK-400,13,3,6,-3
6633cb8d8f483ae6701074d0,20211223,TK-400,13,1,3,-2
6633cb8d8f483ae6701074d1,20211224,TK-400,13,2,6,-4
6633cb8d8f483ae6701074d2,20211225,TK-400,13,1,4,-3
6633cb8d8f483ae6701074d3,20211227,TK-400,13,0,3,-3
6633cb8d8f483ae6701074d4,20211228,TK-400,13,2,6,-4
6633cb8d8f483ae6701074d5,20211229,TK-400,13,1,3,-2
6633cb8d8f483ae6701074d6,20211230,TK-400,13,1,3,-2
6633cb8d8f483ae6701074d7,20211231,TK-400,13,2,5,-3
6633cb8d8f483ae6701074d8,20220101,TK-400,13,3,5,-2
6633cb8d8f483ae6701074d9,20220103,TK-400,13,0,3,-3
6633cb8d8f483ae6701074da,20220104,TK-400,13,3,5,-2
6633cb8d8f483ae6701074db,20220105,TK-400,13,1,1,0
6633cb8d8f483ae6701074dc,20220106,TK-400,13,1,3,-2
6633cb8d8f483ae6701074dd,20220107,TK-400,13,0,2,-2
6633cb8d8f483ae6701074de,20220110,TK-400,13,0,0,0
6633cb8d8f483ae6701074df,20220111,TK-400,13,0,1,-1
6633cb8d8f483ae6701074e0,20220112,TK-400,13,0,0,0
6633cb8d8f483ae6701074e1,20220113,TK-400,13,0,0,0
6633cb8d8f483ae6701074e2,20220114,TK-400,13,2,2,0
6633cb8d8f483ae6701074e3,20220115,TK-400,13,0,2,-2
6633cb8d8f483ae6701074e4,20220117,TK-400,13,1,1,0
6633cb8d8f483ae6701074e5,20220118,TK-400,13,0,1,-1
6633cb8d8f483ae6701074e6,20220119,TK-400,13,0,0,0
6633cb8d8f483ae6701074e7,20220120,TK-400,13,1,2,-1
6633cb8d8f483ae6701074e8,20220121,TK-400,13,0,1,-1
6633cb8d8f483ae6701074e9,20220122,TK-400,13,1,2,-1
6633cb8d8f483ae6701074ea,20220124,TK-400,13,0,0,0
6633cb8d8f483ae6701074eb,20220125,TK-400,13,0,1,-1
6633cb8d8f483ae6701074ec,20220126,TK-400,13,0,1,-1
6633cb8d8f483ae6701074ed,20220127,TK-400,13,0,1,-1
6633cb8d8f483ae6701074ee,20220128,TK-400,13,2,3,-1
6633cb8d8f483ae6701074ef,20220129,TK-400,13,0,1,-1
6633cb8d8f483ae6701074f0,20220131,TK-400,13,1,3,-2
6633cb8d8f483ae6701074f1,20220201,TK-400,13,0,1,-1
6633cb8d8f483ae6701074f2,20220202,TK-400,13,1,2,-1
6633cb8d8f483ae6701074f3,20220203,TK-400,13,1,3,-2
6633cb8d8f483ae6701074f4,20220204,TK-400,13,0,2,-2
6633cb8d8f483ae6701074f5,20220207,TK-400,13,0,1,-1
6633cb8d8f483ae6701074f6,20220208,TK-400,13,2,3,-1
6633cb8d8f483ae6701074f7,20220209,TK-400,13,0,1,-1
6633cb8d8f483ae6701074f8,20220210,TK-400,13,0,2,-2
6633cb8d8f483ae6701074f9,20220211,TK-400,13,1,1,0
6633cb8d8f483ae6701074fa,20220212,TK-400,13,1,2,-1
6633cb8d8f483ae6701074fb,20220214,TK-400,13,0,1,-1
6633cb8d8f483ae6701074fc,20220215,TK-400,13,2,4,-2
6633cb8d8f483ae6701074fd,20220216,TK-400,13,1,3,-2
6633cb8d8f483ae6701074fe,20220217,TK-400,13,0,2,-2
6633cb8d8f483ae6701074ff,20220218,TK-400,13,0,1,-1
6633cb8d8f483ae670107500,20220219,TK-400,13,1,1,0
6633cb8d8f483ae670107501,20220221,TK-400,13,0,1,-1
6633cb8d8f483ae670107502,20220222,TK-400,13,0,1,-1
6633cb8d8f483ae670107503,20220223,TK-400,13,0,1,-1
6633cb8d8f483ae670107504,20220224,TK-400,13,0,0,0
6633cb8d8f483ae670107505,20220225,TK-400,13,0,2,-2
6633cb8d8f483ae670107506,20220226,TK-400,13,1,1,0
6633cb8d8f483ae670107507,20220228,TK-400,13,0,2,-2
6633cb8d8f483ae670107508,20220301,TK-400,13,0,1,-1
6633cb8d8f483ae670107509,20220302,TK-400,13,1,2,-1
6633cb8d8f483ae67010750a,20220303,TK-400,13,0,1,-1
6633cb8d8f483ae67010750b,20220304,TK-400,13,0,2,-2
6633cb8d8f483ae67010750c,20220305,TK-400,13,1,2,-1
6633cb8d8f483ae67010750d,20220307,TK-400,13,0,0,0
6633cb8d8f483ae67010750e,20220308,TK-400,13,0,2,-2
6633cb8d8f483ae67010750f,20220309,TK-400,13,0,0,0
6633cb8d8f483ae670107510,20220310,TK-400,13,0,1,-1
6633cb8d8f483ae670107511,20220311,TK-400,13,2,5,-3
6633cb8d8f483ae670107512,20220312,TK-400,13,1,3,-2
6633cb8d8f483ae670107513,20220314,TK-400,13,1,2,-1
6633cb8d8f483ae670107514,20220315,TK-400,13,3,5,-2
6633cb8d8f483ae670107515,20220316,TK-400,13,1,4,-3
6633cb8d8f483ae670107516,20220317,TK-400,13,1,3,-2
6633cb8d8f483ae670107517,20220318,TK-400,13,1,3,-2
6633cb8d8f483ae670107518,20220319,TK-400,13,2,4,-2
6633cb8d8f483ae670107519,20220321,TK-400,13,2,4,-2
6633cb8d8f483ae67010751a,20220322,TK-400,13,0,2,-2
6633cb8d8f483ae67010751b,20220323,TK-400,13,1,1,0
6633cb8d8f483ae67010751c,20220324,TK-400,13,1,2,-1
6633cb8d8f483ae67010751d,20220326,TK-400,13,0,2,-2
6633cb8d8f483ae67010751e,20220328,TK-400,13,0,1,-1
6633cb8d8f483ae67010751f,20220329,TK-400,13,0,0,0
6633cb8d8f483ae670107520,20220330,TK-400,13,1,2,-1
6633cb8d8f483ae670107521,20220401,TK-400,13,0,0,0
6633cb8d8f483ae670107522,20220402,TK-400,13,1,1,0
6633cb8d8f483ae670107523,20220405,TK-400,13,1,2,-1
6633cb8d8f483ae670107524,20220407,TK-400,13,0,1,-1
6633cb8d8f483ae670107525,20220408,TK-400,13,0,0,0
6633cb8d8f483ae670107526,20220409,TK-400,13,0,2,-2
6633cb8d8f483ae670107527,20220411,TK-400,13,0,0,0
6633cb8d8f483ae670107528,20220412,TK-400,13,0,1,-1
6633cb8d8f483ae670107529,20220413,TK-400,13,0,0,0
6633cb8d8f483ae67010752a,20220414,TK-400,13,0,1,-1
6633cb8d8f483ae67010752b,20220415,TK-400,13,0,0,0
6633cb8d8f483ae67010752c,20220416,TK-400,13,1,2,-1
6633cb8d8f483ae67010752d,20220418,TK-400,13,0,1,-1
6633cb8d8f483ae67010752e,20220419,TK-400,13,0,0,0
6633cb8d8f483ae67010752f,20220420,TK-400,13,1,2,-1
6633cb8d8f483ae670107530,20220421,TK-400,13,1,4,-3
6633cb8d8f483ae670107531,20220422,TK-400,13,0,0,0
6633cb8d8f483ae670107532,20220423,TK-400,13,0,0,0
6633cb8d8f483ae670107533,20220424,TK-400,13,0,1,-1
6633cb8d8f483ae670107534,20220425,TK-400,13,0,1,-1
6633cb8d8f483ae670107535,20220426,TK-400,13,0,0,0
6633cb8d8f483ae670107536,20220427,TK-400,13,0,2,-2
6633cb8d8f483ae670107537,20220428,TK-400,13,2,3,-1
6633cb8d8f483ae670107538,20220429,TK-400,13,3,5,-2
6633cb8d8f483ae670107539,20220503,TK-400,13,0,0,0
6633cb8d8f483ae67010753a,20220504,TK-400,13,0,1,-1
6633cb8d8f483ae67010753b,20220505,TK-400,13,1,5,-4
6633cb8d8f483ae67010753c,20220506,TK-400,13,0,1,-1
6633cb8d8f483ae67010753d,20220507,TK-400,13,0,1,-1
6633cb8d8f483ae67010753e,20220509,TK-400,13,1,3,-2
6633cb8d8f483ae67010753f,20220510,TK-400,13,1,2,-1
6633cb8d8f483ae670107540,20220511,TK-400,13,0,1,-1
6633cb8d8f483ae670107541,20220512,TK-400,13,0,1,-1
6633cb8d8f483ae670107542,20220513,TK-400,13,0,2,-2
6633cb8d8f483ae670107543,20220514,TK-400,13,2,4,-2
6633cb8d8f483ae670107544,20220516,TK-400,13,0,1,-1
6633cb8d8f483ae670107545,20220517,TK-400,13,2,4,-2
6633cb8d8f483ae670107546,20220518,TK-400,13,1,3,-2
6633cb8d8f483ae670107547,20220519,TK-400,13,1,3,-2
6633cb8d8f483ae670107548,20220520,TK-400,13,1,1,0
6633cb8d8f483ae670107549,20220521,TK-400,13,0,1,-1
6633cb8d8f483ae67010754a,20220523,TK-400,13,0,2,-2
6633cb8d8f483ae67010754b,20220524,TK-400,13,2,3,-1
6633cb8d8f483ae67010754c,20220525,TK-400,13,1,2,-1
6633cb8d8f483ae67010754d,20220526,TK-400,13,0,1,-1
6633cb8d8f483ae67010754e,20220527,TK-400,13,0,2,-2
6633cb8d8f483ae67010754f,20220528,TK-400,13,0,0,0
6633cb8d8f483ae670107550,20220530,TK-400,13,0,1,-1
6633cb8d8f483ae670107551,20220531,TK-400,13,1,2,-1
6633cb8d8f483ae670107552,20220601,TK-400,13,0,0,0
6633cb8d8f483ae670107553,20220602,TK-400,13,1,3,-2
6633cb8d8f483ae670107554,20220603,TK-400,13,1,2,-1
6633cb8d8f483ae670107555,20220604,TK-400,13,1,2,-1
6633cb8d8f483ae670107556,20220606,TK-400,13,5,7,-2
6633cb8d8f483ae670107557,20220607,TK-400,13,4,6,-2
6633cb8d8f483ae670107558,20220608,TK-400,13,9,12,-3
6633cb8d8f483ae670107559,20220609,TK-400,13,0,0,0
6633cb8d8f483ae67010755a,20220610,TK-400,13,1,3,-2
6633cb8d8f483ae67010755b,20220611,TK-400,13,2,5,-3
6633cb8d8f483ae67010755c,20220613,TK-400,13,3,5,-2
6633cb8d8f483ae67010755d,20220614,TK-400,13,8,11,-3
6633cb8d8f483ae67010755e,20220615,TK-400,13,5,8,-3
6633cb8d8f483ae67010755f,20220616,TK-400,13,0,1,-1
6633cb8d8f483ae670107560,20220617,TK-400,13,0,0,0
6633cb8d8f483ae670107561,20220618,TK-400,13,2,3,-1
6633cb8d8f483ae670107562,20220620,TK-400,13,6,10,-4
6633cb8d8f483ae670107563,20220621,TK-400,13,3,4,-1
6633cb8d8f483ae670107564,20220622,TK-400,13,0,2,-2
6633cb8d8f483ae670107565,20220623,TK-400,13,0,0,0
6633cb8d8f483ae670107566,20220624,TK-400,13,1,4,-3
6633cb8d8f483ae670107567,20220625,TK-400,13,0,1,-1
6633cb8d8f483ae670107568,20220627,TK-400,13,1,3,-2
6633cb8d8f483ae670107569,20220628,TK-400,13,0,0,0
6633cb8d8f483ae67010756a,20220629,TK-400,13,3,3,0
6633cb8d8f483ae67010756b,20220630,TK-400,13,2,6,-4
6633cb8d8f483ae67010756c,20220701,TK-400,13,0,2,-2
6633cb8d8f483ae67010756d,20220702,TK-400,13,0,3,-3
6633cb8d8f483ae67010756e,20220704,TK-400,13,2,4,-2
6633cb8d8f483ae67010756f,20220705,TK-400,13,0,1,-1
6633cb8d8f483ae670107570,20220706,TK-400,13,2,4,-2
6633cb8d8f483ae670107571,20220707,TK-400,13,2,5,-3
6633cb8d8f483ae670107572,20220708,TK-400,13,3,8,-5
6633cb8d8f483ae670107573,20220709,TK-400,13,0,1,-1
6633cb8d8f483ae670107574,20220712,TK-400,13,2,3,-1
6633cb8d8f483ae670107575,20220713,TK-400,13,0,0,0
6633cb8d8f483ae670107576,20220714,TK-400,13,1,1,0
6633cb8d8f483ae670107577,20220715,TK-400,13,0,0,0
6633cb8d8f483ae670107578,20220716,TK-400,13,0,1,-1
6633cb8d8f483ae670107579,20220718,TK-400,13,1,3,-2
6633cb8d8f483ae67010757a,20220719,TK-400,13,0,1,-1
6633cb8d8f483ae67010757b,20220720,TK-400,13,2,4,-2
6633cb8d8f483ae67010757c,20220721,TK-400,13,1,3,-2
6633cb8d8f483ae67010757d,20220722,TK-400,13,0,2,-2
6633cb8d8f483ae67010757e,20220723,TK-400,13,1,3,-2
6633cb8d8f483ae67010757f,20220725,TK-400,13,0,2,-2
6633cb8d8f483ae670107580,20220726,TK-400,13,3,4,-1
6633cb8d8f483ae670107581,20220727,TK-400,13,1,2,-1
6633cb8d8f483ae670107582,20220806,TK-400,13,0,1,-1
6633cb8d8f483ae670107583,20220808,TK-400,13,2,2,0
6633cb8d8f483ae670107584,20220809,TK-400,13,0,0,0
6633cb8d8f483ae670107585,20220810,TK-400,13,1,2,-1
6633cb8d8f483ae670107586,20220811,TK-400,13,1,2,-1
6633cb8d8f483ae670107587,20220812,TK-400,13,0,1,-1
6633cb8d8f483ae670107588,20220813,TK-400,13,0,1,-1
6633cb8d8f483ae670107589,20220815,TK-400,13,0,1,-1
6633cb8d8f483ae67010758a,20220816,TK-400,13,2,5,-3
6633cb8d8f483ae67010758b,20220817,TK-400,13,1,3,-2
6633cb8d8f483ae67010758c,20220818,TK-400,13,2,4,-2
6633cb8d8f483ae67010758d,20220819,TK-400,13,2,4,-2
6633cb8d8f483ae67010758e,20220820,TK-400,13,0,1,-1
6633cb8d8f483ae67010758f,20220822,TK-400,13,0,3,-3
6633cb8d8f483ae670107590,20220823,TK-400,13,0,1,-1
6633cb8d8f483ae670107591,20220824,TK-400,13,2,2,0
6633cb8d8f483ae670107592,20220825,TK-400,13,1,5,-4
6633cb8d8f483ae670107593,20220826,TK-400,13,2,2,0
6633cb8d8f483ae670107594,20220827,TK-400,13,0,1,-1
6633cb8d8f483ae670107595,20220829,TK-400,13,1,1,0
6633cb8d8f483ae670107596,20220830,TK-400,13,1,2,-1
6633cb8d8f483ae670107597,20220831,TK-400,13,0,2,-2
6633cb8d8f483ae670107598,20220901,TK-400,13,0,0,0
6633cb8d8f483ae670107599,20220902,TK-400,13,0,2,-2
6633cb8d8f483ae67010759a,20220903,TK-400,13,0,1,-1
6633cb8d8f483ae67010759b,20220905,TK-400,13,0,1,-1
6633cb8d8f483ae67010759c,20220907,TK-400,13,1,3,-2
6633cb8d8f483ae67010759d,20220908,TK-400,13,1,3,-2
6633cb8d8f483ae67010759e,20220909,TK-400,13,1,3,-2
6633cb8d8f483ae67010759f,20220910,TK-400,13,0,2,-2
6633cb8d8f483ae6701075a0,20220912,TK-400,13,0,1,-1
6633cb8d8f483ae6701075a1,20220913,TK-400,13,1,2,-1
6633cb8d8f483ae6701075a2,20220914,TK-400,13,0,1,-1
6633cb8d8f483ae6701075a3,20220915,TK-400,13,0,1,-1
6633cb8d8f483ae6701075a4,20220916,TK-400,13,0,2,-2
6633cb8d8f483ae6701075a5,20220917,TK-400,13,0,0,0
6633cb8d8f483ae6701075a6,20220918,TK-400,13,0,0,0
6633cb8d8f483ae6701075a7,20220919,TK-400,13,0,1,-1
6633cb8d8f483ae6701075a8,20220920,TK-400,13,0,1,-1
6633cb8d8f483ae6701075a9,20220921,TK-400,13,0,0,0
6633cb8d8f483ae6701075aa,20220922,TK-400,13,0,0,0
6633cb8d8f483ae6701075ab,20220923,TK-400,13,1,1,0
6633cb8d8f483ae6701075ac,20220924,TK-400,13,0,0,0
6633cb8d8f483ae6701075ad,20220926,TK-400,13,0,0,0
6633cb8d8f483ae6701075ae,20220927,TK-400,13,0,1,-1
6633cb8d8f483ae6701075af,20220928,TK-400,13,0,1,-1
6633cb8d8f483ae6701075b0,20220929,TK-400,13,0,0,0
6633cb8d8f483ae6701075b1,20220930,TK-400,13,0,0,0
6633cb8d8f483ae6701075b2,20221001,TK-400,13,0,0,0
6633cb8d8f483ae6701075b3,20221004,TK-400,13,0,0,0
6633cb8d8f483ae6701075b4,20221006,TK-400,13,0,0,0
6633cb8d8f483ae6701075b5,20221007,TK-400,13,0,0,0
6633cb8d8f483ae6701075b6,20221008,TK-400,13,0,0,0
6633cb8d8f483ae6701075b7,20221010,TK-400,13,0,0,0
6633cb8d8f483ae6701075b8,20221011,TK-400,13,0,0,0
6633cb8d8f483ae6701075b9,20221012,TK-400,13,0,0,0
6633cb8d8f483ae6701075ba,20221013,TK-400,13,0,0,0
6633cb8d8f483ae6701075bb,20221014,TK-400,13,0,0,0
6633cb8d8f483ae6701075bc,20221015,TK-400,13,0,0,0
6633cb8d8f483ae6701075bd,20221017,TK-400,13,0,0,0
6633cb8d8f483ae6701075be,20221021,TK-400,13,0,0,0
6633cb8d8f483ae6701075bf,20221022,TK-400,13,1,1,0
6633cb8d8f483ae6701075c0,20221024,TK-400,13,0,0,0
6633cb8d8f483ae6701075c1,20221025,TK-400,13,0,0,0
6633cb8d8f483ae6701075c2,20221026,TK-400,13,0,0,0
6633cb8d8f483ae6701075c3,20221027,TK-400,13,1,1,0
6633cb8d8f483ae6701075c4,20221029,TK-400,13,1,1,0
6633cb8d8f483ae6701075c5,20221031,TK-400,13,0,0,0
6633cb8d8f483ae6701075c6,20221102,TK-400,13,0,0,0
6633cb8d8f483ae6701075c7,20221103,TK-400,13,0,0,0
6633cb8d8f483ae6701075c8,20221104,TK-400,13,0,0,0
6633cb8d8f483ae6701075c9,20221107,TK-400,13,0,0,0
6633cb8d8f483ae6701075ca,20221108,TK-400,13,0,0,0
6633cb8d8f483ae6701075cb,20221109,TK-400,13,0,0,0
6633cb8d8f483ae6701075cc,20221110,TK-400,13,0,0,0
6633cb8d8f483ae6701075cd,20221111,TK-400,13,0,0,0
6633cb8d8f483ae6701075ce,20221112,TK-400,13,0,0,0
6633cb8d8f483ae6701075cf,20221115,TK-400,13,0,0,0
6633cb8d8f483ae6701075d0,20221116,TK-400,13,0,0,0
6633cb8d8f483ae6701075d1,20221117,TK-400,13,0,0,0
6633cb8d8f483ae6701075d2,20221118,TK-400,13,0,1,-1
6633cb8d8f483ae6701075d3,20221121,TK-400,13,0,0,0
6633cb8d8f483ae6701075d4,20221123,TK-400,13,0,0,0
6633cb8d8f483ae6701075d5,20221128,TK-400,13,0,0,0
6633cb8d8f483ae6701075d6,20221129,TK-400,13,0,0,0
6633cb8d8f483ae6701075d7,20221130,TK-400,13,0,0,0
6633cb8d8f483ae6701075d8,20221201,TK-400,13,0,0,0
6633cb8d8f483ae6701075d9,20221202,TK-400,13,0,0,0
6633cb8d8f483ae6701075da,20221203,TK-400,13,0,0,0
6633cb8d8f483ae6701075db,20221205,TK-400,13,0,0,0
6633cb8d8f483ae6701075dc,20221207,TK-400,13,0,0,0
6633cb8d8f483ae6701075dd,20221212,TK-400,13,0,0,0
6633cb8d8f483ae6701075de,20221213,TK-400,13,0,0,0
6633cb8d8f483ae6701075df,20221215,TK-400,13,0,0,0
6633cb8d8f483ae6701075e0,20221216,TK-400,13,0,0,0
6633cb8d8f483ae6701075e1,20221217,TK-400,13,0,1,-1
6633cb8d8f483ae6701075e2,20221219,TK-400,13,0,0,0
6633cb8d8f483ae6701075e3,20221220,TK-400,13,0,0,0
6633cb8d8f483ae6701075e4,20221222,TK-400,13,0,0,0
6633cb8d8f483ae6701075e5,20221223,TK-400,13,0,0,0
6633cb8d8f483ae6701075e6,20221224,TK-400,13,0,0,0
6633cb8d8f483ae6701075e7,20221226,TK-400,13,0,0,0
6633cb8d8f483ae6701075e8,20221227,TK-400,13,0,0,0
6633cb8d8f483ae6701075e9,20221228,TK-400,13,0,0,0
6633cb8d8f483ae6701075ea,20221229,TK-400,13,0,0,0
6633cb8d8f483ae6701075eb,20221230,TK-400,13,0,0,0
6633cb8d8f483ae6701075ec,20221231,TK-400,13,0,0,0
6633cb8d8f483ae6701075ed,20230101,TK-400,13,0,0,0
6633cb8d8f483ae6701075ee,20230102,TK-400,13,0,0,0
6633cb8d8f483ae6701075ef,20230103,TK-400,13,0,0,0
6633cb8d8f483ae6701075f0,20230104,TK-400,13,0,0,0
6633cb8d8f483ae6701075f1,20230105,TK-400,13,0,0,0
6633cb8d8f483ae6701075f2,20230106,TK-400,13,0,0,0
6633cb8d8f483ae6701075f3,20230107,TK-400,13,0,0,0
6633cb8d8f483ae6701075f4,20230109,TK-400,13,0,0,0
6633cb8d8f483ae6701075f5,20230110,TK-400,13,0,0,0
6633cb8d8f483ae6701075f6,20230111,TK-400,13,0,0,0
6633cb8d8f483ae6701075f7,20230112,TK-400,13,0,0,0
6633cb8d8f483ae6701075f8,20230113,TK-400,13,0,0,0
6633cb8d8f483ae6701075f9,20230116,TK-400,13,0,0,0
6633cb8d8f483ae6701075fa,20230117,TK-400,13,0,0,0
6633cb8d8f483ae6701075fb,20230118,TK-400,13,0,0,0
6633cb8d8f483ae6701075fc,20230119,TK-400,13,0,0,0
6633cb8d8f483ae6701075fd,20230120,TK-400,13,0,0,0
6633cb8d8f483ae6701075fe,20230121,TK-400,13,0,0,0
6633cb8d8f483ae6701075ff,20230123,TK-400,13,0,0,0
6633cb8d8f483ae670107600,20230301,TK-400,13,0,1,-1
6633cb8d8f483ae670107601,20230303,TK-400,13,0,1,-1
6633cb8d8f483ae670107602,20230304,TK-400,13,0,1,-1
6633cb8d8f483ae670107603,20230306,TK-400,13,0,0,0
6633cb8d8f483ae670107604,20230307,TK-400,13,1,2,-1
6633cb8d8f483ae670107605,20230308,TK-400,13,0,1,-1
6633cb8d8f483ae670107606,20230309,TK-400,13,1,3,-2
6633cb8d8f483ae670107607,20230310,TK-400,13,0,1,-1
6633cb8d8f483ae670107608,20230311,TK-400,13,0,1,-1
6633cb8d8f483ae670107609,20230313,TK-400,13,0,0,0
6633cb8d8f483ae67010760a,20230314,TK-400,13,0,0,0
6633cb8d8f483ae67010760b,20230315,TK-400,13,0,0,0
6633cb8d8f483ae67010760c,20230316,TK-400,13,0,2,-2
6633cb8d8f483ae67010760d,20230317,TK-400,13,0,0,0
6633cb8d8f483ae67010760e,20230318,TK-400,13,0,0,0
6633cb8d8f483ae67010760f,20230320,TK-400,13,0,1,-1
6633cb8d8f483ae670107610,20230321,TK-400,13,1,1,0
6633cb8d8f483ae670107611,20230322,TK-400,13,0,2,-2
6633cb8d8f483ae670107612,20230323,TK-400,13,1,1,0
6633cb8d8f483ae670107613,20230324,TK-400,13,0,3,-3
6633cb8d8f483ae670107614,20230327,TK-400,13,0,1,-1
6633cb8d8f483ae670107615,20230328,TK-400,13,0,0,0
6633cb8d8f483ae670107616,20230330,TK-400,13,0,1,-1
6633cb8d8f483ae670107617,20230331,TK-400,13,1,2,-1
6633cb8d8f483ae670107618,20230401,TK-400,13,0,1,-1
6633cb8d8f483ae670107619,20230402,TK-400,13,0,0,0
6633cb8d8f483ae67010761a,20230403,TK-400,13,0,2,-2
6633cb8d8f483ae67010761b,20230404,TK-400,13,1,2,-1
6633cb8d8f483ae67010761c,20230405,TK-400,13,0,0,0
6633cb8d8f483ae67010761d,20230406,TK-400,13,0,2,-2
6633cb8d8f483ae67010761e,20230407,TK-400,13,0,2,-2
6633cb8d8f483ae67010761f,20230408,TK-400,13,0,1,-1
6633cb8d8f483ae670107620,20230410,TK-400,13,0,1,-1
6633cb8d8f483ae670107621,20230411,TK-400,13,0,0,0
6633cb8d8f483ae670107622,20230412,TK-400,13,1,1,0
6633cb8d8f483ae670107623,20230413,TK-400,13,0,1,-1
6633cb8d8f483ae670107624,20230414,TK-400,13,1,3,-2
6633cb8d8f483ae670107625,20230415,TK-400,13,0,0,0
6633cb8d8f483ae670107626,20230417,TK-400,13,0,1,-1
6633cb8d8f483ae670107627,20230418,TK-400,13,0,0,0
6633cb8d8f483ae670107628,20230419,TK-400,13,0,2,-2
6633cb8d8f483ae670107629,20230420,TK-400,13,1,4,-3
6633cb8d8f483ae67010762a,20230421,TK-400,13,0,0,0
6633cb8d8f483ae67010762b,20230424,TK-400,13,1,2,-1
6633cb8d8f483ae67010762c,20230425,TK-400,13,0,2,-2
6633cb8d8f483ae67010762d,20230426,TK-400,13,0,1,-1
6633cb8d8f483ae67010762e,20230427,TK-400,13,1,1,0
6633cb8d8f483ae67010762f,20230428,TK-400,13,2,4,-2
6633cb8d8f483ae670107630,20230429,TK-400,13,1,2,-1
6633cb8d8f483ae670107631,20230430,TK-400,13,0,0,0
6633cb8d8f483ae670107632,20230502,TK-400,13,0,3,-3
6633cb8d8f483ae670107633,20230503,TK-400,13,0,1,-1
6633cb8d8f483ae670107634,20230504,TK-400,13,2,5,-3
6633cb8d8f483ae670107635,20230505,TK-400,13,2,5,-3
6633cb8d8f483ae670107636,20230506,TK-400,13,0,1,-1
6633cb8d8f483ae670107637,20230508,TK-400,13,0,4,-4
6633cb8d8f483ae670107638,20230509,TK-400,13,0,0,0
6633cb8d8f483ae670107639,20230510,TK-400,13,0,1,-1
6633cb8d8f483ae67010763a,20230511,TK-400,13,0,1,-1
6633cb8d8f483ae67010763b,20230512,TK-400,13,1,3,-2
6633cb8d8f483ae67010763c,20230513,TK-400,13,0,1,-1
6633cb8d8f483ae67010763d,20230515,TK-400,13,0,1,-1
6633cb8d8f483ae67010763e,20230516,TK-400,13,1,2,-1
6633cb8d8f483ae67010763f,20230517,TK-400,13,1,4,-3
6633cb8d8f483ae670107640,20230518,TK-400,13,0,1,-1
6633cb8d8f483ae670107641,20230519,TK-400,13,0,2,-2
6633cb8d8f483ae670107642,20230520,TK-400,13,0,1,-1
6633cb8d8f483ae670107643,20230522,TK-400,13,0,1,-1
6633cb8d8f483ae670107644,20230523,TK-400,13,1,2,-1
6633cb8d8f483ae670107645,20230524,TK-400,13,0,2,-2
6633cb8d8f483ae670107646,20230525,TK-400,13,0,0,0
6633cb8d8f483ae670107647,20230526,TK-400,13,1,2,-1
6633cb8d8f483ae670107648,20230527,TK-400,13,2,3,-1
6633cb8d8f483ae670107649,20230529,TK-400,13,2,3,-1
6633cb8d8f483ae67010764a,20230530,TK-400,13,0,2,-2
6633cb8d8f483ae67010764b,20230531,TK-400,13,1,3,-2
6633cb8d8f483ae67010764c,20230601,TK-400,13,0,1,-1
6633cb8d8f483ae67010764d,20230602,TK-400,13,0,2,-2
6633cb8d8f483ae67010764e,20230603,TK-400,13,2,2,0
6633cb8d8f483ae67010764f,20230605,TK-400,13,0,1,-1
6633cb8d8f483ae670107650,20230606,TK-400,13,0,0,0
6633cb8d8f483ae670107651,20230607,TK-400,13,1,3,-2
6633cb8d8f483ae670107652,20230608,TK-400,13,0,0,0
6633cb8d8f483ae670107653,20230609,TK-400,13,3,4,-1
6633cb8d8f483ae670107654,20230610,TK-400,13,0,1,-1
6633cb8d8f483ae670107655,20230612,TK-400,13,0,1,-1
6633cb8d8f483ae670107656,20230613,TK-400,13,0,1,-1
6633cb8d8f483ae670107657,20230614,TK-400,13,1,2,-1
6633cb8d8f483ae670107658,20230615,TK-400,13,0,1,-1
6633cb8d8f483ae670107659,20230616,TK-400,13,1,3,-2
6633cb8d8f483ae67010765a,20230617,TK-400,13,1,3,-2
6633cb8d8f483ae67010765b,20230619,TK-400,13,0,1,-1
6633cb8d8f483ae67010765c,20230620,TK-400,13,0,2,-2
6633cb8d8f483ae67010765d,20230621,TK-400,13,0,2,-2
6633cb8d8f483ae67010765e,20230622,TK-400,13,1,1,0
6633cb8d8f483ae67010765f,20230623,TK-400,13,1,3,-2
6633cb8d8f483ae670107660,20230624,TK-400,13,0,2,-2
6633cb8d8f483ae670107661,20230626,TK-400,13,0,3,-3
6633cb8d8f483ae670107662,20230627,TK-400,13,3,6,-3
6633cb8d8f483ae670107663,20230628,TK-400,13,1,3,-2
6633cb8d8f483ae670107664,20230630,TK-400,13,1,2,-1
6633cb8d8f483ae670107665,20230701,TK-400,13,1,3,-2
6633cb8d8f483ae670107666,20230703,TK-400,13,0,2,-2
6633cb8d8f483ae670107667,20230704,TK-400,13,0,1,-1
6633cb8d8f483ae670107668,20230705,TK-400,13,2,3,-1
6633cb8d8f483ae670107669,20230706,TK-400,13,1,3,-2
6633cb8d8f483ae67010766a,20230707,TK-400,13,2,2,0
6633cb8d8f483ae67010766b,20230708,TK-400,13,0,1,-1
6633cb8d8f483ae67010766c,20230710,TK-400,13,0,1,-1
6633cb8d8f483ae67010766d,20230711,TK-400,13,0,0,0
6633cb8d8f483ae67010766e,20230712,TK-400,13,1,3,-2
6633cb8d8f483ae67010766f,20230713,TK-400,13,2,3,-1
6633cb8d8f483ae670107670,20230714,TK-400,13,0,1,-1
6633cb8d8f483ae670107671,20230715,TK-400,13,0,1,-1
6633cb8d8f483ae670107672,20230717,TK-400,13,0,1,-1
6633cb8d8f483ae670107673,20230718,TK-400,13,2,2,0
6633cb8d8f483ae670107674,20230719,TK-400,13,0,0,0
6633cb8d8f483ae670107675,20210927,TK-500,10,26,65,-39
6633cb8d8f483ae670107676,20210928,TK-500,10,73,81,-8
6633cb8d8f483ae670107677,20210929,TK-500,10,56,63,-7
6633cb8d8f483ae670107678,20210930,TK-500,10,46,53,-7
6633cb8d8f483ae670107679,20211001,TK-500,10,61,70,-9
6633cb8d8f483ae67010767a,20211002,TK-500,10,66,77,-11
6633cb8d8f483ae67010767b,20211004,TK-500,10,61,72,-11
6633cb8d8f483ae67010767c,20211005,TK-500,10,50,58,-8
6633cb8d8f483ae67010767d,20211006,TK-500,10,56,64,-8
6633cb8d8f483ae67010767e,20211007,TK-500,10,45,53,-8
6633cb8d8f483ae67010767f,20211008,TK-500,10,65,75,-10
6633cb8d8f483ae670107680,20211009,TK-500,10,45,51,-6
6633cb8d8f483ae670107681,20211011,TK-500,10,54,63,-9
6633cb8d8f483ae670107682,20211012,TK-500,10,45,50,-5
6633cb8d8f483ae670107683,20211013,TK-500,10,8,9,-1
6633cb8d8f483ae670107684,20211014,TK-500,10,24,28,-4
6633cb8d8f483ae670107685,20211015,TK-500,10,61,69,-8
6633cb8d8f483ae670107686,20211016,TK-500,10,46,53,-7
6633cb8d8f483ae670107687,20211018,TK-500,10,55,64,-9
6633cb8d8f483ae670107688,20211019,TK-500,10,49,57,-8
6633cb8d8f483ae670107689,20211020,TK-500,10,39,46,-7
6633cb8d8f483ae67010768a,20211021,TK-500,10,38,44,-6
6633cb8d8f483ae67010768b,20211022,TK-500,10,41,48,-7
6633cb8d8f483ae67010768c,20211023,TK-500,10,55,62,-7
6633cb8d8f483ae67010768d,20211025,TK-500,10,52,62,-10
6633cb8d8f483ae67010768e,20211026,TK-500,10,54,63,-9
6633cb8d8f483ae67010768f,20211027,TK-500,10,43,51,-8
6633cb8d8f483ae670107690,20211028,TK-500,10,62,69,-7
6633cb8d8f483ae670107691,20211029,TK-500,10,56,64,-8
6633cb8d8f483ae670107692,20211030,TK-500,10,49,58,-9
6633cb8d8f483ae670107693,20211101,TK-500,10,48,56,-8
6633cb8d8f483ae670107694,20211102,TK-500,10,50,57,-7
6633cb8d8f483ae670107695,20211103,TK-500,10,58,67,-9
6633cb8d8f483ae670107696,20211104,TK-500,10,65,74,-9
6633cb8d8f483ae670107697,20211105,TK-500,10,45,54,-9
6633cb8d8f483ae670107698,20211106,TK-500,10,52,58,-6
6633cb8d8f483ae670107699,20211108,TK-500,10,51,59,-8
6633cb8d8f483ae67010769a,20211109,TK-500,10,45,52,-7
6633cb8d8f483ae67010769b,20211110,TK-500,10,44,50,-6
6633cb8d8f483ae67010769c,20211111,TK-500,10,65,75,-10
6633cb8d8f483ae67010769d,20211112,TK-500,10,61,71,-10
6633cb8d8f483ae67010769e,20211113,TK-500,10,48,57,-9
6633cb8d8f483ae67010769f,20211115,TK-500,10,66,75,-9
6633cb8d8f483ae6701076a0,20211116,TK-500,10,51,60,-9
6633cb8d8f483ae6701076a1,20211117,TK-500,10,58,68,-10
6633cb8d8f483ae6701076a2,20211118,TK-500,10,63,73,-10
6633cb8d8f483ae6701076a3,20211119,TK-500,10,52,60,-8
6633cb8d8f483ae6701076a4,20211120,TK-500,10,54,63,-9
6633cb8d8f483ae6701076a5,20211122,TK-500,10,53,63,-10
6633cb8d8f483ae6701076a6,20211123,TK-500,10,55,62,-7
6633cb8d8f483ae6701076a7,20211124,TK-500,10,53,59,-6
6633cb8d8f483ae6701076a8,20211125,TK-500,10,49,56,-7
6633cb8d8f483ae6701076a9,20211126,TK-500,10,66,77,-11
6633cb8d8f483ae6701076aa,20211127,TK-500,10,44,50,-6
6633cb8d8f483ae6701076ab,20211129,TK-500,10,56,65,-9
6633cb8d8f483ae6701076ac,20211130,TK-500,10,31,33,-2
6633cb8d8f483ae6701076ad,20211201,TK-500,10,67,75,-8
6633cb8d8f483ae6701076ae,20211202,TK-500,10,48,55,-7
6633cb8d8f483ae6701076af,20211203,TK-500,10,62,71,-9
6633cb8d8f483ae6701076b0,20211204,TK-500,10,60,69,-9
6633cb8d8f483ae6701076b1,20211206,TK-500,10,55,65,-10
6633cb8d8f483ae6701076b2,20211207,TK-500,10,51,61,-10
6633cb8d8f483ae6701076b3,20211208,TK-500,10,44,51,-7
6633cb8d8f483ae6701076b4,20211209,TK-500,10,43,49,-6
6633cb8d8f483ae6701076b5,20211210,TK-500,10,65,76,-11
6633cb8d8f483ae6701076b6,20211211,TK-500,10,56,63,-7
6633cb8d8f483ae6701076b7,20211213,TK-500,10,53,62,-9
6633cb8d8f483ae6701076b8,20211214,TK-500,10,38,45,-7
6633cb8d8f483ae6701076b9,20211215,TK-500,10,50,59,-9
6633cb8d8f483ae6701076ba,20211216,TK-500,10,56,64,-8
6633cb8d8f483ae6701076bb,20211217,TK-500,10,53,61,-8
6633cb8d8f483ae6701076bc,20211218,TK-500,10,55,62,-7
6633cb8d8f483ae6701076bd,20211220,TK-500,10,55,66,-11
6633cb8d8f483ae6701076be,20211221,TK-500,10,52,59,-7
6633cb8d8f483ae6701076bf,20211222,TK-500,10,42,48,-6
6633cb8d8f483ae6701076c0,20211223,TK-500,10,62,73,-11
6633cb8d8f483ae6701076c1,20211224,TK-500,10,51,59,-8
6633cb8d8f483ae6701076c2,20211225,TK-500,10,46,53,-7
6633cb8d8f483ae6701076c3,20211227,TK-500,10,57,68,-11
6633cb8d8f483ae6701076c4,20211228,TK-500,10,52,63,-11
6633cb8d8f483ae6701076c5,20211229,TK-500,10,35,41,-6
6633cb8d8f483ae6701076c6,20211230,TK-500,10,41,48,-7
6633cb8d8f483ae6701076c7,20211231,TK-500,10,62,71,-9
6633cb8d8f483ae6701076c8,20220101,TK-500,10,39,46,-7
6633cb8d8f483ae6701076c9,20220103,TK-500,10,63,72,-9
6633cb8d8f483ae6701076ca,20220104,TK-500,10,48,55,-7
6633cb8d8f483ae6701076cb,20220105,TK-500,10,61,69,-8
6633cb8d8f483ae6701076cc,20220106,TK-500,10,52,62,-10
6633cb8d8f483ae6701076cd,20220107,TK-500,10,57,66,-9
6633cb8d8f483ae6701076ce,20220108,TK-500,10,47,55,-8
6633cb8d8f483ae6701076cf,20220110,TK-500,10,60,68,-8
6633cb8d8f483ae6701076d0,20220111,TK-500,10,59,67,-8
6633cb8d8f483ae6701076d1,20220112,TK-500,10,47,55,-8
6633cb8d8f483ae6701076d2,20220113,TK-500,10,49,56,-7
6633cb8d8f483ae6701076d3,20220114,TK-500,10,60,69,-9
6633cb8d8f483ae6701076d4,20220115,TK-500,10,44,51,-7
6633cb8d8f483ae6701076d5,20220117,TK-500,10,65,75,-10
6633cb8d8f483ae6701076d6,20220118,TK-500,10,46,54,-8
6633cb8d8f483ae6701076d7,20220119,TK-500,10,64,72,-8
6633cb8d8f483ae6701076d8,20220120,TK-500,10,55,62,-7
6633cb8d8f483ae6701076d9,20220121,TK-500,10,62,74,-12
6633cb8d8f483ae6701076da,20220122,TK-500,10,57,66,-9
6633cb8d8f483ae6701076db,20220124,TK-500,10,56,65,-9
6633cb8d8f483ae6701076dc,20220125,TK-500,10,51,59,-8
6633cb8d8f483ae6701076dd,20220126,TK-500,10,41,45,-4
6633cb8d8f483ae6701076de,20220127,TK-500,10,44,49,-5
6633cb8d8f483ae6701076df,20220128,TK-500,10,54,64,-10
6633cb8d8f483ae6701076e0,20220129,TK-500,10,50,57,-7
6633cb8d8f483ae6701076e1,20220131,TK-500,10,54,62,-8
6633cb8d8f483ae6701076e2,20220201,TK-500,10,63,71,-8
6633cb8d8f483ae6701076e3,20220202,TK-500,10,56,65,-9
6633cb8d8f483ae6701076e4,20220203,TK-500,10,66,78,-12
6633cb8d8f483ae6701076e5,20220204,TK-500,10,51,57,-6
6633cb8d8f483ae6701076e6,20220205,TK-500,10,45,51,-6
6633cb8d8f483ae6701076e7,20220207,TK-500,10,53,61,-8
6633cb8d8f483ae6701076e8,20220208,TK-500,10,58,67,-9
6633cb8d8f483ae6701076e9,20220209,TK-500,10,57,67,-10
6633cb8d8f483ae6701076ea,20220210,TK-500,10,57,68,-11
6633cb8d8f483ae6701076eb,20220211,TK-500,10,44,53,-9
6633cb8d8f483ae6701076ec,20220212,TK-500,10,59,68,-9
6633cb8d8f483ae6701076ed,20220214,TK-500,10,51,57,-6
6633cb8d8f483ae6701076ee,20220215,TK-500,10,61,71,-10
6633cb8d8f483ae6701076ef,20220216,TK-500,10,45,52,-7
6633cb8d8f483ae6701076f0,20220217,TK-500,10,48,57,-9
6633cb8d8f483ae6701076f1,20220218,TK-500,10,64,72,-8
6633cb8d8f483ae6701076f2,20220219,TK-500,10,43,50,-7
6633cb8d8f483ae6701076f3,20220221,TK-500,10,53,59,-6
6633cb8d8f483ae6701076f4,20220222,TK-500,10,56,63,-7
6633cb8d8f483ae6701076f5,20220223,TK-500,10,46,54,-8
6633cb8d8f483ae6701076f6,20220224,TK-500,10,55,62,-7
6633cb8d8f483ae6701076f7,20220225,TK-500,10,51,63,-12
6633cb8d8f483ae6701076f8,20220226,TK-500,10,43,49,-6
6633cb8d8f483ae6701076f9,20220228,TK-500,10,29,34,-5
6633cb8d8f483ae6701076fa,20220301,TK-500,10,61,70,-9
6633cb8d8f483ae6701076fb,20220302,TK-500,10,52,59,-7
6633cb8d8f483ae6701076fc,20220303,TK-500,10,58,64,-6
6633cb8d8f483ae6701076fd,20220304,TK-500,10,35,42,-7
6633cb8d8f483ae6701076fe,20220305,TK-500,10,56,65,-9
6633cb8d8f483ae6701076ff,20220307,TK-500,10,50,60,-10
6633cb8d8f483ae670107700,20220308,TK-500,10,44,50,-6
6633cb8d8f483ae670107701,20220309,TK-500,10,57,64,-7
6633cb8d8f483ae670107702,20220310,TK-500,10,55,63,-8
6633cb8d8f483ae670107703,20220311,TK-500,10,47,56,-9
6633cb8d8f483ae670107704,20220312,TK-500,10,58,69,-11
6633cb8d8f483ae670107705,20220314,TK-500,10,62,73,-11
6633cb8d8f483ae670107706,20220315,TK-500,10,61,71,-10
6633cb8d8f483ae670107707,20220316,TK-500,10,63,72,-9
6633cb8d8f483ae670107708,20220317,TK-500,10,46,55,-9
6633cb8d8f483ae670107709,20220318,TK-500,10,70,78,-8
6633cb8d8f483ae67010770a,20220319,TK-500,10,47,54,-7
6633cb8d8f483ae67010770b,20220321,TK-500,10,49,58,-9
6633cb8d8f483ae67010770c,20220322,TK-500,10,48,57,-9
6633cb8d8f483ae67010770d,20220323,TK-500,10,41,48,-7
6633cb8d8f483ae67010770e,20220324,TK-500,10,56,64,-8
6633cb8d8f483ae67010770f,20220325,TK-500,10,54,62,-8
6633cb8d8f483ae670107710,20220326,TK-500,10,46,54,-8
6633cb8d8f483ae670107711,20220328,TK-500,10,64,74,-10
6633cb8d8f483ae670107712,20220329,TK-500,10,40,48,-8
6633cb8d8f483ae670107713,20220330,TK-500,10,63,70,-7
6633cb8d8f483ae670107714,20220331,TK-500,10,58,70,-12
6633cb8d8f483ae670107715,20220401,TK-500,10,55,64,-9
6633cb8d8f483ae670107716,20220402,TK-500,10,62,75,-13
6633cb8d8f483ae670107717,20220403,TK-500,10,3,0,3
6633cb8d8f483ae670107718,20220404,TK-500,10,44,50,-6
6633cb8d8f483ae670107719,20220405,TK-500,10,46,55,-9
6633cb8d8f483ae67010771a,20220406,TK-500,10,41,49,-8
6633cb8d8f483ae67010771b,20220407,TK-500,10,43,52,-9
6633cb8d8f483ae67010771c,20220408,TK-500,10,49,56,-7
6633cb8d8f483ae67010771d,20220409,TK-500,10,59,66,-7
6633cb8d8f483ae67010771e,20220411,TK-500,10,43,51,-8
6633cb8d8f483ae67010771f,20220412,TK-500,10,42,48,-6
6633cb8d8f483ae670107720,20220413,TK-500,10,38,45,-7
6633cb8d8f483ae670107721,20220414,TK-500,10,33,40,-7
6633cb8d8f483ae670107722,20220415,TK-500,10,44,50,-6
6633cb8d8f483ae670107723,20220416,TK-500,10,30,34,-4
6633cb8d8f483ae670107724,20220418,TK-500,10,52,62,-10
6633cb8d8f483ae670107725,20220419,TK-500,10,53,60,-7
6633cb8d8f483ae670107726,20220420,TK-500,10,46,55,-9
6633cb8d8f483ae670107727,20220421,TK-500,10,95,108,-13
6633cb8d8f483ae670107728,20220422,TK-500,10,54,62,-8
6633cb8d8f483ae670107729,20220424,TK-500,10,47,54,-7
6633cb8d8f483ae67010772a,20220425,TK-500,10,43,48,-5
6633cb8d8f483ae67010772b,20220426,TK-500,10,47,54,-7
6633cb8d8f483ae67010772c,20220427,TK-500,10,50,63,-13
6633cb8d8f483ae67010772d,20220428,TK-500,10,38,46,-8
6633cb8d8f483ae67010772e,20220429,TK-500,10,56,62,-6
6633cb8d8f483ae67010772f,20220503,TK-500,10,45,53,-8
6633cb8d8f483ae670107730,20220504,TK-500,10,42,49,-7
6633cb8d8f483ae670107731,20220505,TK-500,10,45,53,-8
6633cb8d8f483ae670107732,20220506,TK-500,10,49,60,-11
6633cb8d8f483ae670107733,20220507,TK-500,10,51,61,-10
6633cb8d8f483ae670107734,20220509,TK-500,10,57,65,-8
6633cb8d8f483ae670107735,20220510,TK-500,10,51,59,-8
6633cb8d8f483ae670107736,20220511,TK-500,10,48,58,-10
6633cb8d8f483ae670107737,20220512,TK-500,10,53,62,-9
6633cb8d8f483ae670107738,20220513,TK-500,10,60,68,-8
6633cb8d8f483ae670107739,20220514,TK-500,10,47,58,-11
6633cb8d8f483ae67010773a,20220516,TK-500,10,59,67,-8
6633cb8d8f483ae67010773b,20220517,TK-500,10,57,65,-8
6633cb8d8f483ae67010773c,20220518,TK-500,10,54,62,-8
6633cb8d8f483ae67010773d,20220519,TK-500,10,53,63,-10
6633cb8d8f483ae67010773e,20220520,TK-500,10,56,66,-10
6633cb8d8f483ae67010773f,20220521,TK-500,10,40,48,-8
6633cb8d8f483ae670107740,20220523,TK-500,10,59,69,-10
6633cb8d8f483ae670107741,20220524,TK-500,10,46,54,-8
6633cb8d8f483ae670107742,20220525,TK-500,10,47,55,-8
6633cb8d8f483ae670107743,20220526,TK-500,10,48,56,-8
6633cb8d8f483ae670107744,20220527,TK-500,10,35,42,-7
6633cb8d8f483ae670107745,20220528,TK-500,10,43,49,-6
6633cb8d8f483ae670107746,20220530,TK-500,10,47,56,-9
6633cb8d8f483ae670107747,20220531,TK-500,10,45,54,-9
6633cb8d8f483ae670107748,20220601,TK-500,10,33,41,-8
6633cb8d8f483ae670107749,20220602,TK-500,10,34,41,-7
6633cb8d8f483ae67010774a,20220603,TK-500,10,64,73,-9
6633cb8d8f483ae67010774b,20220604,TK-500,10,46,54,-8
6633cb8d8f483ae67010774c,20220606,TK-500,10,26,30,-4
6633cb8d8f483ae67010774d,20220607,TK-500,10,58,68,-10
6633cb8d8f483ae67010774e,20220608,TK-500,10,36,43,-7
6633cb8d8f483ae67010774f,20220609,TK-500,10,56,68,-12
6633cb8d8f483ae670107750,20220610,TK-500,10,53,62,-9
6633cb8d8f483ae670107751,20220611,TK-500,10,61,72,-11
6633cb8d8f483ae670107752,20220613,TK-500,10,64,73,-9
6633cb8d8f483ae670107753,20220614,TK-500,10,46,51,-5
6633cb8d8f483ae670107754,20220615,TK-500,10,70,82,-12
6633cb8d8f483ae670107755,20220616,TK-500,10,46,52,-6
6633cb8d8f483ae670107756,20220617,TK-500,10,41,48,-7
6633cb8d8f483ae670107757,20220618,TK-500,10,51,61,-10
6633cb8d8f483ae670107758,20220620,TK-500,10,40,47,-7
6633cb8d8f483ae670107759,20220621,TK-500,10,40,47,-7
6633cb8d8f483ae67010775a,20220622,TK-500,10,42,47,-5
6633cb8d8f483ae67010775b,20220623,TK-500,10,48,54,-6
6633cb8d8f483ae67010775c,20220624,TK-500,10,52,58,-6
6633cb8d8f483ae67010775d,20220625,TK-500,10,42,48,-6
6633cb8d8f483ae67010775e,20220627,TK-500,10,50,58,-8
6633cb8d8f483ae67010775f,20220628,TK-500,10,51,57,-6
6633cb8d8f483ae670107760,20220629,TK-500,10,45,54,-9
6633cb8d8f483ae670107761,20220630,TK-500,10,51,59,-8
6633cb8d8f483ae670107762,20220701,TK-500,10,57,66,-9
6633cb8d8f483ae670107763,20220702,TK-500,10,62,73,-11
6633cb8d8f483ae670107764,20220704,TK-500,10,43,51,-8
6633cb8d8f483ae670107765,20220705,TK-500,10,45,53,-8
6633cb8d8f483ae670107766,20220706,TK-500,10,48,58,-10
6633cb8d8f483ae670107767,20220707,TK-500,10,57,64,-7
6633cb8d8f483ae670107768,20220708,TK-500,10,51,59,-8
6633cb8d8f483ae670107769,20220709,TK-500,10,45,53,-8
6633cb8d8f483ae67010776a,20220711,TK-500,10,12,15,-3
6633cb8d8f483ae67010776b,20220712,TK-500,10,30,34,-4
6633cb8d8f483ae67010776c,20220713,TK-500,10,25,29,-4
6633cb8d8f483ae67010776d,20220714,TK-500,10,17,19,-2
6633cb8d8f483ae67010776e,20220715,TK-500,10,38,47,-9
6633cb8d8f483ae67010776f,20220716,TK-500,10,35,43,-8
6633cb8d8f483ae670107770,20220718,TK-500,10,52,60,-8
6633cb8d8f483ae670107771,20220719,TK-500,10,49,57,-8
6633cb8d8f483ae670107772,20220720,TK-500,10,45,54,-9
6633cb8d8f483ae670107773,20220721,TK-500,10,42,48,-6
6633cb8d8f483ae670107774,20220722,TK-500,10,60,73,-13
6633cb8d8f483ae670107775,20220723,TK-500,10,54,63,-9
6633cb8d8f483ae670107776,20220725,TK-500,10,49,54,-5
6633cb8d8f483ae670107777,20220726,TK-500,10,47,57,-10
6633cb8d8f483ae670107778,20220727,TK-500,10,41,49,-8
6633cb8d8f483ae670107779,20220728,TK-500,10,57,67,-10
6633cb8d8f483ae67010777a,20220729,TK-500,10,39,46,-7
6633cb8d8f483ae67010777b,20220730,TK-500,10,55,61,-6
6633cb8d8f483ae67010777c,20220801,TK-500,10,40,48,-8
6633cb8d8f483ae67010777d,20220802,TK-500,10,57,63,-6
6633cb8d8f483ae67010777e,20220803,TK-500,10,56,67,-11
6633cb8d8f483ae67010777f,20220804,TK-500,10,53,60,-7
6633cb8d8f483ae670107780,20220805,TK-500,10,55,65,-10
6633cb8d8f483ae670107781,20220806,TK-500,10,58,67,-9
6633cb8d8f483ae670107782,20220808,TK-500,10,41,51,-10
6633cb8d8f483ae670107783,20220809,TK-500,10,43,50,-7
6633cb8d8f483ae670107784,20220810,TK-500,10,42,49,-7
6633cb8d8f483ae670107785,20220811,TK-500,10,58,67,-9
6633cb8d8f483ae670107786,20220812,TK-500,10,55,65,-10
6633cb8d8f483ae670107787,20220813,TK-500,10,49,54,-5
6633cb8d8f483ae670107788,20220815,TK-500,10,44,50,-6
6633cb8d8f483ae670107789,20220816,TK-500,10,52,64,-12
6633cb8d8f483ae67010778a,20220817,TK-500,10,65,70,-5
6633cb8d8f483ae67010778b,20220818,TK-500,10,41,48,-7
6633cb8d8f483ae67010778c,20220819,TK-500,10,48,57,-9
6633cb8d8f483ae67010778d,20220820,TK-500,10,55,69,-14
6633cb8d8f483ae67010778e,20220822,TK-500,10,53,63,-10
6633cb8d8f483ae67010778f,20220823,TK-500,10,49,57,-8
6633cb8d8f483ae670107790,20220824,TK-500,10,47,57,-10
6633cb8d8f483ae670107791,20220825,TK-500,10,41,49,-8
6633cb8d8f483ae670107792,20220826,TK-500,10,46,54,-8
6633cb8d8f483ae670107793,20220827,TK-500,10,50,55,-5
6633cb8d8f483ae670107794,20220829,TK-500,10,51,61,-10
6633cb8d8f483ae670107795,20220830,TK-500,10,47,57,-10
6633cb8d8f483ae670107796,20220831,TK-500,10,47,54,-7
6633cb8d8f483ae670107797,20220901,TK-500,10,35,41,-6
6633cb8d8f483ae670107798,20220902,TK-500,10,6,8,-2
6633cb8d8f483ae670107799,20220903,TK-500,10,0,0,0
6633cb8d8f483ae67010779a,20220905,TK-500,10,0,0,0
6633cb8d8f483ae67010779b,20220907,TK-500,10,0,0,0
6633cb8d8f483ae67010779c,20220908,TK-500,10,4,5,-1
6633cb8d8f483ae67010779d,20220909,TK-500,10,45,52,-7
6633cb8d8f483ae67010779e,20220910,TK-500,10,45,52,-7
6633cb8d8f483ae67010779f,20220912,TK-500,10,40,47,-7
6633cb8d8f483ae6701077a0,20220913,TK-500,10,40,44,-4
6633cb8d8f483ae6701077a1,20220914,TK-500,10,39,45,-6
6633cb8d8f483ae6701077a2,20220915,TK-500,10,38,45,-7
6633cb8d8f483ae6701077a3,20220916,TK-500,10,34,40,-6
6633cb8d8f483ae6701077a4,20220917,TK-500,10,51,58,-7
6633cb8d8f483ae6701077a5,20220919,TK-500,10,38,44,-6
6633cb8d8f483ae6701077a6,20220920,TK-500,10,39,48,-9
6633cb8d8f483ae6701077a7,20220921,TK-500,10,38,43,-5
6633cb8d8f483ae6701077a8,20220922,TK-500,10,39,47,-8
6633cb8d8f483ae6701077a9,20220923,TK-500,10,50,59,-9
6633cb8d8f483ae6701077aa,20220924,TK-500,10,41,47,-6
6633cb8d8f483ae6701077ab,20220926,TK-500,10,40,47,-7
6633cb8d8f483ae6701077ac,20220927,TK-500,10,31,36,-5
6633cb8d8f483ae6701077ad,20220928,TK-500,10,27,30,-3
6633cb8d8f483ae6701077ae,20220929,TK-500,10,37,41,-4
6633cb8d8f483ae6701077af,20220930,TK-500,10,39,44,-5
6633cb8d8f483ae6701077b0,20221001,TK-500,10,12,13,-1
6633cb8d8f483ae6701077b1,20221004,TK-500,10,66,74,-8
6633cb8d8f483ae6701077b2,20221005,TK-500,10,41,49,-8
6633cb8d8f483ae6701077b3,20221006,TK-500,10,47,51,-4
6633cb8d8f483ae6701077b4,20221007,TK-500,10,43,54,-11
6633cb8d8f483ae6701077b5,20221008,TK-500,10,56,61,-5
6633cb8d8f483ae6701077b6,20221010,TK-500,10,25,32,-7
6633cb8d8f483ae6701077b7,20221011,TK-500,10,19,21,-2
6633cb8d8f483ae6701077b8,20221012,TK-500,10,35,41,-6
6633cb8d8f483ae6701077b9,20221013,TK-500,10,34,41,-7
6633cb8d8f483ae6701077ba,20221014,TK-500,10,38,43,-5
6633cb8d8f483ae6701077bb,20221015,TK-500,10,49,57,-8
6633cb8d8f483ae6701077bc,20221017,TK-500,10,52,60,-8
6633cb8d8f483ae6701077bd,20221018,TK-500,10,44,49,-5
6633cb8d8f483ae6701077be,20221019,TK-500,10,48,55,-7
6633cb8d8f483ae6701077bf,20221020,TK-500,10,6,7,-1
6633cb8d8f483ae6701077c0,20221021,TK-500,10,38,44,-6
6633cb8d8f483ae6701077c1,20221022,TK-500,10,32,39,-7
6633cb8d8f483ae6701077c2,20221024,TK-500,10,37,43,-6
6633cb8d8f483ae6701077c3,20221025,TK-500,10,23,27,-4
6633cb8d8f483ae6701077c4,20221026,TK-500,10,42,50,-8
6633cb8d8f483ae6701077c5,20221027,TK-500,10,40,47,-7
6633cb8d8f483ae6701077c6,20221028,TK-500,10,45,53,-8
6633cb8d8f483ae6701077c7,20221029,TK-500,10,44,50,-6
6633cb8d8f483ae6701077c8,20221031,TK-500,10,49,55,-6
6633cb8d8f483ae6701077c9,20221101,TK-500,10,38,45,-7
6633cb8d8f483ae6701077ca,20221102,TK-500,10,53,59,-6
6633cb8d8f483ae6701077cb,20221103,TK-500,10,37,42,-5
6633cb8d8f483ae6701077cc,20221104,TK-500,10,41,48,-7
6633cb8d8f483ae6701077cd,20221105,TK-500,10,41,47,-6
6633cb8d8f483ae6701077ce,20221107,TK-500,10,31,37,-6
6633cb8d8f483ae6701077cf,20221108,TK-500,10,29,33,-4
6633cb8d8f483ae6701077d0,20221109,TK-500,10,31,35,-4
6633cb8d8f483ae6701077d1,20221110,TK-500,10,22,27,-5
6633cb8d8f483ae6701077d2,20221111,TK-500,10,27,32,-5
6633cb8d8f483ae6701077d3,20221112,TK-500,10,40,45,-5
6633cb8d8f483ae6701077d4,20221114,TK-500,10,29,34,-5
6633cb8d8f483ae6701077d5,20221115,TK-500,10,34,37,-3
6633cb8d8f483ae6701077d6,20221116,TK-500,10,30,35,-5
6633cb8d8f483ae6701077d7,20221117,TK-500,10,37,47,-10
6633cb8d8f483ae6701077d8,20221118,TK-500,10,43,51,-8
6633cb8d8f483ae6701077d9,20221119,TK-500,10,37,41,-4
6633cb8d8f483ae6701077da,20221121,TK-500,10,35,41,-6
6633cb8d8f483ae6701077db,20221122,TK-500,10,34,38,-4
6633cb8d8f483ae6701077dc,20221123,TK-500,10,36,41,-5
6633cb8d8f483ae6701077dd,20221124,TK-500,10,41,47,-6
6633cb8d8f483ae6701077de,20221125,TK-500,10,36,41,-5
6633cb8d8f483ae6701077df,20221126,TK-500,10,34,37,-3
6633cb8d8f483ae6701077e0,20221128,TK-500,10,35,40,-5
6633cb8d8f483ae6701077e1,20221129,TK-500,10,43,48,-5
6633cb8d8f483ae6701077e2,20221130,TK-500,10,40,45,-5
6633cb8d8f483ae6701077e3,20221201,TK-500,10,25,28,-3
6633cb8d8f483ae6701077e4,20221202,TK-500,10,33,39,-6
6633cb8d8f483ae6701077e5,20221203,TK-500,10,41,47,-6
6633cb8d8f483ae6701077e6,20221205,TK-500,10,47,56,-9
6633cb8d8f483ae6701077e7,20221206,TK-500,10,41,49,-8
6633cb8d8f483ae6701077e8,20221207,TK-500,10,30,35,-5
6633cb8d8f483ae6701077e9,20221208,TK-500,10,34,38,-4
6633cb8d8f483ae6701077ea,20221209,TK-500,10,18,20,-2
6633cb8d8f483ae6701077eb,20221210,TK-500,10,40,45,-5
6633cb8d8f483ae6701077ec,20221212,TK-500,10,37,43,-6
6633cb8d8f483ae6701077ed,20221213,TK-500,10,21,24,-3
6633cb8d8f483ae6701077ee,20221214,TK-500,10,15,18,-3
6633cb8d8f483ae6701077ef,20221215,TK-500,10,28,31,-3
6633cb8d8f483ae6701077f0,20221216,TK-500,10,37,42,-5
6633cb8d8f483ae6701077f1,20221217,TK-500,10,31,37,-6
6633cb8d8f483ae6701077f2,20221219,TK-500,10,28,31,-3
6633cb8d8f483ae6701077f3,20221220,TK-500,10,33,38,-5
6633cb8d8f483ae6701077f4,20221221,TK-500,10,34,37,-3
6633cb8d8f483ae6701077f5,20221222,TK-500,10,25,29,-4
6633cb8d8f483ae6701077f6,20221223,TK-500,10,30,37,-7
6633cb8d8f483ae6701077f7,20221224,TK-500,10,28,31,-3
6633cb8d8f483ae6701077f8,20221226,TK-500,10,33,38,-5
6633cb8d8f483ae6701077f9,20221227,TK-500,10,38,42,-4
6633cb8d8f483ae6701077fa,20221228,TK-500,10,39,45,-6
6633cb8d8f483ae6701077fb,20221229,TK-500,10,36,42,-6
6633cb8d8f483ae6701077fc,20221230,TK-500,10,38,44,-6
6633cb8d8f483ae6701077fd,20221231,TK-500,10,28,33,-5
6633cb8d8f483ae6701077fe,20230102,TK-500,10,32,37,-5
6633cb8d8f483ae6701077ff,20230103,TK-500,10,34,40,-6
6633cb8d8f483ae670107800,20230104,TK-500,10,34,42,-8
6633cb8d8f483ae670107801,20230105,TK-500,10,44,50,-6
6633cb8d8f483ae670107802,20230106,TK-500,10,41,49,-8
6633cb8d8f483ae670107803,20230107,TK-500,10,38,44,-6
6633cb8d8f483ae670107804,20230109,TK-500,10,34,40,-6
6633cb8d8f483ae670107805,20230110,TK-500,10,36,42,-6
6633cb8d8f483ae670107806,20230111,TK-500,10,42,47,-5
6633cb8d8f483ae670107807,20230112,TK-500,10,40,45,-5
6633cb8d8f483ae670107808,20230113,TK-500,10,31,35,-4
6633cb8d8f483ae670107809,20230114,TK-500,10,38,44,-6
6633cb8d8f483ae67010780a,20230116,TK-500,10,25,30,-5
6633cb8d8f483ae67010780b,20230117,TK-500,10,32,36,-4
6633cb8d8f483ae67010780c,20230118,TK-500,10,38,43,-5
6633cb8d8f483ae67010780d,20230119,TK-500,10,34,39,-5
6633cb8d8f483ae67010780e,20230120,TK-500,10,43,50,-7
6633cb8d8f483ae67010780f,20230121,TK-500,10,42,48,-6
6633cb8d8f483ae670107810,20230123,TK-500,10,46,55,-9
6633cb8d8f483ae670107811,20230124,TK-500,10,53,60,-7
6633cb8d8f483ae670107812,20230125,TK-500,10,43,51,-8
6633cb8d8f483ae670107813,20230126,TK-500,10,40,44,-4
6633cb8d8f483ae670107814,20230127,TK-500,10,30,33,-3
6633cb8d8f483ae670107815,20230128,TK-500,10,32,36,-4
6633cb8d8f483ae670107816,20230130,TK-500,10,37,42,-5
6633cb8d8f483ae670107817,20230131,TK-500,10,39,43,-4
6633cb8d8f483ae670107818,20230201,TK-500,10,50,57,-7
6633cb8d8f483ae670107819,20230202,TK-500,10,41,48,-7
6633cb8d8f483ae67010781a,20230203,TK-500,10,51,57,-6
6633cb8d8f483ae67010781b,20230204,TK-500,10,44,50,-6
6633cb8d8f483ae67010781c,20230206,TK-500,10,40,46,-6
6633cb8d8f483ae67010781d,20230207,TK-500,10,44,50,-6
6633cb8d8f483ae67010781e,20230208,TK-500,10,46,50,-4
6633cb8d8f483ae67010781f,20230209,TK-500,10,37,44,-7
6633cb8d8f483ae670107820,20230210,TK-500,10,36,43,-7
6633cb8d8f483ae670107821,20230211,TK-500,10,42,47,-5
6633cb8d8f483ae670107822,20230213,TK-500,10,29,34,-5
6633cb8d8f483ae670107823,20230214,TK-500,10,17,19,-2
6633cb8d8f483ae670107824,20230215,TK-500,10,22,27,-5
6633cb8d8f483ae670107825,20230216,TK-500,10,57,66,-9
6633cb8d8f483ae670107826,20230217,TK-500,10,45,50,-5
6633cb8d8f483ae670107827,20230218,TK-500,10,32,37,-5
6633cb8d8f483ae670107828,20230220,TK-500,10,26,31,-5
6633cb8d8f483ae670107829,20230221,TK-500,10,40,46,-6
6633cb8d8f483ae67010782a,20230222,TK-500,10,41,48,-7
6633cb8d8f483ae67010782b,20230223,TK-500,10,35,40,-5
6633cb8d8f483ae67010782c,20230224,TK-500,10,42,46,-4
6633cb8d8f483ae67010782d,20230225,TK-500,10,31,36,-5
6633cb8d8f483ae67010782e,20230227,TK-500,10,26,30,-4
6633cb8d8f483ae67010782f,20230228,TK-500,10,27,31,-4
6633cb8d8f483ae670107830,20230301,TK-500,10,38,43,-5
6633cb8d8f483ae670107831,20230302,TK-500,10,49,56,-7
6633cb8d8f483ae670107832,20230303,TK-500,10,46,52,-6
6633cb8d8f483ae670107833,20230304,TK-500,10,45,55,-10
6633cb8d8f483ae670107834,20230306,TK-500,10,48,55,-7
6633cb8d8f483ae670107835,20230307,TK-500,10,39,45,-6
6633cb8d8f483ae670107836,20230308,TK-500,10,31,36,-5
6633cb8d8f483ae670107837,20230309,TK-500,10,40,45,-5
6633cb8d8f483ae670107838,20230310,TK-500,10,54,62,-8
6633cb8d8f483ae670107839,20230311,TK-500,10,47,53,-6
6633cb8d8f483ae67010783a,20230313,TK-500,10,40,43,-3
6633cb8d8f483ae67010783b,20230314,TK-500,10,26,29,-3
6633cb8d8f483ae67010783c,20230315,TK-500,10,56,64,-8
6633cb8d8f483ae67010783d,20230316,TK-500,10,82,92,-10
6633cb8d8f483ae67010783e,20230317,TK-500,10,77,85,-8
6633cb8d8f483ae67010783f,20230318,TK-500,10,56,64,-8
6633cb8d8f483ae670107840,20230320,TK-500,10,82,92,-10
6633cb8d8f483ae670107841,20230321,TK-500,10,44,50,-6
6633cb8d8f483ae670107842,20230322,TK-500,10,66,72,-6
6633cb8d8f483ae670107843,20230323,TK-500,10,48,55,-7
6633cb8d8f483ae670107844,20230324,TK-500,10,82,90,-8
6633cb8d8f483ae670107845,20230325,TK-500,10,60,66,-6
6633cb8d8f483ae670107846,20230327,TK-500,10,67,71,-4
6633cb8d8f483ae670107847,20230328,TK-500,10,40,44,-4
6633cb8d8f483ae670107848,20230329,TK-500,10,56,62,-6
6633cb8d8f483ae670107849,20230330,TK-500,10,52,58,-6
6633cb8d8f483ae67010784a,20230331,TK-500,10,46,54,-8
6633cb8d8f483ae67010784b,20230401,TK-500,10,53,58,-5
6633cb8d8f483ae67010784c,20230402,TK-500,10,7,7,0
6633cb8d8f483ae67010784d,20230403,TK-500,10,71,80,-9
6633cb8d8f483ae67010784e,20230404,TK-500,10,79,90,-11
6633cb8d8f483ae67010784f,20230405,TK-500,10,6,9,-3
6633cb8d8f483ae670107850,20230406,TK-500,10,86,94,-8
6633cb8d8f483ae670107851,20230407,TK-500,10,82,92,-10
6633cb8d8f483ae670107852,20230408,TK-500,10,69,77,-8
6633cb8d8f483ae670107853,20230410,TK-500,10,69,76,-7
6633cb8d8f483ae670107854,20230411,TK-500,10,53,60,-7
6633cb8d8f483ae670107855,20230412,TK-500,10,67,77,-10
6633cb8d8f483ae670107856,20230413,TK-500,10,58,65,-7
6633cb8d8f483ae670107857,20230414,TK-500,10,74,82,-8
6633cb8d8f483ae670107858,20230415,TK-500,10,54,61,-7
6633cb8d8f483ae670107859,20230417,TK-500,10,70,80,-10
6633cb8d8f483ae67010785a,20230418,TK-500,10,41,47,-6
6633cb8d8f483ae67010785b,20230419,TK-500,10,76,83,-7
6633cb8d8f483ae67010785c,20230420,TK-500,10,88,96,-8
6633cb8d8f483ae67010785d,20230421,TK-500,10,60,70,-10
6633cb8d8f483ae67010785e,20230424,TK-500,10,63,69,-6
6633cb8d8f483ae67010785f,20230425,TK-500,10,60,68,-8
6633cb8d8f483ae670107860,20230426,TK-500,10,49,56,-7
6633cb8d8f483ae670107861,20230427,TK-500,10,51,57,-6
6633cb8d8f483ae670107862,20230428,TK-500,10,71,80,-9
6633cb8d8f483ae670107863,20230429,TK-500,10,70,79,-9
6633cb8d8f483ae670107864,20230430,TK-500,10,7,7,0
6633cb8d8f483ae670107865,20230501,TK-500,10,40,46,-6
6633cb8d8f483ae670107866,20230502,TK-500,10,68,76,-8
6633cb8d8f483ae670107867,20230503,TK-500,10,73,79,-6
6633cb8d8f483ae670107868,20230504,TK-500,10,110,121,-11
6633cb8d8f483ae670107869,20230505,TK-500,10,80,89,-9
6633cb8d8f483ae67010786a,20230506,TK-500,10,99,112,-13
6633cb8d8f483ae67010786b,20230508,TK-500,10,87,97,-10
6633cb8d8f483ae67010786c,20230509,TK-500,10,60,70,-10
6633cb8d8f483ae67010786d,20230510,TK-500,10,77,89,-12
6633cb8d8f483ae67010786e,20230511,TK-500,10,83,95,-12
6633cb8d8f483ae67010786f,20230512,TK-500,10,75,85,-10
6633cb8d8f483ae670107870,20230513,TK-500,10,67,76,-9
6633cb8d8f483ae670107871,20230515,TK-500,10,73,84,-11
6633cb8d8f483ae670107872,20230516,TK-500,10,50,58,-8
6633cb8d8f483ae670107873,20230517,TK-500,10,90,101,-11
6633cb8d8f483ae670107874,20230518,TK-500,10,73,82,-9
6633cb8d8f483ae670107875,20230519,TK-500,10,65,74,-9
6633cb8d8f483ae670107876,20230520,TK-500,10,75,84,-9
6633cb8d8f483ae670107877,20230522,TK-500,10,75,80,-5
6633cb8d8f483ae670107878,20230523,TK-500,10,80,88,-8
6633cb8d8f483ae670107879,20230524,TK-500,10,67,76,-9
6633cb8d8f483ae67010787a,20230525,TK-500,10,57,64,-7
6633cb8d8f483ae67010787b,20230526,TK-500,10,69,78,-9
6633cb8d8f483ae67010787c,20230527,TK-500,10,81,88,-7
6633cb8d8f483ae67010787d,20230529,TK-500,10,68,75,-7
6633cb8d8f483ae67010787e,20230530,TK-500,10,81,90,-9
6633cb8d8f483ae67010787f,20230531,TK-500,10,66,76,-10
6633cb8d8f483ae670107880,20230601,TK-500,10,56,65,-9
6633cb8d8f483ae670107881,20230602,TK-500,10,74,83,-9
6633cb8d8f483ae670107882,20230603,TK-500,10,79,87,-8
6633cb8d8f483ae670107883,20230605,TK-500,10,73,82,-9
6633cb8d8f483ae670107884,20230606,TK-500,10,57,65,-8
6633cb8d8f483ae670107885,20230607,TK-500,10,88,97,-9
6633cb8d8f483ae670107886,20230608,TK-500,10,58,68,-10
6633cb8d8f483ae670107887,20230609,TK-500,10,73,82,-9
6633cb8d8f483ae670107888,20230610,TK-500,10,53,59,-6
6633cb8d8f483ae670107889,20230612,TK-500,10,68,76,-8
6633cb8d8f483ae67010788a,20230613,TK-500,10,71,79,-8
6633cb8d8f483ae67010788b,20230614,TK-500,10,74,83,-9
6633cb8d8f483ae67010788c,20230615,TK-500,10,71,80,-9
6633cb8d8f483ae67010788d,20230616,TK-500,10,72,80,-8
6633cb8d8f483ae67010788e,20230617,TK-500,10,84,93,-9
6633cb8d8f483ae67010788f,20230619,TK-500,10,60,69,-9
6633cb8d8f483ae670107890,20230620,TK-500,10,84,93,-9
6633cb8d8f483ae670107891,20230621,TK-500,10,81,89,-8
6633cb8d8f483ae670107892,20230622,TK-500,10,75,84,-9
6633cb8d8f483ae670107893,20230623,TK-500,10,100,113,-13
6633cb8d8f483ae670107894,20230624,TK-500,10,70,80,-10
6633cb8d8f483ae670107895,20230626,TK-500,10,98,109,-11
6633cb8d8f483ae670107896,20230627,TK-500,10,93,107,-14
6633cb8d8f483ae670107897,20230628,TK-500,10,72,83,-11
6633cb8d8f483ae670107898,20230630,TK-500,10,55,60,-5
6633cb8d8f483ae670107899,20230701,TK-500,10,52,58,-6
6633cb8d8f483ae67010789a,20230703,TK-500,10,64,70,-6
6633cb8d8f483ae67010789b,20230704,TK-500,10,81,92,-11
6633cb8d8f483ae67010789c,20230705,TK-500,10,64,72,-8
6633cb8d8f483ae67010789d,20230706,TK-500,10,71,80,-9
6633cb8d8f483ae67010789e,20230707,TK-500,10,72,82,-10
6633cb8d8f483ae67010789f,20230708,TK-500,10,48,56,-8
6633cb8d8f483ae6701078a0,20230710,TK-500,10,51,58,-7
6633cb8d8f483ae6701078a1,20230711,TK-500,10,48,55,-7
6633cb8d8f483ae6701078a2,20230712,TK-500,10,72,80,-8
6633cb8d8f483ae6701078a3,20230713,TK-500,10,38,48,-10
6633cb8d8f483ae6701078a4,20230714,TK-500,10,31,37,-6
6633cb8d8f483ae6701078a5,20230715,TK-500,10,21,29,-8
6633cb8d8f483ae6701078a6,20230717,TK-500,10,36,44,-8
6633cb8d8f483ae6701078a7,20230718,TK-500,10,61,71,-10
6633cb8d8f483ae6701078a8,20230719,TK-500,10,54,61,-7
6633cb8d8f483ae6701078a9,20210927,TK-600,11,7,18,-11
6633cb8d8f483ae6701078aa,20210928,TK-600,11,18,26,-8
6633cb8d8f483ae6701078ab,20210929,TK-600,11,10,13,-3
6633cb8d8f483ae6701078ac,20210930,TK-600,11,8,11,-3
6633cb8d8f483ae6701078ad,20211001,TK-600,11,10,15,-5
6633cb8d8f483ae6701078ae,20211002,TK-600,11,10,15,-5
6633cb8d8f483ae6701078af,20211004,TK-600,11,13,17,-4
6633cb8d8f483ae6701078b0,20211005,TK-600,11,11,17,-6
6633cb8d8f483ae6701078b1,20211006,TK-600,11,11,16,-5
6633cb8d8f483ae6701078b2,20211007,TK-600,11,16,21,-5
6633cb8d8f483ae6701078b3,20211008,TK-600,11,15,23,-8
6633cb8d8f483ae6701078b4,20211009,TK-600,11,12,17,-5
6633cb8d8f483ae6701078b5,20211011,TK-600,11,11,17,-6
6633cb8d8f483ae6701078b6,20211012,TK-600,11,8,11,-3
6633cb8d8f483ae6701078b7,20211013,TK-600,11,2,3,-1
6633cb8d8f483ae6701078b8,20211014,TK-600,11,5,6,-1
6633cb8d8f483ae6701078b9,20211015,TK-600,11,11,17,-6
6633cb8d8f483ae6701078ba,20211016,TK-600,11,12,18,-6
6633cb8d8f483ae6701078bb,20211018,TK-600,11,6,10,-4
6633cb8d8f483ae6701078bc,20211019,TK-600,11,16,23,-7
6633cb8d8f483ae6701078bd,20211020,TK-600,11,8,11,-3
6633cb8d8f483ae6701078be,20211021,TK-600,11,11,16,-5
6633cb8d8f483ae6701078bf,20211022,TK-600,11,10,14,-4
6633cb8d8f483ae6701078c0,20211023,TK-600,11,7,11,-4
6633cb8d8f483ae6701078c1,20211025,TK-600,11,16,22,-6
6633cb8d8f483ae6701078c2,20211026,TK-600,11,18,24,-6
6633cb8d8f483ae6701078c3,20211027,TK-600,11,8,11,-3
6633cb8d8f483ae6701078c4,20211028,TK-600,11,8,12,-4
6633cb8d8f483ae6701078c5,20211029,TK-600,11,5,7,-2
6633cb8d8f483ae6701078c6,20211030,TK-600,11,9,14,-5
6633cb8d8f483ae6701078c7,20211101,TK-600,11,17,21,-4
6633cb8d8f483ae6701078c8,20211102,TK-600,11,14,20,-6
6633cb8d8f483ae6701078c9,20211103,TK-600,11,10,14,-4
6633cb8d8f483ae6701078ca,20211104,TK-600,11,7,10,-3
6633cb8d8f483ae6701078cb,20211105,TK-600,11,12,19,-7
6633cb8d8f483ae6701078cc,20211106,TK-600,11,8,11,-3
6633cb8d8f483ae6701078cd,20211108,TK-600,11,8,12,-4
6633cb8d8f483ae6701078ce,20211109,TK-600,11,6,9,-3
6633cb8d8f483ae6701078cf,20211110,TK-600,11,5,7,-2
6633cb8d8f483ae6701078d0,20211111,TK-600,11,11,17,-6
6633cb8d8f483ae6701078d1,20211112,TK-600,11,15,21,-6
6633cb8d8f483ae6701078d2,20211113,TK-600,11,8,12,-4
6633cb8d8f483ae6701078d3,20211115,TK-600,11,11,15,-4
6633cb8d8f483ae6701078d4,20211116,TK-600,11,9,14,-5
6633cb8d8f483ae6701078d5,20211117,TK-600,11,14,20,-6
6633cb8d8f483ae6701078d6,20211118,TK-600,11,12,17,-5
6633cb8d8f483ae6701078d7,20211119,TK-600,11,14,18,-4
6633cb8d8f483ae6701078d8,20211120,TK-600,11,9,13,-4
6633cb8d8f483ae6701078d9,20211122,TK-600,11,13,17,-4
6633cb8d8f483ae6701078da,20211123,TK-600,11,7,9,-2
6633cb8d8f483ae6701078db,20211124,TK-600,11,12,17,-5
6633cb8d8f483ae6701078dc,20211125,TK-600,11,8,10,-2
6633cb8d8f483ae6701078dd,20211126,TK-600,11,14,19,-5
6633cb8d8f483ae6701078de,20211127,TK-600,11,8,11,-3
6633cb8d8f483ae6701078df,20211129,TK-600,11,6,8,-2
6633cb8d8f483ae6701078e0,20211130,TK-600,11,4,5,-1
6633cb8d8f483ae6701078e1,20211201,TK-600,11,14,18,-4
6633cb8d8f483ae6701078e2,20211202,TK-600,11,6,9,-3
6633cb8d8f483ae6701078e3,20211203,TK-600,11,2,2,0
6633cb8d8f483ae6701078e4,20211204,TK-600,11,12,17,-5
6633cb8d8f483ae6701078e5,20211206,TK-600,11,11,14,-3
6633cb8d8f483ae6701078e6,20211207,TK-600,11,9,13,-4
6633cb8d8f483ae6701078e7,20211208,TK-600,11,6,7,-1
6633cb8d8f483ae6701078e8,20211209,TK-600,11,6,9,-3
6633cb8d8f483ae6701078e9,20211210,TK-600,11,14,19,-5
6633cb8d8f483ae6701078ea,20211211,TK-600,11,11,16,-5
6633cb8d8f483ae6701078eb,20211213,TK-600,11,8,11,-3
6633cb8d8f483ae6701078ec,20211214,TK-600,11,7,10,-3
6633cb8d8f483ae6701078ed,20211215,TK-600,11,9,13,-4
6633cb8d8f483ae6701078ee,20211216,TK-600,11,7,10,-3
6633cb8d8f483ae6701078ef,20211217,TK-600,11,12,15,-3
6633cb8d8f483ae6701078f0,20211218,TK-600,11,12,17,-5
6633cb8d8f483ae6701078f1,20211220,TK-600,11,12,18,-6
6633cb8d8f483ae6701078f2,20211221,TK-600,11,6,8,-2
6633cb8d8f483ae6701078f3,20211222,TK-600,11,9,13,-4
6633cb8d8f483ae6701078f4,20211223,TK-600,11,15,19,-4
6633cb8d8f483ae6701078f5,20211224,TK-600,11,11,15,-4
6633cb8d8f483ae6701078f6,20211225,TK-600,11,10,14,-4
6633cb8d8f483ae6701078f7,20211227,TK-600,11,15,20,-5
6633cb8d8f483ae6701078f8,20211228,TK-600,11,8,10,-2
6633cb8d8f483ae6701078f9,20211229,TK-600,11,7,9,-2
6633cb8d8f483ae6701078fa,20211230,TK-600,11,9,12,-3
6633cb8d8f483ae6701078fb,20211231,TK-600,11,10,14,-4
6633cb8d8f483ae6701078fc,20220101,TK-600,11,8,12,-4
6633cb8d8f483ae6701078fd,20220103,TK-600,11,12,16,-4
6633cb8d8f483ae6701078fe,20220104,TK-600,11,7,11,-4
6633cb8d8f483ae6701078ff,20220105,TK-600,11,12,16,-4
6633cb8d8f483ae670107900,20220106,TK-600,11,11,16,-5
6633cb8d8f483ae670107901,20220107,TK-600,11,15,19,-4
6633cb8d8f483ae670107902,20220108,TK-600,11,11,16,-5
6633cb8d8f483ae670107903,20220110,TK-600,11,7,9,-2
6633cb8d8f483ae670107904,20220111,TK-600,11,8,12,-4
6633cb8d8f483ae670107905,20220112,TK-600,11,15,20,-5
6633cb8d8f483ae670107906,20220113,TK-600,11,11,17,-6
6633cb8d8f483ae670107907,20220114,TK-600,11,9,13,-4
6633cb8d8f483ae670107908,20220115,TK-600,11,6,9,-3
6633cb8d8f483ae670107909,20220117,TK-600,11,11,16,-5
6633cb8d8f483ae67010790a,20220118,TK-600,11,9,15,-6
6633cb8d8f483ae67010790b,20220119,TK-600,11,7,9,-2
6633cb8d8f483ae67010790c,20220120,TK-600,11,12,17,-5
6633cb8d8f483ae67010790d,20220121,TK-600,11,12,17,-5
6633cb8d8f483ae67010790e,20220122,TK-600,11,9,14,-5
6633cb8d8f483ae67010790f,20220124,TK-600,11,10,13,-3
6633cb8d8f483ae670107910,20220125,TK-600,11,6,10,-4
6633cb8d8f483ae670107911,20220126,TK-600,11,5,6,-1
6633cb8d8f483ae670107912,20220127,TK-600,11,9,13,-4
6633cb8d8f483ae670107913,20220128,TK-600,11,11,17,-6
6633cb8d8f483ae670107914,20220129,TK-600,11,7,11,-4
6633cb8d8f483ae670107915,20220131,TK-600,11,15,18,-3
6633cb8d8f483ae670107916,20220201,TK-600,11,7,10,-3
6633cb8d8f483ae670107917,20220202,TK-600,11,10,14,-4
6633cb8d8f483ae670107918,20220203,TK-600,11,17,25,-8
6633cb8d8f483ae670107919,20220204,TK-600,11,10,13,-3
6633cb8d8f483ae67010791a,20220205,TK-600,11,6,9,-3
6633cb8d8f483ae67010791b,20220207,TK-600,11,11,16,-5
6633cb8d8f483ae67010791c,20220208,TK-600,11,6,10,-4
6633cb8d8f483ae67010791d,20220209,TK-600,11,12,15,-3
6633cb8d8f483ae67010791e,20220210,TK-600,11,12,17,-5
6633cb8d8f483ae67010791f,20220211,TK-600,11,13,17,-4
6633cb8d8f483ae670107920,20220212,TK-600,11,10,15,-5
6633cb8d8f483ae670107921,20220214,TK-600,11,9,11,-2
6633cb8d8f483ae670107922,20220215,TK-600,11,11,16,-5
6633cb8d8f483ae670107923,20220216,TK-600,11,9,12,-3
6633cb8d8f483ae670107924,20220217,TK-600,11,14,20,-6
6633cb8d8f483ae670107925,20220218,TK-600,11,10,13,-3
6633cb8d8f483ae670107926,20220219,TK-600,11,9,14,-5
6633cb8d8f483ae670107927,20220221,TK-600,11,6,7,-1
6633cb8d8f483ae670107928,20220222,TK-600,11,5,7,-2
6633cb8d8f483ae670107929,20220223,TK-600,11,11,14,-3
6633cb8d8f483ae67010792a,20220224,TK-600,11,9,13,-4
6633cb8d8f483ae67010792b,20220225,TK-600,11,13,19,-6
6633cb8d8f483ae67010792c,20220226,TK-600,11,8,10,-2
6633cb8d8f483ae67010792d,20220228,TK-600,11,6,7,-1
6633cb8d8f483ae67010792e,20220301,TK-600,11,10,14,-4
6633cb8d8f483ae67010792f,20220302,TK-600,11,12,16,-4
6633cb8d8f483ae670107930,20220303,TK-600,11,6,9,-3
6633cb8d8f483ae670107931,20220304,TK-600,11,11,17,-6
6633cb8d8f483ae670107932,20220305,TK-600,11,7,11,-4
6633cb8d8f483ae670107933,20220307,TK-600,11,13,17,-4
6633cb8d8f483ae670107934,20220308,TK-600,11,6,9,-3
6633cb8d8f483ae670107935,20220309,TK-600,11,18,23,-5
6633cb8d8f483ae670107936,20220310,TK-600,11,7,10,-3
6633cb8d8f483ae670107937,20220311,TK-600,11,10,13,-3
6633cb8d8f483ae670107938,20220312,TK-600,11,16,22,-6
6633cb8d8f483ae670107939,20220314,TK-600,11,12,17,-5
6633cb8d8f483ae67010793a,20220315,TK-600,11,10,13,-3
6633cb8d8f483ae67010793b,20220316,TK-600,11,13,18,-5
6633cb8d8f483ae67010793c,20220317,TK-600,11,10,14,-4
6633cb8d8f483ae67010793d,20220318,TK-600,11,13,16,-3
6633cb8d8f483ae67010793e,20220319,TK-600,11,12,16,-4
6633cb8d8f483ae67010793f,20220321,TK-600,11,8,12,-4
6633cb8d8f483ae670107940,20220322,TK-600,11,12,17,-5
6633cb8d8f483ae670107941,20220323,TK-600,11,10,13,-3
6633cb8d8f483ae670107942,20220324,TK-600,11,12,15,-3
6633cb8d8f483ae670107943,20220325,TK-600,11,6,10,-4
6633cb8d8f483ae670107944,20220326,TK-600,11,5,7,-2
6633cb8d8f483ae670107945,20220328,TK-600,11,12,16,-4
6633cb8d8f483ae670107946,20220329,TK-600,11,9,13,-4
6633cb8d8f483ae670107947,20220330,TK-600,11,7,10,-3
6633cb8d8f483ae670107948,20220331,TK-600,11,8,12,-4
6633cb8d8f483ae670107949,20220401,TK-600,11,11,15,-4
6633cb8d8f483ae67010794a,20220402,TK-600,11,12,15,-3
6633cb8d8f483ae67010794b,20220404,TK-600,11,1,1,0
6633cb8d8f483ae67010794c,20220405,TK-600,11,7,12,-5
6633cb8d8f483ae67010794d,20220406,TK-600,11,7,10,-3
6633cb8d8f483ae67010794e,20220407,TK-600,11,11,15,-4
6633cb8d8f483ae67010794f,20220408,TK-600,11,12,16,-4
6633cb8d8f483ae670107950,20220409,TK-600,11,7,9,-2
6633cb8d8f483ae670107951,20220411,TK-600,11,9,12,-3
6633cb8d8f483ae670107952,20220412,TK-600,11,6,9,-3
6633cb8d8f483ae670107953,20220413,TK-600,11,9,11,-2
6633cb8d8f483ae670107954,20220414,TK-600,11,14,17,-3
6633cb8d8f483ae670107955,20220415,TK-600,11,11,13,-2
6633cb8d8f483ae670107956,20220416,TK-600,11,5,7,-2
6633cb8d8f483ae670107957,20220418,TK-600,11,16,22,-6
6633cb8d8f483ae670107958,20220419,TK-600,11,11,13,-2
6633cb8d8f483ae670107959,20220420,TK-600,11,12,15,-3
6633cb8d8f483ae67010795a,20220421,TK-600,11,26,33,-7
6633cb8d8f483ae67010795b,20220422,TK-600,11,8,12,-4
6633cb8d8f483ae67010795c,20220424,TK-600,11,12,16,-4
6633cb8d8f483ae67010795d,20220425,TK-600,11,6,7,-1
6633cb8d8f483ae67010795e,20220426,TK-600,11,13,15,-2
6633cb8d8f483ae67010795f,20220427,TK-600,11,18,23,-5
6633cb8d8f483ae670107960,20220428,TK-600,11,13,19,-6
6633cb8d8f483ae670107961,20220429,TK-600,11,7,9,-2
6633cb8d8f483ae670107962,20220503,TK-600,11,11,14,-3
6633cb8d8f483ae670107963,20220504,TK-600,11,11,15,-4
6633cb8d8f483ae670107964,20220505,TK-600,11,12,17,-5
6633cb8d8f483ae670107965,20220506,TK-600,11,19,25,-6
6633cb8d8f483ae670107966,20220507,TK-600,11,20,26,-6
6633cb8d8f483ae670107967,20220509,TK-600,11,9,12,-3
6633cb8d8f483ae670107968,20220510,TK-600,11,14,17,-3
6633cb8d8f483ae670107969,20220511,TK-600,11,15,20,-5
6633cb8d8f483ae67010796a,20220512,TK-600,11,11,15,-4
6633cb8d8f483ae67010796b,20220513,TK-600,11,14,18,-4
6633cb8d8f483ae67010796c,20220514,TK-600,11,14,21,-7
6633cb8d8f483ae67010796d,20220516,TK-600,11,10,13,-3
6633cb8d8f483ae67010796e,20220517,TK-600,11,13,18,-5
6633cb8d8f483ae67010796f,20220518,TK-600,11,15,19,-4
6633cb8d8f483ae670107970,20220519,TK-600,11,11,16,-5
6633cb8d8f483ae670107971,20220520,TK-600,11,11,16,-5
6633cb8d8f483ae670107972,20220521,TK-600,11,10,13,-3
6633cb8d8f483ae670107973,20220523,TK-600,11,11,15,-4
6633cb8d8f483ae670107974,20220524,TK-600,11,5,7,-2
6633cb8d8f483ae670107975,20220525,TK-600,11,12,14,-2
6633cb8d8f483ae670107976,20220526,TK-600,11,6,10,-4
6633cb8d8f483ae670107977,20220527,TK-600,11,6,8,-2
6633cb8d8f483ae670107978,20220528,TK-600,11,7,10,-3
6633cb8d8f483ae670107979,20220530,TK-600,11,11,17,-6
6633cb8d8f483ae67010797a,20220531,TK-600,11,7,8,-1
6633cb8d8f483ae67010797b,20220601,TK-600,11,12,15,-3
6633cb8d8f483ae67010797c,20220602,TK-600,11,7,9,-2
6633cb8d8f483ae67010797d,20220603,TK-600,11,9,16,-7
6633cb8d8f483ae67010797e,20220604,TK-600,11,9,12,-3
6633cb8d8f483ae67010797f,20220606,TK-600,11,5,6,-1
6633cb8d8f483ae670107980,20220607,TK-600,11,13,15,-2
6633cb8d8f483ae670107981,20220608,TK-600,11,6,10,-4
6633cb8d8f483ae670107982,20220609,TK-600,11,14,17,-3
6633cb8d8f483ae670107983,20220610,TK-600,11,7,14,-7
6633cb8d8f483ae670107984,20220611,TK-600,11,12,17,-5
6633cb8d8f483ae670107985,20220613,TK-600,11,10,15,-5
6633cb8d8f483ae670107986,20220614,TK-600,11,6,8,-2
6633cb8d8f483ae670107987,20220615,TK-600,11,5,7,-2
6633cb8d8f483ae670107988,20220616,TK-600,11,4,6,-2
6633cb8d8f483ae670107989,20220617,TK-600,11,9,13,-4
6633cb8d8f483ae67010798a,20220618,TK-600,11,12,18,-6
6633cb8d8f483ae67010798b,20220620,TK-600,11,3,10,-7
6633cb8d8f483ae67010798c,20220621,TK-600,11,13,17,-4
6633cb8d8f483ae67010798d,20220622,TK-600,11,6,8,-2
6633cb8d8f483ae67010798e,20220623,TK-600,11,8,11,-3
6633cb8d8f483ae67010798f,20220624,TK-600,11,10,14,-4
6633cb8d8f483ae670107990,20220625,TK-600,11,4,7,-3
6633cb8d8f483ae670107991,20220627,TK-600,11,11,15,-4
6633cb8d8f483ae670107992,20220628,TK-600,11,10,16,-6
6633cb8d8f483ae670107993,20220629,TK-600,11,9,12,-3
6633cb8d8f483ae670107994,20220630,TK-600,11,11,15,-4
6633cb8d8f483ae670107995,20220701,TK-600,11,5,8,-3
6633cb8d8f483ae670107996,20220702,TK-600,11,12,20,-8
6633cb8d8f483ae670107997,20220704,TK-600,11,10,12,-2
6633cb8d8f483ae670107998,20220705,TK-600,11,10,12,-2
6633cb8d8f483ae670107999,20220706,TK-600,11,14,21,-7
6633cb8d8f483ae67010799a,20220707,TK-600,11,9,15,-6
6633cb8d8f483ae67010799b,20220708,TK-600,11,15,22,-7
6633cb8d8f483ae67010799c,20220709,TK-600,11,17,23,-6
6633cb8d8f483ae67010799d,20220711,TK-600,11,5,6,-1
6633cb8d8f483ae67010799e,20220712,TK-600,11,9,14,-5
6633cb8d8f483ae67010799f,20220713,TK-600,11,3,6,-3
6633cb8d8f483ae6701079a0,20220714,TK-600,11,5,7,-2
6633cb8d8f483ae6701079a1,20220715,TK-600,11,15,20,-5
6633cb8d8f483ae6701079a2,20220716,TK-600,11,7,11,-4
6633cb8d8f483ae6701079a3,20220718,TK-600,11,9,14,-5
6633cb8d8f483ae6701079a4,20220719,TK-600,11,10,17,-7
6633cb8d8f483ae6701079a5,20220720,TK-600,11,18,23,-5
6633cb8d8f483ae6701079a6,20220721,TK-600,11,5,9,-4
6633cb8d8f483ae6701079a7,20220722,TK-600,11,12,19,-7
6633cb8d8f483ae6701079a8,20220723,TK-600,11,16,20,-4
6633cb8d8f483ae6701079a9,20220725,TK-600,11,11,17,-6
6633cb8d8f483ae6701079aa,20220726,TK-600,11,13,19,-6
6633cb8d8f483ae6701079ab,20220727,TK-600,11,10,15,-5
6633cb8d8f483ae6701079ac,20220728,TK-600,11,13,19,-6
6633cb8d8f483ae6701079ad,20220729,TK-600,11,15,18,-3
6633cb8d8f483ae6701079ae,20220730,TK-600,11,8,11,-3
6633cb8d8f483ae6701079af,20220801,TK-600,11,10,14,-4
6633cb8d8f483ae6701079b0,20220802,TK-600,11,13,22,-9
6633cb8d8f483ae6701079b1,20220803,TK-600,11,21,26,-5
6633cb8d8f483ae6701079b2,20220804,TK-600,11,15,18,-3
6633cb8d8f483ae6701079b3,20220805,TK-600,11,16,23,-7
6633cb8d8f483ae6701079b4,20220806,TK-600,11,12,16,-4
6633cb8d8f483ae6701079b5,20220808,TK-600,11,21,27,-6
6633cb8d8f483ae6701079b6,20220809,TK-600,11,8,12,-4
6633cb8d8f483ae6701079b7,20220810,TK-600,11,16,21,-5
6633cb8d8f483ae6701079b8,20220811,TK-600,11,18,22,-4
6633cb8d8f483ae6701079b9,20220812,TK-600,11,13,20,-7
6633cb8d8f483ae6701079ba,20220813,TK-600,11,10,17,-7
6633cb8d8f483ae6701079bb,20220815,TK-600,11,13,18,-5
6633cb8d8f483ae6701079bc,20220816,TK-600,11,17,23,-6
6633cb8d8f483ae6701079bd,20220817,TK-600,11,11,16,-5
6633cb8d8f483ae6701079be,20220818,TK-600,11,14,18,-4
6633cb8d8f483ae6701079bf,20220819,TK-600,11,9,13,-4
6633cb8d8f483ae6701079c0,20220820,TK-600,11,21,29,-8
6633cb8d8f483ae6701079c1,20220822,TK-600,11,13,19,-6
6633cb8d8f483ae6701079c2,20220823,TK-600,11,14,23,-9
6633cb8d8f483ae6701079c3,20220824,TK-600,11,10,15,-5
6633cb8d8f483ae6701079c4,20220825,TK-600,11,12,17,-5
6633cb8d8f483ae6701079c5,20220826,TK-600,11,10,15,-5
6633cb8d8f483ae6701079c6,20220827,TK-600,11,13,18,-5
6633cb8d8f483ae6701079c7,20220829,TK-600,11,11,16,-5
6633cb8d8f483ae6701079c8,20220830,TK-600,11,12,15,-3
6633cb8d8f483ae6701079c9,20220831,TK-600,11,7,10,-3
6633cb8d8f483ae6701079ca,20220901,TK-600,11,3,7,-4
6633cb8d8f483ae6701079cb,20220902,TK-600,11,12,15,-3
6633cb8d8f483ae6701079cc,20220903,TK-600,11,7,11,-4
6633cb8d8f483ae6701079cd,20220905,TK-600,11,10,17,-7
6633cb8d8f483ae6701079ce,20220906,TK-600,11,1,1,0
6633cb8d8f483ae6701079cf,20220907,TK-600,11,3,4,-1
6633cb8d8f483ae6701079d0,20220908,TK-600,11,3,5,-2
6633cb8d8f483ae6701079d1,20220909,TK-600,11,8,15,-7
6633cb8d8f483ae6701079d2,20220910,TK-600,11,7,13,-6
6633cb8d8f483ae6701079d3,20220912,TK-600,11,6,9,-3
6633cb8d8f483ae6701079d4,20220913,TK-600,11,3,5,-2
6633cb8d8f483ae6701079d5,20220914,TK-600,11,12,15,-3
6633cb8d8f483ae6701079d6,20220915,TK-600,11,4,4,0
6633cb8d8f483ae6701079d7,20220916,TK-600,11,8,12,-4
6633cb8d8f483ae6701079d8,20220917,TK-600,11,11,15,-4
6633cb8d8f483ae6701079d9,20220919,TK-600,11,3,4,-1
6633cb8d8f483ae6701079da,20220920,TK-600,11,6,8,-2
6633cb8d8f483ae6701079db,20220921,TK-600,11,5,9,-4
6633cb8d8f483ae6701079dc,20220922,TK-600,11,10,13,-3
6633cb8d8f483ae6701079dd,20220923,TK-600,11,10,13,-3
6633cb8d8f483ae6701079de,20220924,TK-600,11,4,5,-1
6633cb8d8f483ae6701079df,20220926,TK-600,11,5,7,-2
6633cb8d8f483ae6701079e0,20220927,TK-600,11,6,8,-2
6633cb8d8f483ae6701079e1,20220928,TK-600,11,2,3,-1
6633cb8d8f483ae6701079e2,20220929,TK-600,11,6,7,-1
6633cb8d8f483ae6701079e3,20220930,TK-600,11,8,12,-4
6633cb8d8f483ae6701079e4,20221001,TK-600,11,1,1,0
6633cb8d8f483ae6701079e5,20221004,TK-600,11,2,5,-3
6633cb8d8f483ae6701079e6,20221005,TK-600,11,0,0,0
6633cb8d8f483ae6701079e7,20221007,TK-600,11,1,1,0
6633cb8d8f483ae6701079e8,20221008,TK-600,11,1,1,0
6633cb8d8f483ae6701079e9,20221010,TK-600,11,1,2,-1
6633cb8d8f483ae6701079ea,20221011,TK-600,11,1,1,0
6633cb8d8f483ae6701079eb,20221012,TK-600,11,4,5,-1
6633cb8d8f483ae6701079ec,20221013,TK-600,11,13,17,-4
6633cb8d8f483ae6701079ed,20221014,TK-600,11,8,10,-2
6633cb8d8f483ae6701079ee,20221015,TK-600,11,10,13,-3
6633cb8d8f483ae6701079ef,20221017,TK-600,11,1,1,0
6633cb8d8f483ae6701079f0,20221018,TK-600,11,6,9,-3
6633cb8d8f483ae6701079f1,20221019,TK-600,11,3,7,-4
6633cb8d8f483ae6701079f2,20221021,TK-600,11,7,9,-2
6633cb8d8f483ae6701079f3,20221022,TK-600,11,4,5,-1
6633cb8d8f483ae6701079f4,20221024,TK-600,11,7,8,-1
6633cb8d8f483ae6701079f5,20221025,TK-600,11,2,3,-1
6633cb8d8f483ae6701079f6,20221026,TK-600,11,9,13,-4
6633cb8d8f483ae6701079f7,20221027,TK-600,11,6,9,-3
6633cb8d8f483ae6701079f8,20221028,TK-600,11,12,14,-2
6633cb8d8f483ae6701079f9,20221029,TK-600,11,4,7,-3
6633cb8d8f483ae6701079fa,20221031,TK-600,11,5,5,0
6633cb8d8f483ae6701079fb,20221101,TK-600,11,6,10,-4
6633cb8d8f483ae6701079fc,20221102,TK-600,11,4,9,-5
6633cb8d8f483ae6701079fd,20221103,TK-600,11,2,5,-3
6633cb8d8f483ae6701079fe,20221104,TK-600,11,10,14,-4
6633cb8d8f483ae6701079ff,20221105,TK-600,11,4,5,-1
6633cb8d8f483ae670107a00,20221107,TK-600,11,8,9,-1
6633cb8d8f483ae670107a01,20221108,TK-600,11,8,12,-4
6633cb8d8f483ae670107a02,20221109,TK-600,11,3,5,-2
6633cb8d8f483ae670107a03,20221110,TK-600,11,12,13,-1
6633cb8d8f483ae670107a04,20221111,TK-600,11,1,2,-1
6633cb8d8f483ae670107a05,20221112,TK-600,11,2,3,-1
6633cb8d8f483ae670107a06,20221114,TK-600,11,3,6,-3
6633cb8d8f483ae670107a07,20221115,TK-600,11,2,2,0
6633cb8d8f483ae670107a08,20221116,TK-600,11,9,12,-3
6633cb8d8f483ae670107a09,20221117,TK-600,11,12,15,-3
6633cb8d8f483ae670107a0a,20221118,TK-600,11,7,9,-2
6633cb8d8f483ae670107a0b,20221119,TK-600,11,5,7,-2
6633cb8d8f483ae670107a0c,20221121,TK-600,11,4,5,-1
6633cb8d8f483ae670107a0d,20221122,TK-600,11,4,4,0
6633cb8d8f483ae670107a0e,20221123,TK-600,11,3,4,-1
6633cb8d8f483ae670107a0f,20221124,TK-600,11,5,6,-1
6633cb8d8f483ae670107a10,20221125,TK-600,11,10,12,-2
6633cb8d8f483ae670107a11,20221126,TK-600,11,0,1,-1
6633cb8d8f483ae670107a12,20221128,TK-600,11,0,0,0
6633cb8d8f483ae670107a13,20221129,TK-600,11,2,3,-1
6633cb8d8f483ae670107a14,20221130,TK-600,11,7,8,-1
6633cb8d8f483ae670107a15,20221201,TK-600,11,2,3,-1
6633cb8d8f483ae670107a16,20221202,TK-600,11,5,7,-2
6633cb8d8f483ae670107a17,20221203,TK-600,11,1,2,-1
6633cb8d8f483ae670107a18,20221205,TK-600,11,12,15,-3
6633cb8d8f483ae670107a19,20221206,TK-600,11,8,10,-2
6633cb8d8f483ae670107a1a,20221207,TK-600,11,2,4,-2
6633cb8d8f483ae670107a1b,20221208,TK-600,11,9,11,-2
6633cb8d8f483ae670107a1c,20221209,TK-600,11,1,1,0
6633cb8d8f483ae670107a1d,20221210,TK-600,11,7,11,-4
6633cb8d8f483ae670107a1e,20221212,TK-600,11,2,3,-1
6633cb8d8f483ae670107a1f,20221213,TK-600,11,7,9,-2
6633cb8d8f483ae670107a20,20221214,TK-600,11,2,2,0
6633cb8d8f483ae670107a21,20221215,TK-600,11,3,4,-1
6633cb8d8f483ae670107a22,20221216,TK-600,11,4,6,-2
6633cb8d8f483ae670107a23,20221217,TK-600,11,7,9,-2
6633cb8d8f483ae670107a24,20221219,TK-600,11,3,5,-2
6633cb8d8f483ae670107a25,20221220,TK-600,11,8,12,-4
6633cb8d8f483ae670107a26,20221221,TK-600,11,2,4,-2
6633cb8d8f483ae670107a27,20221222,TK-600,11,2,2,0
6633cb8d8f483ae670107a28,20221223,TK-600,11,6,9,-3
6633cb8d8f483ae670107a29,20221224,TK-600,11,7,8,-1
6633cb8d8f483ae670107a2a,20221226,TK-600,11,5,7,-2
6633cb8d8f483ae670107a2b,20221227,TK-600,11,5,8,-3
6633cb8d8f483ae670107a2c,20221228,TK-600,11,8,12,-4
6633cb8d8f483ae670107a2d,20221229,TK-600,11,8,10,-2
6633cb8d8f483ae670107a2e,20221230,TK-600,11,8,12,-4
6633cb8d8f483ae670107a2f,20221231,TK-600,11,4,6,-2
6633cb8d8f483ae670107a30,20230102,TK-600,11,5,10,-5
6633cb8d8f483ae670107a31,20230103,TK-600,11,8,9,-1
6633cb8d8f483ae670107a32,20230104,TK-600,11,8,11,-3
6633cb8d8f483ae670107a33,20230105,TK-600,11,8,11,-3
6633cb8d8f483ae670107a34,20230106,TK-600,11,8,10,-2
6633cb8d8f483ae670107a35,20230107,TK-600,11,9,12,-3
6633cb8d8f483ae670107a36,20230109,TK-600,11,7,10,-3
6633cb8d8f483ae670107a37,20230110,TK-600,11,10,12,-2
6633cb8d8f483ae670107a38,20230111,TK-600,11,4,8,-4
6633cb8d8f483ae670107a39,20230112,TK-600,11,3,4,-1
6633cb8d8f483ae670107a3a,20230113,TK-600,11,8,11,-3
6633cb8d8f483ae670107a3b,20230114,TK-600,11,7,9,-2
6633cb8d8f483ae670107a3c,20230116,TK-600,11,12,15,-3
6633cb8d8f483ae670107a3d,20230117,TK-600,11,5,7,-2
6633cb8d8f483ae670107a3e,20230118,TK-600,11,15,18,-3
6633cb8d8f483ae670107a3f,20230119,TK-600,11,4,6,-2
6633cb8d8f483ae670107a40,20230120,TK-600,11,12,16,-4
6633cb8d8f483ae670107a41,20230121,TK-600,11,5,7,-2
6633cb8d8f483ae670107a42,20230123,TK-600,11,11,15,-4
6633cb8d8f483ae670107a43,20230124,TK-600,11,6,8,-2
6633cb8d8f483ae670107a44,20230125,TK-600,11,4,6,-2
6633cb8d8f483ae670107a45,20230126,TK-600,11,9,9,0
6633cb8d8f483ae670107a46,20230127,TK-600,11,18,19,-1
6633cb8d8f483ae670107a47,20230128,TK-600,11,3,3,0
6633cb8d8f483ae670107a48,20230130,TK-600,11,16,17,-1
6633cb8d8f483ae670107a49,20230131,TK-600,11,3,3,0
6633cb8d8f483ae670107a4a,20230202,TK-600,11,18,20,-2
6633cb8d8f483ae670107a4b,20230203,TK-600,11,15,19,-4
6633cb8d8f483ae670107a4c,20230204,TK-600,11,9,11,-2
6633cb8d8f483ae670107a4d,20230206,TK-600,11,6,10,-4
6633cb8d8f483ae670107a4e,20230207,TK-600,11,8,12,-4
6633cb8d8f483ae670107a4f,20230208,TK-600,11,4,4,0
6633cb8d8f483ae670107a50,20230209,TK-600,11,9,12,-3
6633cb8d8f483ae670107a51,20230210,TK-600,11,6,9,-3
6633cb8d8f483ae670107a52,20230211,TK-600,11,8,10,-2
6633cb8d8f483ae670107a53,20230213,TK-600,11,6,7,-1
6633cb8d8f483ae670107a54,20230214,TK-600,11,2,5,-3
6633cb8d8f483ae670107a55,20230215,TK-600,11,12,13,-1
6633cb8d8f483ae670107a56,20230216,TK-600,11,5,9,-4
6633cb8d8f483ae670107a57,20230217,TK-600,11,11,16,-5
6633cb8d8f483ae670107a58,20230218,TK-600,11,3,5,-2
6633cb8d8f483ae670107a59,20230220,TK-600,11,6,9,-3
6633cb8d8f483ae670107a5a,20230221,TK-600,11,7,10,-3
6633cb8d8f483ae670107a5b,20230222,TK-600,11,5,7,-2
6633cb8d8f483ae670107a5c,20230223,TK-600,11,13,16,-3
6633cb8d8f483ae670107a5d,20230224,TK-600,11,2,5,-3
6633cb8d8f483ae670107a5e,20230225,TK-600,11,9,12,-3
6633cb8d8f483ae670107a5f,20230227,TK-600,11,3,5,-2
6633cb8d8f483ae670107a60,20230228,TK-600,11,7,9,-2
6633cb8d8f483ae670107a61,20230301,TK-600,11,5,6,-1
6633cb8d8f483ae670107a62,20230302,TK-600,11,7,11,-4
6633cb8d8f483ae670107a63,20230303,TK-600,11,10,15,-5
6633cb8d8f483ae670107a64,20230304,TK-600,11,9,12,-3
6633cb8d8f483ae670107a65,20230306,TK-600,11,5,6,-1
6633cb8d8f483ae670107a66,20230307,TK-600,11,5,8,-3
6633cb8d8f483ae670107a67,20230308,TK-600,11,6,8,-2
6633cb8d8f483ae670107a68,20230309,TK-600,11,11,15,-4
6633cb8d8f483ae670107a69,20230310,TK-600,11,9,14,-5
6633cb8d8f483ae670107a6a,20230311,TK-600,11,11,15,-4
6633cb8d8f483ae670107a6b,20230313,TK-600,11,2,5,-3
6633cb8d8f483ae670107a6c,20230314,TK-600,11,4,5,-1
6633cb8d8f483ae670107a6d,20230315,TK-600,11,10,15,-5
6633cb8d8f483ae670107a6e,20230316,TK-600,11,10,14,-4
6633cb8d8f483ae670107a6f,20230317,TK-600,11,7,12,-5
6633cb8d8f483ae670107a70,20230318,TK-600,11,6,10,-4
6633cb8d8f483ae670107a71,20230320,TK-600,11,8,11,-3
6633cb8d8f483ae670107a72,20230321,TK-600,11,9,12,-3
6633cb8d8f483ae670107a73,20230322,TK-600,11,2,4,-2
6633cb8d8f483ae670107a74,20230323,TK-600,11,7,11,-4
6633cb8d8f483ae670107a75,20230324,TK-600,11,12,16,-4
6633cb8d8f483ae670107a76,20230325,TK-600,11,11,14,-3
6633cb8d8f483ae670107a77,20230327,TK-600,11,5,7,-2
6633cb8d8f483ae670107a78,20230328,TK-600,11,8,11,-3
6633cb8d8f483ae670107a79,20230329,TK-600,11,5,8,-3
6633cb8d8f483ae670107a7a,20230330,TK-600,11,11,14,-3
6633cb8d8f483ae670107a7b,20230331,TK-600,11,10,11,-1
6633cb8d8f483ae670107a7c,20230401,TK-600,11,5,6,-1
6633cb8d8f483ae670107a7d,20230403,TK-600,11,11,14,-3
6633cb8d8f483ae670107a7e,20230404,TK-600,11,14,18,-4
6633cb8d8f483ae670107a7f,20230405,TK-600,11,1,2,-1
6633cb8d8f483ae670107a80,20230406,TK-600,11,11,14,-3
6633cb8d8f483ae670107a81,20230407,TK-600,11,8,11,-3
6633cb8d8f483ae670107a82,20230408,TK-600,11,10,16,-6
6633cb8d8f483ae670107a83,20230410,TK-600,11,8,10,-2
6633cb8d8f483ae670107a84,20230411,TK-600,11,9,14,-5
6633cb8d8f483ae670107a85,20230412,TK-600,11,10,15,-5
6633cb8d8f483ae670107a86,20230413,TK-600,11,9,13,-4
6633cb8d8f483ae670107a87,20230414,TK-600,11,3,4,-1
6633cb8d8f483ae670107a88,20230415,TK-600,11,12,15,-3
6633cb8d8f483ae670107a89,20230417,TK-600,11,11,16,-5
6633cb8d8f483ae670107a8a,20230418,TK-600,11,11,14,-3
6633cb8d8f483ae670107a8b,20230419,TK-600,11,4,6,-2
6633cb8d8f483ae670107a8c,20230420,TK-600,11,6,11,-5
6633cb8d8f483ae670107a8d,20230421,TK-600,11,11,18,-7
6633cb8d8f483ae670107a8e,20230424,TK-600,11,3,5,-2
6633cb8d8f483ae670107a8f,20230425,TK-600,11,10,14,-4
6633cb8d8f483ae670107a90,20230426,TK-600,11,8,10,-2
6633cb8d8f483ae670107a91,20230427,TK-600,11,3,6,-3
6633cb8d8f483ae670107a92,20230428,TK-600,11,5,9,-4
6633cb8d8f483ae670107a93,20230429,TK-600,11,11,14,-3
6633cb8d8f483ae670107a94,20230501,TK-600,11,8,10,-2
6633cb8d8f483ae670107a95,20230502,TK-600,11,10,13,-3
6633cb8d8f483ae670107a96,20230503,TK-600,11,4,8,-4
6633cb8d8f483ae670107a97,20230504,TK-600,11,18,22,-4
6633cb8d8f483ae670107a98,20230505,TK-600,11,6,8,-2
6633cb8d8f483ae670107a99,20230506,TK-600,11,8,13,-5
6633cb8d8f483ae670107a9a,20230508,TK-600,11,11,14,-3
6633cb8d8f483ae670107a9b,20230509,TK-600,11,11,15,-4
6633cb8d8f483ae670107a9c,20230510,TK-600,11,7,10,-3
6633cb8d8f483ae670107a9d,20230511,TK-600,11,11,14,-3
6633cb8d8f483ae670107a9e,20230512,TK-600,11,9,13,-4
6633cb8d8f483ae670107a9f,20230513,TK-600,11,12,15,-3
6633cb8d8f483ae670107aa0,20230515,TK-600,11,15,18,-3
6633cb8d8f483ae670107aa1,20230516,TK-600,11,5,7,-2
6633cb8d8f483ae670107aa2,20230517,TK-600,11,10,15,-5
6633cb8d8f483ae670107aa3,20230518,TK-600,11,5,10,-5
6633cb8d8f483ae670107aa4,20230519,TK-600,11,12,15,-3
6633cb8d8f483ae670107aa5,20230520,TK-600,11,7,11,-4
6633cb8d8f483ae670107aa6,20230522,TK-600,11,12,14,-2
6633cb8d8f483ae670107aa7,20230523,TK-600,11,9,12,-3
6633cb8d8f483ae670107aa8,20230524,TK-600,11,12,15,-3
6633cb8d8f483ae670107aa9,20230525,TK-600,11,8,11,-3
6633cb8d8f483ae670107aaa,20230526,TK-600,11,13,17,-4
6633cb8d8f483ae670107aab,20230527,TK-600,11,7,11,-4
6633cb8d8f483ae670107aac,20230529,TK-600,11,5,7,-2
6633cb8d8f483ae670107aad,20230530,TK-600,11,10,13,-3
6633cb8d8f483ae670107aae,20230531,TK-600,11,12,15,-3
6633cb8d8f483ae670107aaf,20230601,TK-600,11,7,10,-3
6633cb8d8f483ae670107ab0,20230602,TK-600,11,9,13,-4
6633cb8d8f483ae670107ab1,20230603,TK-600,11,18,23,-5
6633cb8d8f483ae670107ab2,20230605,TK-600,11,6,9,-3
6633cb8d8f483ae670107ab3,20230606,TK-600,11,9,12,-3
6633cb8d8f483ae670107ab4,20230607,TK-600,11,7,8,-1
6633cb8d8f483ae670107ab5,20230608,TK-600,11,11,15,-4
6633cb8d8f483ae670107ab6,20230609,TK-600,11,8,14,-6
6633cb8d8f483ae670107ab7,20230610,TK-600,11,7,10,-3
6633cb8d8f483ae670107ab8,20230612,TK-600,11,5,7,-2
6633cb8d8f483ae670107ab9,20230613,TK-600,11,9,12,-3
6633cb8d8f483ae670107aba,20230614,TK-600,11,6,8,-2
6633cb8d8f483ae670107abb,20230615,TK-600,11,10,14,-4
6633cb8d8f483ae670107abc,20230616,TK-600,11,9,12,-3
6633cb8d8f483ae670107abd,20230617,TK-600,11,15,18,-3
6633cb8d8f483ae670107abe,20230619,TK-600,11,12,19,-7
6633cb8d8f483ae670107abf,20230620,TK-600,11,8,11,-3
6633cb8d8f483ae670107ac0,20230621,TK-600,11,9,12,-3
6633cb8d8f483ae670107ac1,20230622,TK-600,11,9,13,-4
6633cb8d8f483ae670107ac2,20230623,TK-600,11,18,22,-4
6633cb8d8f483ae670107ac3,20230624,TK-600,11,8,12,-4
6633cb8d8f483ae670107ac4,20230626,TK-600,11,15,22,-7
6633cb8d8f483ae670107ac5,20230627,TK-600,11,12,17,-5
6633cb8d8f483ae670107ac6,20230628,TK-600,11,15,22,-7
6633cb8d8f483ae670107ac7,20230630,TK-600,11,5,8,-3
6633cb8d8f483ae670107ac8,20230701,TK-600,11,19,22,-3
6633cb8d8f483ae670107ac9,20230703,TK-600,11,9,12,-3
6633cb8d8f483ae670107aca,20230704,TK-600,11,12,18,-6
6633cb8d8f483ae670107acb,20230705,TK-600,11,10,13,-3
6633cb8d8f483ae670107acc,20230706,TK-600,11,12,16,-4
6633cb8d8f483ae670107acd,20230707,TK-600,11,18,23,-5
6633cb8d8f483ae670107ace,20230708,TK-600,11,7,11,-4
6633cb8d8f483ae670107acf,20230710,TK-600,11,12,18,-6
6633cb8d8f483ae670107ad0,20230711,TK-600,11,14,19,-5
6633cb8d8f483ae670107ad1,20230712,TK-600,11,10,14,-4
6633cb8d8f483ae670107ad2,20230713,TK-600,11,18,20,-2
6633cb8d8f483ae670107ad3,20230714,TK-600,11,6,11,-5
6633cb8d8f483ae670107ad4,20230715,TK-600,11,5,9,-4
6633cb8d8f483ae670107ad5,20230717,TK-600,11,0,1,-1
6633cb8d8f483ae670107ad6,20230718,TK-600,11,19,26,-7
6633cb8d8f483ae670107ad7,20230719,TK-600,11,14,20,-6
